county,administered_date,total_doses,cumulative_total_doses,pfizer_doses,cumulative_pfizer_doses,moderna_doses,cumulative_moderna_doses,jj_doses,cumulative_jj_doses,partially_vaccinated,total_partially_vaccinated,fully_vaccinated,cumulative_fully_vaccinated,at_least_one_dose,cumulative_at_least_one_dose,california_flag
All CA Counties,2020-12-15,1187,1187,1187,1187,0,0,0,0,1187,1187,0,0,1187,1187,
All CA Counties,2020-12-16,8745,9932,8745,9932,0,0,0,0,8745,9932,0,0,8745,9932,
All CA Counties,2020-12-17,26795,36727,26795,36727,0,0,0,0,26797,36729,0,0,26797,36729,
All CA Counties,2020-12-18,45554,82281,45484,82211,70,70,0,0,45554,82282,1,1,45554,82283,
All CA Counties,2020-12-19,25653,107934,25623,107834,30,100,0,0,25652,107933,1,2,25652,107935,
All CA Counties,2020-12-20,19193,127127,19157,126991,36,136,0,0,19191,127122,2,4,19191,127126,
All CA Counties,2020-12-21,49931,177058,49826,176817,105,241,0,0,49932,177052,3,7,49933,177059,
All CA Counties,2020-12-22,50347,227405,48182,224999,2165,2406,0,0,50338,227381,9,16,50338,227397,
All CA Counties,2020-12-23,50863,278268,42009,267008,8854,11260,0,0,50856,278233,7,23,50859,278256,
All CA Counties,2020-12-24,24165,302433,16383,283391,7782,19042,0,0,24158,302387,6,29,24160,302416,
All CA Counties,2020-12-25,2361,304794,2035,285426,326,19368,0,0,2361,304748,0,29,2361,304777,
All CA Counties,2020-12-26,14670,319464,9495,294921,5175,24543,0,0,14668,319414,2,31,14668,319445,
All CA Counties,2020-12-27,9480,328944,5615,300536,3865,28408,0,0,9477,328888,3,34,9477,328922,
All CA Counties,2020-12-28,46321,375265,29657,330193,16664,45072,0,0,46314,375196,6,40,46314,375236,
All CA Counties,2020-12-29,51498,426763,28656,358849,22842,67914,0,0,51491,426682,5,45,51491,426727,
All CA Counties,2020-12-30,63317,490080,35715,394564,27602,95516,0,0,63304,489979,10,55,63307,490034,
All CA Counties,2020-12-31,29694,519774,10964,405528,18730,114246,0,0,29671,519630,21,76,29672,519706,
All CA Counties,2021-01-01,5068,524842,2364,407892,2704,116950,0,0,5056,524676,10,86,5056,524762,
All CA Counties,2021-01-02,18587,543429,10278,418170,8309,125259,0,0,18581,543255,2,88,18581,543343,
All CA Counties,2021-01-03,6265,549694,3523,421693,2742,128001,0,0,6232,549475,12,100,6232,549575,
All CA Counties,2021-01-04,43856,593550,22093,443786,21763,149764,0,0,43775,593210,40,140,43775,593350,
All CA Counties,2021-01-05,57003,650553,30105,473891,26898,176662,0,0,51193,638766,5740,5880,51296,644646,
All CA Counties,2021-01-06,74053,724606,40934,514825,33119,209781,0,0,58019,680990,15842,21722,58066,702712,
All CA Counties,2021-01-07,93209,817815,53111,567936,40098,249879,0,0,61269,710569,31752,53474,61331,764043,
All CA Counties,2021-01-08,108269,926084,65097,633033,43172,293051,0,0,65879,734293,42235,95709,65959,830002,
All CA Counties,2021-01-09,44814,970898,25817,658850,18997,312048,0,0,28041,745620,16743,112452,28070,858072,
All CA Counties,2021-01-10,24534,995432,14998,673848,9536,321584,0,0,13204,747533,11312,123764,13225,871297,
All CA Counties,2021-01-11,105334,1100766,70215,744063,35119,356703,0,0,61002,764442,44281,168045,61190,932487,
All CA Counties,2021-01-12,114916,1215682,68094,812157,46822,403525,0,0,73172,796246,41641,209686,73445,1005932,
All CA Counties,2021-01-13,120293,1335975,62474,874631,57819,461344,0,0,86135,848415,34061,243747,86230,1092162,
All CA Counties,2021-01-14,125342,1461317,50243,924874,75099,536443,0,0,105395,934183,19828,263575,105596,1197758,
All CA Counties,2021-01-15,142967,1604284,52156,977030,90811,627254,0,0,127668,1046926,15176,278751,127919,1325677,
All CA Counties,2021-01-16,81266,1685550,27474,1004504,53792,681046,0,0,73607,1112960,7628,286379,73662,1399339,
All CA Counties,2021-01-17,48418,1733968,16937,1021441,31481,712527,0,0,44711,1154024,3694,290073,44758,1444097,
All CA Counties,2021-01-18,88656,1822624,46235,1067676,42421,754948,0,0,69160,1203951,19419,309492,69346,1513443,
All CA Counties,2021-01-19,142905,1965529,73617,1141293,69288,824236,0,0,111505,1284499,31292,340784,111840,1625283,
All CA Counties,2021-01-20,164279,2129808,84814,1226107,79465,903701,0,0,129855,1380468,34166,374950,130135,1755418,
All CA Counties,2021-01-21,176648,2306456,79006,1305113,97642,1001343,0,0,156811,1518086,19595,394545,157213,1912631,
All CA Counties,2021-01-22,171436,2477892,69934,1375047,101502,1102845,0,0,156772,1660505,14518,409063,156937,2069568,
All CA Counties,2021-01-23,112298,2590190,49565,1424612,62733,1165578,0,0,99620,1747640,12611,421674,99746,2169314,
All CA Counties,2021-01-24,61467,2651657,29473,1454085,31994,1197572,0,0,56722,1799725,4708,426382,56793,2226107,
All CA Counties,2021-01-25,146394,2798051,65886,1519971,80508,1278080,0,0,110766,1875422,35470,461852,111167,2337274,
All CA Counties,2021-01-26,170752,2968803,83739,1603710,87013,1365093,0,0,132460,1970034,38129,499981,132741,2470015,
All CA Counties,2021-01-27,184213,3153016,88523,1692233,95690,1460783,0,0,143965,2074335,39898,539879,144199,2614214,
All CA Counties,2021-01-28,190021,3343037,87590,1779823,102431,1563214,0,0,155199,2195287,34498,574377,155450,2769664,
All CA Counties,2021-01-29,185611,3528648,88960,1868783,96651,1659865,0,0,150128,2310779,34828,609205,150320,2919984,
All CA Counties,2021-01-30,124983,3653631,55851,1924634,69132,1728997,0,0,109305,2404747,15494,624699,109462,3029446,
All CA Counties,2021-01-31,69973,3723604,39075,1963709,30898,1759895,0,0,64873,2464647,5035,629734,64935,3094381,
All CA Counties,2021-02-01,163194,3886798,76168,2039877,87026,1846921,0,0,121489,2544772,41488,671222,121613,3215994,
All CA Counties,2021-02-02,187489,4074287,79030,2118907,108459,1955380,0,0,142059,2641977,45084,716306,142289,3358283,
All CA Counties,2021-02-03,212817,4287104,96104,2215011,116713,2072093,0,0,157357,2744693,54901,771207,157617,3515900,
All CA Counties,2021-02-04,229879,4516983,100339,2315350,129540,2201633,0,0,168042,2851879,61231,832438,168417,3684317,
All CA Counties,2021-02-05,248151,4765134,106656,2422006,141495,2343128,0,0,167962,2941130,79281,911719,168532,3852849,
All CA Counties,2021-02-06,156431,4921565,75041,2497047,81390,2424518,0,0,121196,3027830,34999,946718,121699,3974548,
All CA Counties,2021-02-07,67358,4988923,43567,2540614,23791,2448309,0,0,50706,3062442,16549,963267,51161,4025709,
All CA Counties,2021-02-08,183038,5171961,90049,2630663,92989,2541298,0,0,120538,3121767,61979,1025246,121304,4147013,
All CA Counties,2021-02-09,213533,5385494,102719,2733382,110814,2652112,0,0,127434,3165184,85249,1110495,128666,4275679,
All CA Counties,2021-02-10,251532,5637026,120983,2854365,130549,2782661,0,0,138063,3192213,112534,1223029,139563,4415242,
All CA Counties,2021-02-11,268332,5905358,132602,2986967,135730,2918391,0,0,144977,3216983,122043,1345072,146813,4562055,
All CA Counties,2021-02-12,275716,6181074,120491,3107458,155225,3073616,0,0,148096,3240942,126533,1471605,150492,4712547,
All CA Counties,2021-02-13,169300,6350374,78348,3185806,90952,3164568,0,0,93251,3260548,75608,1547213,95214,4807761,
All CA Counties,2021-02-14,96621,6446995,48098,3233904,48523,3213091,0,0,51976,3269642,44439,1591652,53533,4861294,
All CA Counties,2021-02-15,144278,6591273,63255,3297159,81023,3294114,0,0,79471,3287920,64333,1655985,82611,4943905,
All CA Counties,2021-02-16,252407,6843680,119768,3416927,132639,3426753,0,0,134397,3307878,117518,1773503,137476,5081381,
All CA Counties,2021-02-17,262883,7106563,130892,3547819,131991,3558744,0,0,130042,3308998,132129,1905632,133249,5214630,
All CA Counties,2021-02-18,276917,7383480,144499,3692318,132418,3691162,0,0,133178,3303598,142828,2048460,137428,5352058,
All CA Counties,2021-02-19,258114,7641594,149753,3842071,108361,3799523,0,0,132335,3312964,125060,2173520,134426,5486484,
All CA Counties,2021-02-20,157754,7799348,100841,3942912,56913,3856436,0,0,85867,3329324,71504,2245024,87864,5574348,
All CA Counties,2021-02-21,87668,7887016,70797,4013709,16871,3873307,0,0,44624,3332793,42712,2287736,46181,5620529,
All CA Counties,2021-02-22,173462,8060478,116232,4129941,57230,3930537,0,0,85533,3332705,87347,2375083,87259,5707788,
All CA Counties,2021-02-23,237197,8297675,125294,4255235,111903,4042440,0,0,109148,3320754,127107,2502190,115156,5822944,
All CA Counties,2021-02-24,296342,8594017,150080,4405315,146262,4188702,0,0,139313,3311585,156063,2658253,146894,5969838,
All CA Counties,2021-02-25,336477,8930494,166326,4571641,170151,4358853,0,0,174819,3334346,160640,2818893,183401,6153239,
All CA Counties,2021-02-26,371332,9301826,173241,4744882,198091,4556944,0,0,205451,3382484,164619,2983512,212757,6365996,
All CA Counties,2021-02-27,264825,9566651,128719,4873601,136075,4693019,31,31,149232,3421450,114733,3098245,153699,6519695,
All CA Counties,2021-02-28,141833,9708484,84434,4958035,57385,4750404,14,45,81925,3446957,59289,3157534,84796,6604491,
All CA Counties,2021-03-01,254238,9962722,135271,5093306,118781,4869185,186,231,145576,3489213,107540,3265074,149796,6754287,
All CA Counties,2021-03-02,301162,10263884,151796,5245102,149329,5018514,37,268,179284,3554299,121142,3386216,186228,6940515,
All CA Counties,2021-03-03,344288,10608172,171007,5416109,173203,5191717,78,346,197903,3614122,145499,3531715,205322,7145837,
All CA Counties,2021-03-04,362222,10970394,182704,5598813,179417,5371134,101,447,211299,3682620,149949,3681664,218447,7364284,
All CA Counties,2021-03-05,349642,11320036,171344,5770157,177152,5548286,1146,1593,215989,3774411,132640,3814304,224431,7588715,
All CA Counties,2021-03-06,263942,11583978,135330,5905487,120681,5668967,7931,9524,163174,3849943,100225,3914529,175757,7764472,
All CA Counties,2021-03-07,134050,11718028,79618,5985105,47527,5716494,6905,16429,81925,3890562,51857,3966386,92476,7856948,
All CA Counties,2021-03-08,225629,11943657,109719,6094824,104868,5821362,11042,27471,146916,3975195,78218,4044604,162851,8019799,
All CA Counties,2021-03-09,296676,12240333,141252,6236076,139082,5960444,16342,43813,165537,4030502,130486,4175090,185793,8205592,
All CA Counties,2021-03-10,327749,12568082,162792,6398868,140143,6100587,24814,68627,176682,4085792,150208,4325298,205498,8411090,
All CA Counties,2021-03-11,381694,12949776,184533,6583401,163454,6264041,33707,102334,195054,4133089,185464,4510762,232761,8643851,
All CA Counties,2021-03-12,399754,13349530,178381,6761782,174836,6438877,46537,148871,195543,4175860,203150,4713912,245921,8889772,
All CA Counties,2021-03-13,287482,13637012,125738,6887520,130360,6569237,31384,180255,155382,4235151,131520,4845432,190811,9080583,
All CA Counties,2021-03-14,157100,13794112,83695,6971215,58253,6627490,15152,195407,78643,4253026,78077,4923509,95952,9176535,
All CA Counties,2021-03-15,293610,14087722,140335,7111550,132546,6760036,20729,216136,158451,4301341,134184,5057693,182499,9359034,
All CA Counties,2021-03-16,373980,14461702,175819,7287369,180666,6940702,17495,233631,215251,4379442,157751,5215444,235852,9594886,
All CA Counties,2021-03-17,389629,14851331,193197,7480566,177656,7118358,18776,252407,240027,4492084,148529,5363973,261171,9856057,
All CA Counties,2021-03-18,406874,15258205,208531,7689097,179910,7298268,18433,270840,238794,4584592,166746,5530719,259254,10115311,
All CA Counties,2021-03-19,415774,15673979,218782,7907879,175060,7473328,21932,292772,238462,4670848,176093,5706812,262349,10377660,
All CA Counties,2021-03-20,298571,15972550,156874,8064753,125685,7599013,16012,308784,187016,4764607,110719,5817531,204478,10582138,
All CA Counties,2021-03-21,145694,16118244,100531,8165284,37601,7636614,7562,316346,86666,4801667,58523,5876054,95583,10677721,
All CA Counties,2021-03-22,276719,16394963,161298,8326582,104145,7740759,11276,327622,178245,4896727,97468,5973522,192528,10870249,
All CA Counties,2021-03-23,362192,16757155,199725,8526307,151329,7892088,11138,338760,220019,4989397,141057,6114579,233727,11103976,
All CA Counties,2021-03-24,392154,17149309,224232,8750539,155291,8047379,12631,351391,224795,5062990,165871,6280450,239464,11343440,
All CA Counties,2021-03-25,422927,17572236,232976,8983515,174969,8222348,14982,366373,236482,5131695,184853,6465303,253558,11596998,
All CA Counties,2021-03-26,439978,18012214,234938,9218453,188771,8411119,16269,382642,234031,5180372,204403,6669706,253080,11850078,
All CA Counties,2021-03-27,316594,18328808,167941,9386394,136799,8547918,11854,394496,157708,5194295,157841,6827547,171764,12021842,
All CA Counties,2021-03-28,171161,18499969,109989,9496383,57560,8605478,3612,398108,88287,5206223,82313,6909860,94241,12116083,
All CA Counties,2021-03-29,313943,18813912,168650,9665033,136106,8741584,9187,407295,172329,5249627,140588,7050448,183992,12300075,
All CA Counties,2021-03-30,402637,19216549,203930,9868963,180374,8921958,18333,425628,224314,5316657,177311,7227759,244341,12544416,
All CA Counties,2021-03-31,430328,19646877,233696,10102659,174566,9096524,22066,447694,237207,5385056,191808,7419567,260207,12804623,
All CA Counties,2021-04-01,497608,20144485,254409,10357068,202138,9298662,41061,488755,271672,5474471,224076,7643643,313491,13118114,
All CA Counties,2021-04-02,477963,20622448,232757,10589825,201587,9500249,43619,532374,257206,5557395,219256,7862899,302180,13420294,
All CA Counties,2021-04-03,331694,20954142,169099,10758924,120853,9621102,41742,574116,164438,5597982,166465,8029364,207052,13627346,
All CA Counties,2021-04-04,133006,21087148,69400,10828324,44472,9665574,19134,593250,57891,5600276,74729,8104093,77023,13704369,
All CA Counties,2021-04-05,356854,21444002,183576,11011900,132880,9798454,40398,633648,173694,5634312,182267,8286360,216303,13920672,
All CA Counties,2021-04-06,461880,21905882,233643,11245543,162297,9960751,65940,699588,222683,5686520,238024,8524384,290232,14210904,
All CA Counties,2021-04-07,476656,22382538,247495,11493038,158664,10119415,70497,770085,230475,5743221,244990,8769374,301691,14512595,
All CA Counties,2021-04-08,503550,22886088,254019,11747057,164468,10283883,85063,855148,236103,5800271,265973,9035347,323023,14835618,
All CA Counties,2021-04-09,500341,23386429,248902,11995959,170685,10454568,80754,935902,229517,5843724,269518,9304865,312971,15148589,
All CA Counties,2021-04-10,371799,23758228,169162,12165121,127766,10582334,74871,1010773,155682,5861486,215209,9520074,232971,15381560,
All CA Counties,2021-04-11,189453,23947681,105953,12271074,49049,10631383,34451,1045224,77990,5865589,111019,9631093,115122,15496682,
All CA Counties,2021-04-12,343188,24290869,176160,12447234,128396,10759779,38632,1083856,157947,5881550,184075,9815168,200036,15696718,
All CA Counties,2021-04-13,437710,24728579,244881,12692115,191861,10951640,968,1084824,243669,5936428,192785,10007953,247663,15944381,
All CA Counties,2021-04-14,456743,25185322,256086,12948201,200349,11151989,308,1085132,236933,5959792,218400,10226353,241764,16186145,
All CA Counties,2021-04-15,496504,25681826,288769,13236970,207414,11359403,321,1085453,275834,6019904,218903,10445256,279015,16465160,
All CA Counties,2021-04-16,482359,26164185,270854,13507824,211189,11570592,316,1085769,255746,6053394,225022,10670278,258512,16723672,
All CA Counties,2021-04-17,347698,26511883,194280,13702104,153354,11723946,64,1085833,196805,6103606,149834,10820112,200046,16923718,
All CA Counties,2021-04-18,162346,26674229,104340,13806444,57983,11781929,23,1085856,82881,6110620,78931,10899043,85945,17009663,
All CA Counties,2021-04-19,323962,26998191,186019,13992463,137839,11919768,104,1085960,152070,6093908,170754,11069797,154042,17163705,
All CA Counties,2021-04-20,420176,27418367,226692,14219155,193401,12113169,83,1086043,207004,6092262,211819,11281616,210173,17373878,
All CA Counties,2021-04-21,443194,27861561,256207,14475362,186699,12299868,288,1086331,211895,6078494,229397,11511013,215629,17589507,
All CA Counties,2021-04-22,460777,28322338,264964,14740326,195719,12495587,94,1086425,204738,6032305,254274,11765287,208085,17797592,
All CA Counties,2021-04-23,453737,28776075,260467,15000793,193171,12688758,99,1086524,205373,5994507,246654,12011941,208856,18006448,
All CA Counties,2021-04-24,331143,29107218,207799,15208592,123150,12811908,194,1086718,167748,6003548,162194,12174135,171235,18177683,
All CA Counties,2021-04-25,152332,29259550,99817,15308409,52436,12864344,79,1086797,81230,6015821,70516,12244651,82789,18260472,
All CA Counties,2021-04-26,308331,29567881,179358,15487767,127410,12991754,1563,1088360,134549,5983877,172580,12417231,140636,18401108,
All CA Counties,2021-04-27,376260,29944141,208781,15696548,160795,13152549,6684,1095044,151742,5922345,223142,12640373,161610,18562718,
All CA Counties,2021-04-28,363001,30307142,209732,15906280,145244,13297793,8025,1103069,149534,5870193,212072,12852445,159920,18722638,
All CA Counties,2021-04-29,373110,30680252,216523,16122803,148554,13446347,8033,1111102,137198,5782905,234409,13086854,147121,18869759,
All CA Counties,2021-04-30,386007,31066259,222415,16345218,154545,13600892,9047,1120149,147118,5703811,237251,13324105,158157,19027916,
All CA Counties,2021-05-01,251974,31318233,160561,16505779,85216,13686108,6197,1126346,91610,5644641,159209,13483314,100039,19127955,
All CA Counties,2021-05-02,117933,31436166,82506,16588285,31512,13717620,3915,1130261,41193,5613855,76261,13559575,45475,19173430,
All CA Counties,2021-05-03,257806,31693972,158697,16746982,90258,13807878,8851,1139112,78438,5523732,178312,13737887,88189,19261619,
All CA Counties,2021-05-04,336811,32030783,206961,16953943,119946,13927824,9904,1149016,99246,5397798,236271,13974158,110337,19371956,
All CA Counties,2021-05-05,341945,32372728,214088,17168031,117724,14045548,10133,1159149,96623,5261773,243849,14218007,107824,19479780,
All CA Counties,2021-05-06,360077,32732805,236642,17404673,112805,14158353,10630,1169779,91100,5098940,267057,14485064,104224,19584004,
All CA Counties,2021-05-07,355667,33088472,223421,17628094,122322,14280675,9924,1179703,96558,4949228,257464,14742528,107752,19691756,
All CA Counties,2021-05-08,235419,33323891,150042,17778136,78355,14359030,7022,1186725,64804,4853034,169495,14912023,73301,19765057,
All CA Counties,2021-05-09,96006,33419897,72607,17850743,20396,14379426,3003,1189728,25201,4811253,70427,14982450,28646,19793703,
All CA Counties,2021-05-10,209011,33628908,119845,17970588,81202,14460628,7964,1197692,51580,4715664,156431,15138881,60842,19854545,
All CA Counties,2021-05-11,277628,33906536,158725,18129313,110176,14570804,8727,1206419,72992,4595686,203505,15342386,83527,19938072,
All CA Counties,2021-05-12,274052,34180588,159516,18288829,105356,14676160,9180,1215599,73358,4479906,199471,15541857,83691,20021763,
All CA Counties,2021-05-13,319657,34500245,206122,18494951,106074,14782234,7461,1223060,120031,4411740,198336,15740193,130170,20151933,
All CA Counties,2021-05-14,343369,34843614,220072,18715023,114332,14896566,8965,1232025,133579,4348015,208360,15948553,144635,20296568,
All CA Counties,2021-05-15,282286,35125900,197122,18912145,79115,14975681,6049,1238074,116146,4306087,165109,16113662,123181,20419749,
All CA Counties,2021-05-16,141995,35267895,108875,19021020,30156,15005837,2964,1241038,57835,4283667,83631,16197293,61211,20480960,
All CA Counties,2021-05-17,241302,35509197,158776,19179796,75085,15080922,7441,1248479,95300,4242282,144996,16342289,103611,20584571,
All CA Counties,2021-05-18,282949,35792146,172458,19352254,103036,15183958,7455,1255934,110023,4189476,171707,16513996,118901,20703472,
All CA Counties,2021-05-19,276980,36069126,172738,19524992,96630,15280588,7612,1263546,112798,4148001,163009,16677005,121534,20825006,
All CA Counties,2021-05-20,266197,36335323,159008,19684000,98977,15379565,8212,1271758,101151,4095118,163773,16840778,110890,20935896,
All CA Counties,2021-05-21,283917,36619240,174488,19858488,101426,15480991,8003,1279761,106506,4034858,176013,17016791,115753,21051649,
All CA Counties,2021-05-22,205455,36824695,135932,19994420,63274,15544265,6249,1286010,87341,4012375,117222,17134013,94739,21146388,
All CA Counties,2021-05-23,90863,36915558,63202,20057622,24959,15569224,2702,1288712,38750,4002559,51661,17185674,41845,21188233,
All CA Counties,2021-05-24,171913,37087471,100828,20158450,62727,15631951,8358,1297070,64842,3970434,106172,17291846,74047,21262280,
All CA Counties,2021-05-25,190341,37277812,111524,20269974,70723,15702674,8094,1305164,71721,3933875,117501,17409347,80942,21343222,
All CA Counties,2021-05-26,185222,37463034,106431,20376405,70908,15773582,7883,1313047,71572,3901559,112480,17521827,80164,21423386,
All CA Counties,2021-05-27,172686,37635720,98628,20475033,65528,15839110,8530,1321577,69129,3877646,102637,17624464,78724,21502110,
All CA Counties,2021-05-28,189501,37825221,109296,20584329,73039,15912149,7166,1328743,81488,3860491,106933,17731397,89778,21591888,
All CA Counties,2021-05-29,107400,37932621,65923,20650252,37634,15949783,3843,1332586,50043,3858123,56755,17788152,54387,21646275,
All CA Counties,2021-05-30,47325,37979946,31242,20681494,13616,15963399,2467,1335053,20662,3855085,26383,17814535,23345,21669620,
All CA Counties,2021-05-31,19883,37999829,11717,20693211,7187,15970586,979,1336032,6436,3849368,13246,17827781,7529,21677149,
All CA Counties,2021-06-01,168927,38168756,98439,20791650,63297,16033883,7191,1343223,59504,3808619,108319,17936100,67570,21744719,
All CA Counties,2021-06-02,143098,38311854,84592,20876242,51360,16085243,7146,1350369,53857,3782034,88276,18024376,61691,21806410,
All CA Counties,2021-06-03,171364,38483218,117133,20993375,47144,16132387,7087,1357456,51768,3723199,118693,18143069,59858,21866268,
All CA Counties,2021-06-04,199983,38683201,140814,21134189,52953,16185340,6216,1363672,59541,3651493,139295,18282364,67589,21933857,
All CA Counties,2021-06-05,158000,38841201,119163,21253352,33173,16218513,5664,1369336,43672,3588267,113511,18395875,50285,21984142,
All CA Counties,2021-06-06,64216,38905417,54109,21307461,7883,16226396,2224,1371560,16987,3561382,46916,18442791,20031,22004173,
All CA Counties,2021-06-07,136950,39042367,100496,21407957,30536,16256932,5918,1377478,40196,3512120,96094,18538885,46832,22051005,
All CA Counties,2021-06-08,158637,39201004,115113,21523070,36700,16293632,6824,1384302,46901,3456081,110796,18649681,54757,22105762,
All CA Counties,2021-06-09,152896,39353900,111127,21634197,34966,16328598,6803,1391105,42271,3396294,109767,18759448,49980,22155742,
All CA Counties,2021-06-10,147204,39501104,105849,21740046,33976,16362574,7379,1398484,42540,3343375,103893,18863341,50974,22206716,
All CA Counties,2021-06-11,159909,39661013,112336,21852382,40820,16403394,6753,1405237,49693,3291453,109274,18972615,57352,22264068,
All CA Counties,2021-06-12,115233,39776246,87235,21939617,24257,16427651,3741,1408978,32708,3246628,81946,19054561,37121,22301189,
All CA Counties,2021-06-13,44830,39821076,33420,21973037,9356,16437007,2054,1411032,11077,3226662,33494,19088055,13528,22314717,
All CA Counties,2021-06-14,115802,39936878,82327,22055364,26687,16463694,6788,1417820,38071,3195038,77089,19165144,45465,22360182,
All CA Counties,2021-06-15,132243,40069121,89228,22144592,34198,16497892,8817,1426637,43965,3161349,87372,19252516,53683,22413865,
All CA Counties,2021-06-16,121397,40190518,85478,22230070,28176,16526068,7743,1434380,41523,3132282,79078,19331594,50011,22463876,
All CA Counties,2021-06-17,114869,40305387,79579,22309649,27395,16553463,7895,1442275,40425,3107558,73682,19405276,48958,22512834,
All CA Counties,2021-06-18,129740,40435127,89973,22399622,32246,16585709,7521,1449796,46414,3079862,82386,19487662,54690,22567524,
All CA Counties,2021-06-19,77102,40512229,56053,22455675,17024,16602733,4025,1453821,28640,3065204,47854,19535516,33196,22600720,
All CA Counties,2021-06-20,30813,40543042,23214,22478889,6244,16608977,1355,1455176,11568,3059320,19027,19554543,13143,22613863,
All CA Counties,2021-06-21,71679,40614721,44911,22523800,20720,16629697,6048,1461224,36629,3067885,34636,19589179,43201,22657064,
All CA Counties,2021-06-22,101008,40715729,70490,22594290,24564,16654261,5954,1467178,39184,3052488,61195,19650374,45798,22702862,
All CA Counties,2021-06-23,94383,40810112,66629,22660919,21978,16676239,5776,1472954,38340,3041758,55431,19705805,44701,22747563,
All CA Counties,2021-06-24,91710,40901822,63981,22724900,22087,16698326,5642,1478596,37012,3030967,54006,19759811,43215,22790778,
All CA Counties,2021-06-25,105750,41007572,74865,22799765,25542,16723868,5343,1483939,43113,3018049,61962,19821773,49044,22839822,
All CA Counties,2021-06-26,67890,41075462,51193,22850958,13565,16737433,3132,1487071,27940,3010121,39568,19861341,31640,22871462,
All CA Counties,2021-06-27,31575,41107037,24278,22875236,5753,16743186,1544,1488615,13380,3007274,18001,19879342,15154,22886616,
All CA Counties,2021-06-28,72086,41179123,55792,22931028,11856,16755042,4438,1493053,31384,3003377,40183,19919525,36286,22922902,
All CA Counties,2021-06-29,84055,41263178,59660,22990688,20122,16775164,4273,1497326,35284,2995276,48223,19967748,40122,22963024,
All CA Counties,2021-06-30,79535,41342713,56983,23047671,18667,16793831,3885,1501211,35519,2991831,43412,20011160,39967,23002991,
All CA Counties,2021-07-01,74320,41417033,53563,23101234,16801,16810632,3956,1505167,32557,2987596,41283,20052443,37048,23040039,
All CA Counties,2021-07-02,84646,41501679,60545,23161779,20183,16830815,3918,1509085,37265,2982473,46819,20099262,41696,23081735,
All CA Counties,2021-07-03,46405,41548084,33846,23195625,10846,16841661,1713,1510798,20959,2980382,25081,20124343,22990,23104725,
All CA Counties,2021-07-04,3406,41551490,1980,23197605,1153,16842814,273,1511071,1493,2980324,1881,20126224,1823,23106548,
All CA Counties,2021-07-05,40839,41592329,30238,23227843,9006,16851820,1595,1512666,18867,2979376,21699,20147923,20751,23127299,
All CA Counties,2021-07-06,86516,41678845,63341,23291184,19130,16870950,4045,1516711,33052,2964213,52878,20200801,37715,23165014,
All CA Counties,2021-07-07,73497,41752342,53077,23344261,16356,16887306,4064,1520775,30327,2956542,42654,20243455,34983,23199997,
All CA Counties,2021-07-08,70478,41822820,50551,23394812,16019,16903325,3908,1524683,29336,2949587,40686,20284141,33731,23233728,
All CA Counties,2021-07-09,82364,41905184,58755,23453567,19105,16922430,4504,1529187,35200,2943189,46601,20330742,40203,23273931,
All CA Counties,2021-07-10,51568,41956752,38171,23491738,10884,16933314,2513,1531700,22438,2939742,28759,20359501,25312,23299243,
All CA Counties,2021-07-11,23409,41980161,17499,23509237,4887,16938201,1023,1532723,10875,2939437,12348,20371849,12043,23311286,
All CA Counties,2021-07-12,65828,42045989,48663,23557900,13665,16951866,3500,1536223,27559,2933114,37864,20409713,31541,23342827,
All CA Counties,2021-07-13,69542,42115531,49745,23607645,16582,16968448,3215,1539438,31184,2930115,37870,20447583,34871,23377698,
All CA Counties,2021-07-14,66727,42182258,47978,23655623,15559,16984007,3190,1542628,29663,2926832,36599,20484182,33316,23411014,
All CA Counties,2021-07-15,67344,42249602,49474,23705097,15082,16999089,2788,1545416,31285,2925800,35583,20519765,34551,23445565,
All CA Counties,2021-07-16,81986,42331588,59437,23764534,19201,17018290,3348,1548764,39338,2926823,42141,20561906,43164,23488729,
All CA Counties,2021-07-17,53235,42384823,39283,23803817,11935,17030225,2017,1550781,25709,2927704,27136,20589042,28017,23516746,
All CA Counties,2021-07-18,25568,42410391,19385,23823202,5139,17035364,1044,1551825,12756,2929041,12609,20601651,13946,23530692,
All CA Counties,2021-07-19,66874,42477265,49821,23873023,13989,17049353,3064,1554889,32913,2931977,33505,20635156,36441,23567133,
All CA Counties,2021-07-20,75480,42552745,53897,23926920,18341,17067694,3242,1558131,38373,2937551,36526,20671682,42100,23609233,
All CA Counties,2021-07-21,73726,42626471,53488,23980408,16836,17084530,3402,1561533,37529,2943279,35656,20707338,41384,23650617,
All CA Counties,2021-07-22,73876,42700347,53448,24033856,17155,17101685,3273,1564806,39320,2952299,33967,20741305,42987,23693604,
All CA Counties,2021-07-23,87167,42787514,62642,24096498,20899,17122584,3626,1568432,47407,2964652,39121,20780426,51474,23745078,
All CA Counties,2021-07-24,53864,42841378,39129,24135627,12790,17135374,1945,1570377,30188,2973776,23240,20803666,32364,23777442,
All CA Counties,2021-07-25,24407,42865785,18105,24153732,5692,17141066,610,1570987,17838,2985966,6385,20810051,18575,23796017,
All CA Counties,2021-07-26,67829,42933614,48474,24202206,16305,17157371,3050,1574037,42094,3006191,25245,20835296,45470,23841487,
All CA Counties,2021-07-27,79930,43013544,57982,24260188,18556,17175927,3392,1577429,46112,3022810,33218,20868514,49837,23891324,
All CA Counties,2021-07-28,79074,43092618,57196,24317384,18478,17194405,3400,1580829,46734,3041616,31695,20900209,50501,23941825,
All CA Counties,2021-07-29,75402,43168020,54851,24372235,17406,17211811,3145,1583974,45350,3061087,29383,20929592,48854,23990679,
All CA Counties,2021-07-30,86248,43254268,62600,24434835,20499,17232310,3149,1587123,51022,3081396,34343,20963935,54652,24045331,
All CA Counties,2021-07-31,34309,43288577,24899,24459734,7894,17240204,1516,1588639,20384,3089897,13575,20977510,22076,24067407,
All CA and Non-CA Counties,2020-12-15,1198,1198,1198,1198,0,0,0,0,1198,1198,0,0,1198,1198,
All CA and Non-CA Counties,2020-12-16,9017,10215,9017,10215,0,0,0,0,9017,10215,0,0,9017,10215,
All CA and Non-CA Counties,2020-12-17,28368,38583,28368,38583,0,0,0,0,28368,38583,0,0,28368,38583,
All CA and Non-CA Counties,2020-12-18,47983,86566,47907,86490,76,76,0,0,47982,86564,1,1,47982,86565,
All CA and Non-CA Counties,2020-12-19,26623,113189,26592,113082,31,107,0,0,26622,113185,1,2,26622,113187,
All CA and Non-CA Counties,2020-12-20,19847,133036,19807,132889,40,147,0,0,19845,133028,2,4,19845,133032,
All CA and Non-CA Counties,2020-12-21,52115,185151,52006,184895,109,256,0,0,52112,185138,3,7,52113,185145,
All CA and Non-CA Counties,2020-12-22,52387,237538,50147,235042,2240,2496,0,0,52378,237507,9,16,52378,237523,
All CA and Non-CA Counties,2020-12-23,52386,289924,43385,278427,9001,11497,0,0,52378,289880,8,24,52381,289904,
All CA and Non-CA Counties,2020-12-24,24964,314888,16993,295420,7971,19468,0,0,24957,314833,6,30,24959,314863,
All CA and Non-CA Counties,2020-12-25,2393,317281,2062,297482,331,19799,0,0,2393,317226,0,30,2393,317256,
All CA and Non-CA Counties,2020-12-26,14974,332255,9698,307180,5276,25075,0,0,14972,332196,2,32,14972,332228,
All CA and Non-CA Counties,2020-12-27,9676,341931,5694,312874,3982,29057,0,0,9673,341866,3,35,9673,341901,
All CA and Non-CA Counties,2020-12-28,47727,389658,30543,343417,17184,46241,0,0,47720,389580,6,41,47720,389621,
All CA and Non-CA Counties,2020-12-29,53053,442711,29677,373094,23376,69617,0,0,53047,442622,5,46,53047,442668,
All CA and Non-CA Counties,2020-12-30,65248,507959,36987,410081,28261,97878,0,0,65235,507850,10,56,65238,507906,
All CA and Non-CA Counties,2020-12-31,30802,538761,11559,421640,19243,117121,0,0,30777,538606,22,78,30778,538684,
All CA and Non-CA Counties,2021-01-01,5180,543941,2395,424035,2785,119906,0,0,5168,543764,10,88,5168,543852,
All CA and Non-CA Counties,2021-01-02,18842,562783,10418,434453,8424,128330,0,0,18835,562596,3,91,18835,562687,
All CA and Non-CA Counties,2021-01-03,6455,569238,3617,438070,2838,131168,0,0,6421,569004,13,104,6421,569108,
All CA and Non-CA Counties,2021-01-04,45019,614257,22612,460682,22407,153575,0,0,44932,613894,42,146,44932,614040,
All CA and Non-CA Counties,2021-01-05,58563,672820,30933,491615,27630,181205,0,0,52559,660625,5932,6078,52663,666703,
All CA and Non-CA Counties,2021-01-06,76647,749467,42434,534049,34213,215418,0,0,59963,704145,16490,22568,60010,726713,
All CA and Non-CA Counties,2021-01-07,97307,846774,55640,589689,41667,257085,0,0,63783,734659,33333,55901,63847,790560,
All CA and Non-CA Counties,2021-01-08,112641,959415,67896,657585,44745,301830,0,0,68435,759138,44040,99941,68519,859079,
All CA and Non-CA Counties,2021-01-09,46107,1005522,26361,683946,19746,321576,0,0,29001,771096,17074,117015,29032,888111,
All CA and Non-CA Counties,2021-01-10,24848,1030370,15188,699134,9660,331236,0,0,13395,773077,11435,128450,13416,901527,
All CA and Non-CA Counties,2021-01-11,108555,1138925,72196,771330,36359,367595,0,0,62889,790541,45614,174064,63078,964605,
All CA and Non-CA Counties,2021-01-12,118755,1257680,70389,841719,48366,415961,0,0,75415,823051,43232,217296,75742,1040347,
All CA and Non-CA Counties,2021-01-13,123903,1381583,64261,905980,59642,475603,0,0,88566,876478,35239,252535,88666,1129013,
All CA and Non-CA Counties,2021-01-14,128998,1510581,51511,957491,77487,553090,0,0,108405,964627,20460,272995,108609,1237622,
All CA and Non-CA Counties,2021-01-15,147109,1657690,53158,1010649,93951,647041,0,0,131338,1080580,15636,288631,131589,1369211,
All CA and Non-CA Counties,2021-01-16,83885,1741575,27872,1038521,56013,703054,0,0,76047,1148877,7805,296436,76102,1445313,
All CA and Non-CA Counties,2021-01-17,48950,1790525,17104,1055625,31846,734900,0,0,45186,1190359,3751,300187,45233,1490546,
All CA and Non-CA Counties,2021-01-18,89860,1880385,47018,1102643,42842,777742,0,0,69909,1240582,19873,320060,70096,1560642,
All CA and Non-CA Counties,2021-01-19,147023,2027408,74981,1177624,72042,849784,0,0,114719,1323444,32195,352255,115057,1675699,
All CA and Non-CA Counties,2021-01-20,168763,2196171,86296,1263920,82467,932251,0,0,133346,1421916,35155,387410,133627,1809326,
All CA and Non-CA Counties,2021-01-21,180852,2377023,80206,1344126,100646,1032897,0,0,160437,1562596,20159,407569,160839,1970165,
All CA and Non-CA Counties,2021-01-22,175993,2553016,71062,1415188,104931,1137828,0,0,160907,1708739,14931,422500,161074,2131239,
All CA and Non-CA Counties,2021-01-23,114501,2667517,49920,1465108,64581,1202409,0,0,101647,1797728,12784,435284,101773,2233012,
All CA and Non-CA Counties,2021-01-24,62056,2729573,29719,1494827,32337,1234746,0,0,57231,1850241,4789,440073,57302,2290314,
All CA and Non-CA Counties,2021-01-25,150882,2880455,67761,1562588,83121,1317867,0,0,114364,1928657,36350,476423,114766,2405080,
All CA and Non-CA Counties,2021-01-26,176521,3056976,86405,1648993,90116,1407983,0,0,137358,2027301,39002,515425,137646,2542726,
All CA and Non-CA Counties,2021-01-27,189015,3245991,90896,1739889,98119,1506102,0,0,148108,2135096,40549,555974,148344,2691070,
All CA and Non-CA Counties,2021-01-28,194924,3440915,90069,1829958,104855,1610957,0,0,159504,2259762,35089,591063,159755,2850825,
All CA and Non-CA Counties,2021-01-29,190343,3631258,91804,1921762,98539,1709496,0,0,154051,2378374,35634,626697,154246,3005071,
All CA and Non-CA Counties,2021-01-30,129100,3760358,57916,1979678,71184,1780680,0,0,113182,2475978,15736,642433,113340,3118411,
All CA and Non-CA Counties,2021-01-31,72730,3833088,41435,2021113,31295,1811975,0,0,67568,2538514,5096,647529,67632,3186043,
All CA and Non-CA Counties,2021-02-01,168699,4001787,78590,2099703,90109,1902084,0,0,126264,2622691,42211,689740,126388,3312431,
All CA and Non-CA Counties,2021-02-02,194158,4195945,81001,2180704,113157,2015241,0,0,147986,2725092,45815,735555,148216,3460647,
All CA and Non-CA Counties,2021-02-03,220083,4416028,97960,2278664,122123,2137364,0,0,163721,2833280,55794,791349,163982,3624629,
All CA and Non-CA Counties,2021-02-04,236610,4652638,102288,2380952,134322,2271686,0,0,173706,2945081,62281,853630,174082,3798711,
All CA and Non-CA Counties,2021-02-05,255000,4907638,108843,2489795,146157,2417843,0,0,173666,3038899,80418,934048,174236,3972947,
All CA and Non-CA Counties,2021-02-06,160798,5068436,77131,2566926,83667,2501510,0,0,125085,3129023,35467,969515,125591,4098538,
All CA and Non-CA Counties,2021-02-07,69399,5137835,45214,2612140,24185,2525695,0,0,52661,3165508,16633,986148,53118,4151656,
All CA and Non-CA Counties,2021-02-08,187805,5325640,92834,2704974,94971,2620666,0,0,124228,3227457,63046,1049194,124995,4276651,
All CA and Non-CA Counties,2021-02-09,217728,5543368,104521,2809495,113207,2733873,0,0,130291,3272423,86558,1135752,131524,4408175,
All CA and Non-CA Counties,2021-02-10,256883,5800251,122656,2932151,134227,2868100,0,0,140950,3299936,114947,1250699,142460,4550635,
All CA and Non-CA Counties,2021-02-11,272952,6073203,134609,3066760,138343,3006443,0,0,148222,3326611,123401,1374100,150076,4700711,
All CA and Non-CA Counties,2021-02-12,280954,6354157,122373,3189133,158581,3165024,0,0,151443,3352049,128404,1502504,153842,4854553,
All CA and Non-CA Counties,2021-02-13,171656,6525813,79015,3268148,92641,3257665,0,0,95019,3372854,76190,1578694,96995,4951548,
All CA and Non-CA Counties,2021-02-14,97937,6623750,48460,3316608,49477,3307142,0,0,53018,3382725,44706,1623400,54577,5006125,
All CA and Non-CA Counties,2021-02-15,146819,6770569,64756,3381364,82063,3389205,0,0,80728,3400995,65601,1689001,83871,5089996,
All CA and Non-CA Counties,2021-02-16,258902,7029471,122471,3503835,136431,3525636,0,0,136958,3419603,121433,1810434,140041,5230037,
All CA and Non-CA Counties,2021-02-17,268580,7298051,133578,3637413,135002,3660638,0,0,131845,3418651,136009,1946443,135057,5365094,
All CA and Non-CA Counties,2021-02-18,283191,7581242,147917,3785330,135274,3795912,0,0,135257,3411168,146990,2093433,139507,5504601,
All CA and Non-CA Counties,2021-02-19,263765,7845007,153598,3938928,110167,3906079,0,0,134792,3419813,128240,2221673,136885,5641486,
All CA and Non-CA Counties,2021-02-20,160934,8005941,103324,4042252,57610,3963689,0,0,87151,3435570,73392,2295065,89149,5730635,
All CA and Non-CA Counties,2021-02-21,90283,8096224,73161,4115413,17122,3980811,0,0,45512,3438213,44426,2339491,47069,5777704,
All CA and Non-CA Counties,2021-02-22,177059,8273283,118796,4234209,58263,4039074,0,0,87241,3437955,89229,2428720,88971,5866675,
All CA and Non-CA Counties,2021-02-23,243812,8517095,128749,4362958,115063,4154137,0,0,111689,3424589,131079,2559799,117713,5984388,
All CA and Non-CA Counties,2021-02-24,303209,8820304,153625,4516583,149584,4303721,0,0,141929,3413839,160263,2720062,149513,6133901,
All CA and Non-CA Counties,2021-02-25,343985,9164289,169900,4686483,174085,4477806,0,0,178150,3435804,164770,2884832,186735,6320636,
All CA and Non-CA Counties,2021-02-26,378989,9543278,177141,4863624,201848,4679654,0,0,208871,3483233,168749,3053581,216178,6536814,
All CA and Non-CA Counties,2021-02-27,271116,9814394,131744,4995368,139340,4818994,32,32,151347,3520172,118878,3172459,155817,6692631,
All CA and Non-CA Counties,2021-02-28,144456,9958850,86325,5081693,58116,4877110,15,47,82851,3544929,60968,3233427,85725,6778356,
All CA and Non-CA Counties,2021-03-01,259324,10218174,138302,5219995,120835,4997945,187,234,147160,3585290,111025,3344452,151386,6929742,
All CA and Non-CA Counties,2021-03-02,308993,10527167,154541,5374536,154415,5152360,37,271,181742,3647499,126479,3470931,188688,7118430,
All CA and Non-CA Counties,2021-03-03,352825,10879992,174090,5548626,178654,5331014,81,352,201005,3705022,150907,3621838,208430,7326860,
All CA and Non-CA Counties,2021-03-04,369548,11249540,185542,5734168,183897,5514911,109,461,213980,3771599,154563,3776401,221140,7548000,
All CA and Non-CA Counties,2021-03-05,355430,11604970,174058,5908226,180210,5695121,1162,1623,219003,3863675,135399,3911800,227475,7775475,
All CA and Non-CA Counties,2021-03-06,268786,11873756,137461,6045687,123232,5818353,8093,9716,165649,3939489,102588,4014388,178402,7953877,
All CA and Non-CA Counties,2021-03-07,135742,12009498,80595,6126282,48087,5866440,7060,16776,82919,3980570,52550,4066938,93631,8047508,
All CA and Non-CA Counties,2021-03-08,228862,12238360,111645,6237927,105927,5972367,11290,28066,149181,4066786,79152,4146090,165368,8212876,
All CA and Non-CA Counties,2021-03-09,301421,12539781,143694,6381621,141082,6113449,16645,44711,168350,4123291,132404,4278494,188909,8401785,
All CA and Non-CA Counties,2021-03-10,332219,12872000,164938,6546559,141959,6255408,25322,70033,179420,4180106,151926,4430420,208741,8610526,
All CA and Non-CA Counties,2021-03-11,387974,13259974,187734,6734293,165854,6421262,34386,104419,198381,4228471,188398,4618818,236763,8847289,
All CA and Non-CA Counties,2021-03-12,406320,13666294,182334,6916627,176740,6598002,47246,151665,199135,4272579,206107,4824925,250215,9097504,
All CA and Non-CA Counties,2021-03-13,291299,13957593,127930,7044557,131527,6729529,31842,183507,157976,4333709,132732,4957657,193862,9291366,
All CA and Non-CA Counties,2021-03-14,158899,14116492,84636,7129193,58780,6788309,15483,198990,79631,4352095,78881,5036538,97267,9388633,
All CA and Non-CA Counties,2021-03-15,297717,14414209,142495,7271688,134020,6922329,21202,220192,160635,4401161,136090,5172628,185156,9573789,
All CA and Non-CA Counties,2021-03-16,381662,14795871,180262,7451950,183495,7105824,17905,238097,219488,4480477,161174,5333802,240490,9814279,
All CA and Non-CA Counties,2021-03-17,398210,15194081,198756,7650706,180296,7286120,19158,257255,245154,4595187,151969,5485771,266679,10080958,
All CA and Non-CA Counties,2021-03-18,415309,15609390,213738,7864444,182590,7468710,18981,276236,243618,4689471,170339,5656110,264623,10345581,
All CA and Non-CA Counties,2021-03-19,423240,16032630,223229,8087673,177533,7646243,22478,298714,242850,4777601,179156,5835266,267286,10612867,
All CA and Non-CA Counties,2021-03-20,303425,16336055,160088,8247761,127228,7773471,16109,314823,190666,4873927,111900,5947166,208226,10821093,
All CA and Non-CA Counties,2021-03-21,147854,16483909,102016,8349777,38183,7811654,7655,322478,88359,4912308,58985,6006151,97366,10918459,
All CA and Non-CA Counties,2021-03-22,280121,16764030,163362,8513139,105391,7917045,11368,333846,180536,5008650,98565,6104716,194907,11113366,
All CA and Non-CA Counties,2021-03-23,368516,17132546,202957,8716096,154102,8071147,11457,345303,224193,5103697,143171,6247887,238218,11351584,
All CA and Non-CA Counties,2021-03-24,399634,17532180,228066,8944162,158486,8229633,13082,358385,229885,5180454,168244,6416131,245001,11596585,
All CA and Non-CA Counties,2021-03-25,431386,17963566,236883,9181045,178988,8408621,15515,373900,242565,5253422,187206,6603337,260174,11856759,
All CA and Non-CA Counties,2021-03-26,446866,18410432,238552,9419597,191854,8600475,16460,390360,238504,5304378,206784,6810121,257740,12114499,
All CA and Non-CA Counties,2021-03-27,322279,18732711,171104,9590701,139096,8739571,12079,402439,161249,5319931,159974,6970095,175527,12290026,
All CA and Non-CA Counties,2021-03-28,174319,18907030,111674,9702375,58870,8798441,3775,406214,90314,5332931,83431,7053526,96431,12386457,
All CA and Non-CA Counties,2021-03-29,319330,19226360,171060,9873435,138730,8937171,9540,415754,175394,5377443,142899,7196425,187411,12573868,
All CA and Non-CA Counties,2021-03-30,409721,19636081,207645,10081080,183164,9120335,18912,434666,228481,5446324,180212,7376637,249093,12822961,
All CA and Non-CA Counties,2021-03-31,436887,20072968,237596,10318676,176426,9296761,22865,457531,240691,5515931,194874,7571511,264481,13087442,
All CA and Non-CA Counties,2021-04-01,505422,20578390,259082,10577758,204603,9501364,41737,499268,276181,5607231,227361,7798872,318661,13406103,
All CA and Non-CA Counties,2021-04-02,486621,21065011,237359,10815117,204493,9705857,44769,544037,261680,5691602,223424,8022296,307795,13713898,
All CA and Non-CA Counties,2021-04-03,338126,21403137,172931,10988048,122287,9828144,42908,586945,167883,5733815,169444,8191740,211657,13925555,
All CA and Non-CA Counties,2021-04-04,134879,21538016,70319,11058367,45182,9873326,19378,606323,58907,5736507,75583,8267323,78275,14003830,
All CA and Non-CA Counties,2021-04-05,361206,21899222,185690,11244057,134419,10007745,41097,647420,175767,5771040,184532,8451855,219065,14222895,
All CA and Non-CA Counties,2021-04-06,469256,22368478,237614,11481671,164040,10171785,67602,715022,225660,5823503,242398,8694253,294861,14517756,
All CA and Non-CA Counties,2021-04-07,485168,22853646,252281,11733952,160650,10332435,72237,787259,233820,5880124,250139,8944392,306760,14824516,
All CA and Non-CA Counties,2021-04-08,512027,23365673,258484,11992436,166506,10498941,87037,874296,239516,5937492,271020,9215412,328388,15152904,
All CA and Non-CA Counties,2021-04-09,508135,23873808,252907,12245343,172493,10671434,82735,957031,232552,5981204,274260,9489672,317972,15470876,
All CA and Non-CA Counties,2021-04-10,378033,24251841,172223,12417566,129067,10800501,76743,1033774,157419,5998079,219690,9709362,236565,15707441,
All CA and Non-CA Counties,2021-04-11,192390,24444231,107571,12525137,49711,10850212,35108,1068882,78991,6001906,112948,9822310,116775,15824216,
All CA and Non-CA Counties,2021-04-12,347522,24791753,178600,12703737,129713,10979925,39209,1108091,159879,6017983,186467,10008777,202544,16026760,
All CA and Non-CA Counties,2021-04-13,443729,25235482,248702,12952439,194035,11173960,992,1109083,246774,6073085,195689,10204466,250791,16277551,
All CA and Non-CA Counties,2021-04-14,462444,25697926,259733,13212172,202399,11376359,312,1109395,240063,6097025,220958,10425424,244898,16522449,
All CA and Non-CA Counties,2021-04-15,502862,26200788,292751,13504923,209783,11586142,328,1109723,279234,6157646,221801,10647225,282422,16804871,
All CA and Non-CA Counties,2021-04-16,488496,26689284,274383,13779306,213788,11799930,325,1110048,259159,6191854,227729,10874954,261937,17066808,
All CA and Non-CA Counties,2021-04-17,353384,27042668,197863,13977169,155456,11955386,65,1110113,200085,6242960,152221,11027175,203327,17270135,
All CA and Non-CA Counties,2021-04-18,164614,27207282,105654,14082823,58936,12014322,24,1110137,83996,6249945,80078,11107253,87063,17357198,
All CA and Non-CA Counties,2021-04-19,328285,27535567,188114,14270937,140065,12154387,106,1110243,154281,6233352,172851,11280104,156258,17513456,
All CA and Non-CA Counties,2021-04-20,425873,27961440,229343,14500280,196446,12350833,84,1110327,209333,6230685,215169,11495273,212502,17725958,
All CA and Non-CA Counties,2021-04-21,450058,28411498,259221,14759501,190543,12541376,294,1110621,214407,6215104,233728,11729001,218147,17944105,
All CA and Non-CA Counties,2021-04-22,467987,28879485,268697,15028198,199193,12740569,97,1110718,207381,6167015,258821,11987822,210732,18154837,
All CA and Non-CA Counties,2021-04-23,459961,29339446,263715,15291913,196145,12936714,101,1110819,207942,6128162,250283,12238105,211430,18366267,
All CA and Non-CA Counties,2021-04-24,336039,29675485,211019,15502932,124821,13061535,199,1111018,169715,6136261,165111,12403216,173210,18539477,
All CA and Non-CA Counties,2021-04-25,154659,29830144,101136,15604068,53443,13114978,80,1111098,82452,6148659,71617,12474833,84015,18623492,
All CA and Non-CA Counties,2021-04-26,312704,30142848,181328,15785396,129784,13244762,1592,1112690,136510,6116308,174977,12649810,142626,18766118,
All CA and Non-CA Counties,2021-04-27,382206,30525054,211070,15996466,164079,13408841,7057,1119747,153819,6053380,226996,12876806,164068,18930186,
All CA and Non-CA Counties,2021-04-28,368162,30893216,212005,16208471,147732,13556573,8425,1128172,151550,6000515,215195,13092001,162330,19092516,
All CA and Non-CA Counties,2021-04-29,378215,31271431,218962,16427433,150780,13707353,8473,1136645,139128,5912445,237561,13329562,149491,19242007,
All CA and Non-CA Counties,2021-04-30,391209,31662640,224977,16652410,156750,13864103,9482,1146127,149074,5832515,240481,13570043,160551,19402558,
All CA and Non-CA Counties,2021-05-01,255313,31917953,162495,16814905,86187,13950290,6631,1152758,92965,5773172,161173,13731216,101830,19504388,
All CA and Non-CA Counties,2021-05-02,119871,32037824,83657,16898562,32172,13982462,4042,1156800,42034,5742271,77346,13808562,46445,19550833,
All CA and Non-CA Counties,2021-05-03,260877,32298701,160399,17058961,91332,14073794,9146,1165946,79620,5651743,180193,13988755,89665,19640498,
All CA and Non-CA Counties,2021-05-04,340983,32639684,209243,17268204,121379,14195173,10361,1176307,100609,5524829,239068,14227823,112154,19752652,
All CA and Non-CA Counties,2021-05-05,346679,32986363,216772,17484976,119394,14314567,10513,1186820,98310,5387836,246887,14474710,109894,19862546,
All CA and Non-CA Counties,2021-05-06,364824,33351187,239576,17724552,114270,14428837,10978,1197798,92731,5223878,270161,14744871,106203,19968749,
All CA and Non-CA Counties,2021-05-07,360547,33711734,226267,17950819,123958,14552795,10322,1208120,98215,5073020,260664,15005535,109806,20078555,
All CA and Non-CA Counties,2021-05-08,238802,33950536,152350,18103169,79176,14631971,7276,1215396,65902,4975908,171765,15177300,74653,20153208,
All CA and Non-CA Counties,2021-05-09,97452,34047988,73581,18176750,20744,14652715,3127,1218523,25790,4933988,71278,15248578,29358,20182566,
All CA and Non-CA Counties,2021-05-10,211708,34259696,121120,18297870,82292,14735007,8296,1226819,52516,4837917,158183,15406761,62112,20244678,
All CA and Non-CA Counties,2021-05-11,280912,34540608,160371,18458241,111505,14846512,9036,1235855,74184,4717363,205587,15612348,85033,20329711,
All CA and Non-CA Counties,2021-05-12,277423,34818031,161162,18619403,106746,14953258,9515,1245370,74636,4601110,201556,15813904,85303,20415014,
All CA and Non-CA Counties,2021-05-13,323004,35141035,208075,18827478,107250,15060508,7679,1253049,121451,4532661,200258,16014162,131809,20546823,
All CA and Non-CA Counties,2021-05-14,347060,35488095,222170,19049648,115678,15176186,9212,1262261,135199,4468742,210423,16224585,146504,20693327,
All CA and Non-CA Counties,2021-05-15,285037,35773132,198750,19248398,80093,15256279,6194,1268455,117300,4426527,166698,16391283,124483,20817810,
All CA and Non-CA Counties,2021-05-16,143716,35916848,109999,19358397,30682,15286961,3035,1271490,58617,4404024,84568,16475851,62065,20879875,
All CA and Non-CA Counties,2021-05-17,244433,36161281,160450,19518847,76305,15363266,7678,1279168,96620,4362391,146800,16622651,105167,20985042,
All CA and Non-CA Counties,2021-05-18,286279,36447560,174152,19692999,104357,15467623,7770,1286938,111489,4309518,173556,16796207,120683,21105725,
All CA and Non-CA Counties,2021-05-19,280433,36727993,174483,19867482,98064,15565687,7886,1294824,114271,4267821,164977,16961184,123280,21229005,
All CA and Non-CA Counties,2021-05-20,269449,36997442,160826,20028308,100154,15665841,8469,1303293,102594,4214845,165569,17126753,112593,21341598,
All CA and Non-CA Counties,2021-05-21,287190,37284632,176309,20204617,102621,15768462,8260,1311553,107874,4154319,177904,17304657,117378,21458976,
All CA and Non-CA Counties,2021-05-22,208341,37492973,137834,20342451,64055,15832517,6452,1318005,88880,4132244,118557,17423214,96482,21555458,
All CA and Non-CA Counties,2021-05-23,92478,37585451,64258,20406709,25440,15857957,2780,1320785,39565,4122523,52460,17475674,42739,21598197,
All CA and Non-CA Counties,2021-05-24,174396,37759847,102022,20508731,63668,15921625,8706,1329491,65914,4090418,107572,17583246,75467,21673664,
All CA and Non-CA Counties,2021-05-25,192792,37952639,112678,20621409,71677,15993302,8437,1337928,72749,4053814,118913,17702159,82309,21755973,
All CA and Non-CA Counties,2021-05-26,187668,38140307,107574,20728983,71852,16065154,8242,1346170,72582,4021442,113906,17816065,81534,21837507,
All CA and Non-CA Counties,2021-05-27,174913,38315220,99727,20828710,66356,16131510,8830,1355000,70115,3997579,103871,17919936,80008,21917515,
All CA and Non-CA Counties,2021-05-28,192003,38507223,110558,20939268,73919,16205429,7526,1362526,82607,3980527,108310,18028246,91258,22008773,
All CA and Non-CA Counties,2021-05-29,109117,38616340,66793,21006061,38123,16243552,4201,1366727,50766,3978251,57744,18085990,55468,22064241,
All CA and Non-CA Counties,2021-05-30,48288,38664628,31844,21037905,13849,16257401,2595,1369322,21146,3975351,26857,18112847,23957,22088198,
All CA and Non-CA Counties,2021-05-31,20326,38684954,11918,21049823,7391,16264792,1017,1370339,6631,3969629,13484,18126331,7762,22095960,
All CA and Non-CA Counties,2021-06-01,171123,38856077,99604,21149427,64017,16328809,7502,1377841,60520,3929033,109494,18235825,68898,22164858,
All CA and Non-CA Counties,2021-06-02,145140,39001217,85609,21235036,52032,16380841,7499,1385340,54764,3902587,89400,18325225,62954,22227812,
All CA and Non-CA Counties,2021-06-03,173547,39174764,118340,21353376,47807,16428648,7400,1392740,52748,3843851,119887,18445112,61151,22288963,
All CA and Non-CA Counties,2021-06-04,202559,39377323,142253,21495629,53765,16482413,6541,1399281,60630,3772076,140776,18585888,69001,22357964,
All CA and Non-CA Counties,2021-06-05,159737,39537060,120369,21615998,33537,16515950,5831,1405112,44439,3708821,114472,18700360,51217,22409181,
All CA and Non-CA Counties,2021-06-06,65181,39602241,54834,21670832,8038,16523988,2309,1407421,17435,3681954,47431,18747791,20564,22429745,
All CA and Non-CA Counties,2021-06-07,138901,39741142,101560,21772392,31090,16555078,6251,1413672,40996,3632673,97244,18845035,47963,22477708,
All CA and Non-CA Counties,2021-06-08,160730,39901872,116306,21888698,37254,16592332,7170,1420842,47700,3576488,112085,18957120,55900,22533608,
All CA and Non-CA Counties,2021-06-09,154889,40056761,112322,22001020,35477,16627809,7090,1427932,43070,3516600,110950,19068070,51062,22584670,
All CA and Non-CA Counties,2021-06-10,149199,40205960,107018,22108038,34490,16662299,7691,1435623,43379,3463677,105046,19173116,52123,22636793,
All CA and Non-CA Counties,2021-06-11,162094,40368054,113590,22221628,41417,16703716,7087,1442710,50595,3411716,110550,19283666,58589,22695382,
All CA and Non-CA Counties,2021-06-12,116866,40484920,88456,22310084,24536,16728252,3874,1446584,33332,3366644,82951,19366617,37879,22733261,
All CA and Non-CA Counties,2021-06-13,45767,40530687,34055,22344139,9558,16737810,2154,1448738,11472,3346634,34032,19400649,14022,22747283,
All CA and Non-CA Counties,2021-06-14,117571,40648258,83324,22427463,27155,16764965,7092,1455830,38798,3315005,78123,19478772,46494,22793777,
All CA and Non-CA Counties,2021-06-15,134015,40782273,90201,22517664,34718,16799683,9096,1464926,44737,3281375,88364,19567136,54734,22848511,
All CA and Non-CA Counties,2021-06-16,123118,40905391,86501,22604165,28643,16828326,7974,1472900,42326,3252435,79985,19647121,51045,22899556,
All CA and Non-CA Counties,2021-06-17,116711,41022102,80595,22684760,27864,16856190,8252,1481152,41245,3227870,74699,19721820,50134,22949690,
All CA and Non-CA Counties,2021-06-18,131740,41153842,91076,22775836,32684,16888874,7980,1489132,47245,3200304,83544,19805364,55978,23005668,
All CA and Non-CA Counties,2021-06-19,78170,41232012,56761,22832597,17284,16906158,4125,1493257,29179,3185761,48375,19853739,33832,23039500,
All CA and Non-CA Counties,2021-06-20,31608,41263620,23788,22856385,6418,16912576,1402,1494659,12024,3180046,19360,19873099,13645,23053145,
All CA and Non-CA Counties,2021-06-21,72976,41336596,45566,22901951,21050,16933626,6360,1501019,37322,3189018,35234,19908333,44206,23097351,
All CA and Non-CA Counties,2021-06-22,102657,41439253,71532,22973483,24920,16958546,6205,1507224,40048,3173959,61972,19970305,46913,23144264,
All CA and Non-CA Counties,2021-06-23,96084,41535337,67568,23041051,22421,16980967,6095,1513319,39143,3163458,56323,20026628,45822,23190086,
All CA and Non-CA Counties,2021-06-24,93288,41628625,64904,23105955,22460,17003427,5924,1519243,37832,3153012,54762,20081390,44316,23234402,
All CA and Non-CA Counties,2021-06-25,107529,41736154,75881,23181836,25944,17029371,5704,1524947,43955,3140363,62893,20144283,50244,23284646,
All CA and Non-CA Counties,2021-06-26,69034,41805188,51937,23233773,13782,17043153,3315,1528262,28518,3132634,40130,20184413,32401,23317047,
All CA and Non-CA Counties,2021-06-27,32344,41837532,24877,23258650,5863,17049016,1604,1529866,13826,3129972,18321,20202734,15659,23332706,
All CA and Non-CA Counties,2021-06-28,73517,41911049,56649,23315299,12130,17061146,4738,1534604,32119,3126417,40878,20243612,37323,23370029,
All CA and Non-CA Counties,2021-06-29,85503,41996552,60538,23375837,20455,17081601,4510,1539114,36045,3118631,48904,20292516,41118,23411147,
All CA and Non-CA Counties,2021-06-30,80952,42077504,57803,23433640,19044,17100645,4105,1543219,36271,3115500,44070,20336586,40939,23452086,
All CA and Non-CA Counties,2021-07-01,75736,42153240,54389,23488029,17152,17117797,4195,1547414,33321,3111625,41924,20378510,38049,23490135,
All CA and Non-CA Counties,2021-07-02,86035,42239275,61339,23549368,20537,17138334,4159,1551573,37965,3106762,47498,20426008,42635,23532770,
All CA and Non-CA Counties,2021-07-03,47222,42286497,34426,23583794,10998,17149332,1798,1553371,21476,3104974,25380,20451388,23592,23556362,
All CA and Non-CA Counties,2021-07-04,3510,42290007,2042,23585836,1179,17150511,289,1553660,1555,3104954,1921,20453309,1901,23558263,
All CA and Non-CA Counties,2021-07-05,41870,42331877,30882,23616718,9321,17159832,1667,1555327,19472,3104263,22120,20475429,21429,23579692,
All CA and Non-CA Counties,2021-07-06,87962,42419839,64177,23680895,19450,17179282,4335,1559662,33721,3089286,53650,20529079,38673,23618365,
All CA and Non-CA Counties,2021-07-07,75018,42494857,53880,23734775,16722,17196004,4416,1564078,31072,3081935,43425,20572504,36074,23654439,
All CA and Non-CA Counties,2021-07-08,71804,42566661,51274,23786049,16330,17212334,4200,1568278,29969,3075218,41370,20613874,34653,23689092,
All CA and Non-CA Counties,2021-07-09,83687,42650348,59497,23845546,19440,17231774,4750,1573028,35829,3069010,47286,20661160,41078,23730170,
All CA and Non-CA Counties,2021-07-10,52440,42702788,38791,23884337,11060,17242834,2589,1575617,22949,3065797,29111,20690271,25898,23756068,
All CA and Non-CA Counties,2021-07-11,24046,42726834,17977,23902314,5001,17247835,1068,1576685,11255,3065663,12602,20702873,12468,23768536,
All CA and Non-CA Counties,2021-07-12,67126,42793960,49445,23951759,13955,17261790,3726,1580411,28210,3059579,38502,20741375,32418,23800954,
All CA and Non-CA Counties,2021-07-13,70844,42864804,50549,24002308,16905,17278695,3390,1583801,31822,3056736,38527,20779902,35684,23836638,
All CA and Non-CA Counties,2021-07-14,68133,42932937,48749,24051057,15961,17294656,3423,1587224,30412,3053784,37248,20817150,34296,23870934,
All CA and Non-CA Counties,2021-07-15,68735,43001672,50265,24101322,15427,17310083,3043,1590267,31960,3052970,36296,20853446,35482,23906416,
All CA and Non-CA Counties,2021-07-16,83443,43085115,60249,24161571,19556,17329639,3638,1593905,40083,3054324,42846,20896292,44200,23950616,
All CA and Non-CA Counties,2021-07-17,54167,43139282,39913,24201484,12134,17341773,2120,1596025,26261,3055483,27513,20923805,28672,23979288,
All CA and Non-CA Counties,2021-07-18,26195,43165477,19826,24221310,5273,17347046,1096,1597121,13132,3057000,12859,20936664,14376,23993664,
All CA and Non-CA Counties,2021-07-19,68172,43233649,50646,24271956,14245,17361291,3281,1600402,33630,3060302,34074,20970738,37376,24031040,
All CA and Non-CA Counties,2021-07-20,76966,43310615,54695,24326651,18694,17379985,3577,1603979,39144,3066273,37235,21007973,43206,24074246,
All CA and Non-CA Counties,2021-07-21,75258,43385873,54301,24380952,17267,17397252,3690,1607669,38360,3072427,36350,21044323,42504,24116750,
All CA and Non-CA Counties,2021-07-22,75484,43461357,54368,24435320,17610,17414862,3506,1611175,40248,3081936,34638,21078961,44147,24160897,
All CA and Non-CA Counties,2021-07-23,88705,43550062,63526,24498846,21328,17436190,3851,1615026,48334,3094840,39719,21118680,52623,24213520,
All CA and Non-CA Counties,2021-07-24,54807,43604869,39772,24538618,13008,17449198,2027,1617053,30804,3104341,23561,21142241,33062,24246582,
All CA and Non-CA Counties,2021-07-25,24991,43629860,18523,24557141,5827,17455025,641,1617694,18286,3116883,6512,21148753,19054,24265636,
All CA and Non-CA Counties,2021-07-26,69295,43699155,49294,24606435,16681,17471706,3320,1621014,42939,3137608,25860,21174613,46585,24312221,
All CA and Non-CA Counties,2021-07-27,81391,43780546,58789,24665224,18986,17490692,3616,1624630,47010,3154792,33772,21208385,50956,24363177,
All CA and Non-CA Counties,2021-07-28,80663,43861209,58067,24723291,18984,17509676,3612,1628242,47750,3174262,32260,21240645,51730,24414907,
All CA and Non-CA Counties,2021-07-29,76931,43938140,55729,24779020,17820,17527496,3382,1631624,46276,3194303,29975,21270620,50016,24464923,
All CA and Non-CA Counties,2021-07-30,87756,44025896,63475,24842495,20936,17548432,3345,1634969,51978,3215228,34880,21305500,55805,24520728,
All CA and Non-CA Counties,2021-07-31,35059,44060955,25369,24867864,8097,17556529,1593,1636562,20858,3224009,13847,21319347,22628,24543356,
Alpine,2020-12-15,0,0,0,0,0,0,0,0,0,0,0,0,0,0,
Alpine,2020-12-16,0,0,0,0,0,0,0,0,0,0,0,0,0,0,
Alpine,2020-12-17,0,0,0,0,0,0,0,0,0,0,0,0,0,0,
Alpine,2020-12-20,0,4,0,4,0,0,0,0,0,4,0,0,0,4,
Alpine,2020-12-22,0,5,0,5,0,0,0,0,0,5,0,0,0,5,
Alpine,2020-12-23,0,5,0,5,0,0,0,0,0,5,0,0,0,5,
Alpine,2020-12-24,0,5,0,5,0,0,0,0,0,5,0,0,0,5,
Alpine,2020-12-25,0,5,0,5,0,0,0,0,0,5,0,0,0,5,
Alpine,2020-12-26,0,5,0,5,0,0,0,0,0,5,0,0,0,5,
Alpine,2020-12-27,0,5,0,5,0,0,0,0,0,5,0,0,0,5,
Alpine,2020-12-28,0,5,0,5,0,0,0,0,0,5,0,0,0,5,
Alpine,2021-01-03,0,23,0,6,0,17,0,0,0,23,0,0,0,23,
Alpine,2021-01-10,0,86,0,10,0,76,0,0,0,78,0,4,0,82,
Alpine,2021-01-12,0,118,0,11,0,107,0,0,0,108,0,5,0,113,
Alpine,2021-01-16,0,155,0,11,0,144,0,0,0,145,0,5,0,150,
Alpine,2021-01-17,0,155,0,11,0,144,0,0,0,145,0,5,0,150,
Alpine,2021-01-19,0,156,0,12,0,144,0,0,0,146,0,5,0,151,
Alpine,2021-01-24,0,212,0,13,0,199,0,0,0,200,0,6,0,206,
Alpine,2021-01-27,0,230,0,13,0,217,0,0,0,216,0,7,0,223,
Alpine,2021-01-30,0,232,0,13,0,219,0,0,0,216,0,8,0,224,
Alpine,2021-01-31,0,232,0,13,0,219,0,0,0,216,0,8,0,224,
Alpine,2021-02-02,0,257,0,13,0,244,0,0,0,205,0,26,0,231,
Alpine,2021-02-06,0,331,0,15,0,316,0,0,0,181,0,75,0,256,
Alpine,2021-02-07,0,331,0,15,0,316,0,0,0,181,0,75,0,256,
Alpine,2021-02-09,0,363,0,15,0,348,0,0,0,157,0,103,0,260,
Alpine,2021-02-13,0,404,0,15,0,389,0,0,0,122,0,141,0,263,
Alpine,2021-02-14,0,404,0,15,0,389,0,0,0,122,0,141,0,263,
Alpine,2021-02-15,0,404,0,15,0,389,0,0,0,122,0,141,0,263,
Alpine,2021-02-16,0,404,0,15,0,389,0,0,0,122,0,141,0,263,
Alpine,2021-02-20,0,463,0,16,0,447,0,0,0,75,0,194,0,269,
Alpine,2021-02-21,0,463,0,16,0,447,0,0,0,75,0,194,0,269,
Alpine,2021-02-23,0,491,0,16,0,475,0,0,0,63,0,214,0,277,
Alpine,2021-02-24,0,491,0,16,0,475,0,0,0,63,0,214,0,277,
Alpine,2021-02-28,0,528,0,18,0,510,0,0,0,96,0,216,0,312,
Alpine,2021-03-02,0,564,0,18,0,546,0,0,0,112,0,226,0,338,
Alpine,2021-03-06,0,631,0,18,0,613,0,0,0,143,0,244,0,387,
Alpine,2021-03-07,0,631,0,18,0,613,0,0,0,143,0,244,0,387,
Alpine,2021-03-09,0,662,0,18,0,644,0,0,0,170,0,246,0,416,
Alpine,2021-03-13,0,789,0,18,0,771,0,0,0,285,0,252,0,537,
Alpine,2021-03-14,0,789,0,18,0,771,0,0,0,285,0,252,0,537,
Alpine,2021-03-16,0,809,0,18,0,791,0,0,0,303,0,253,0,556,
Alpine,2021-03-20,0,869,0,19,0,849,0,1,0,352,0,259,0,611,
Alpine,2021-03-21,0,869,0,19,0,849,0,1,0,352,0,259,0,611,
Alpine,2021-03-23,0,893,0,19,0,873,0,1,0,358,0,268,0,626,
Alpine,2021-03-26,0,946,0,19,0,925,0,2,0,377,0,285,0,662,
Alpine,2021-03-30,0,967,0,20,0,944,0,3,0,363,0,303,0,666,
Alpine,2021-03-31,0,967,0,20,0,944,0,3,0,363,0,303,0,666,
Alpine,2021-04-03,0,1084,0,20,0,1061,0,3,0,353,0,366,0,719,
Alpine,2021-04-04,0,1084,0,20,0,1061,0,3,0,353,0,366,0,719,
Alpine,2021-04-10,0,1243,0,21,0,1218,0,4,0,282,0,481,0,763,
Alpine,2021-04-11,0,1243,0,21,0,1218,0,4,0,282,0,481,0,763,
Alpine,2021-04-12,0,1243,0,21,0,1218,0,4,0,282,0,481,0,763,
Alpine,2021-04-13,0,1243,0,21,0,1218,0,4,0,282,0,481,0,763,
Alpine,2021-04-16,0,1325,0,21,0,1300,0,4,0,226,0,550,0,776,
Alpine,2021-04-17,0,1325,0,21,0,1300,0,4,0,226,0,550,0,776,
Alpine,2021-04-18,0,1325,0,21,0,1300,0,4,0,226,0,550,0,776,
Alpine,2021-04-20,0,1326,0,21,0,1301,0,4,0,227,0,550,0,777,
Alpine,2021-04-23,0,1381,0,21,0,1356,0,4,0,204,0,589,0,793,
Alpine,2021-04-24,0,1381,0,21,0,1356,0,4,0,204,0,589,0,793,
Alpine,2021-04-26,0,1382,0,22,0,1356,0,4,0,203,0,590,0,793,
Alpine,2021-05-01,0,1427,0,23,0,1399,0,5,0,175,0,627,0,802,
Alpine,2021-05-03,0,1428,0,23,0,1399,0,6,0,175,0,628,0,803,
Alpine,2021-05-04,0,1428,0,23,0,1399,0,6,0,175,0,628,0,803,
Alpine,2021-05-08,0,1454,0,23,0,1425,0,6,0,157,0,650,0,807,
Alpine,2021-05-09,0,1454,0,23,0,1425,0,6,0,157,0,650,0,807,
Alpine,2021-05-11,0,1455,0,23,0,1426,0,6,0,158,0,650,0,808,
Alpine,2021-05-14,0,1459,0,23,0,1429,0,7,0,155,0,654,0,809,
Alpine,2021-05-15,0,1459,0,23,0,1429,0,7,0,155,0,654,0,809,
Alpine,2021-05-16,0,1459,0,23,0,1429,0,7,0,155,0,654,0,809,
Alpine,2021-05-20,0,1477,0,23,0,1447,0,7,0,141,0,670,0,811,
Alpine,2021-05-22,0,1478,0,24,0,1447,0,7,0,140,0,671,0,811,
Alpine,2021-05-23,0,1478,0,24,0,1447,0,7,0,140,0,671,0,811,
Alpine,2021-05-24,0,1478,0,24,0,1447,0,7,0,140,0,671,0,811,
Alpine,2021-05-26,0,1479,0,24,0,1448,0,7,0,139,0,672,0,811,
Alpine,2021-05-30,0,1485,0,27,0,1451,0,7,0,145,0,672,0,817,
Alpine,2021-05-31,0,1485,0,27,0,1451,0,7,0,145,0,672,0,817,
Alpine,2021-06-01,0,1485,0,27,0,1451,0,7,0,145,0,672,0,817,
Alpine,2021-06-03,0,1493,0,27,0,1459,0,7,0,139,0,679,0,818,
Alpine,2021-06-05,0,1494,0,27,0,1460,0,7,0,140,0,679,0,819,
Alpine,2021-06-06,0,1494,0,27,0,1460,0,7,0,140,0,679,0,819,
Alpine,2021-06-08,0,1495,0,27,0,1461,0,7,0,139,0,680,0,819,
Alpine,2021-06-09,0,1495,0,27,0,1461,0,7,0,139,0,680,0,819,
Alpine,2021-06-11,0,1496,0,28,0,1461,0,7,0,140,0,680,0,820,
Alpine,2021-06-12,0,1496,0,28,0,1461,0,7,0,140,0,680,0,820,
Alpine,2021-06-13,0,1496,0,28,0,1461,0,7,0,140,0,680,0,820,
Alpine,2021-06-14,0,1496,0,28,0,1461,0,7,0,140,0,680,0,820,
Alpine,2021-06-16,0,1498,0,29,0,1462,0,7,0,138,0,682,0,820,
Alpine,2021-06-17,0,1498,0,29,0,1462,0,7,0,138,0,682,0,820,
Alpine,2021-06-20,0,1500,0,31,0,1462,0,7,0,136,0,684,0,820,
Alpine,2021-06-21,0,1500,0,31,0,1462,0,7,0,136,0,684,0,820,
Alpine,2021-06-22,0,1500,0,31,0,1462,0,7,0,136,0,684,0,820,
Alpine,2021-06-23,0,1500,0,31,0,1462,0,7,0,136,0,684,0,820,
Alpine,2021-06-24,0,1500,0,31,0,1462,0,7,0,136,0,684,0,820,
Alpine,2021-06-26,0,1501,0,31,0,1463,0,7,0,135,0,685,0,820,
Alpine,2021-06-27,0,1501,0,31,0,1463,0,7,0,135,0,685,0,820,
Alpine,2021-06-28,0,1501,0,31,0,1463,0,7,0,135,0,685,0,820,
Alpine,2021-07-02,0,1504,0,32,0,1465,0,7,0,134,0,687,0,821,
Alpine,2021-07-03,0,1504,0,32,0,1465,0,7,0,134,0,687,0,821,
Alpine,2021-07-04,0,1504,0,32,0,1465,0,7,0,134,0,687,0,821,
Alpine,2021-07-05,0,1504,0,32,0,1465,0,7,0,134,0,687,0,821,
Alpine,2021-07-08,0,1507,0,32,0,1468,0,7,0,137,0,687,0,824,
Alpine,2021-07-09,0,1507,0,32,0,1468,0,7,0,137,0,687,0,824,
Alpine,2021-07-10,0,1507,0,32,0,1468,0,7,0,137,0,687,0,824,
Alpine,2021-07-11,0,1507,0,32,0,1468,0,7,0,137,0,687,0,824,
Alpine,2021-07-12,0,1507,0,32,0,1468,0,7,0,137,0,687,0,824,
Alpine,2021-07-13,0,1507,0,32,0,1468,0,7,0,137,0,687,0,824,
Alpine,2021-07-14,0,1507,0,32,0,1468,0,7,0,137,0,687,0,824,
Alpine,2021-07-15,0,1507,0,32,0,1468,0,7,0,137,0,687,0,824,
Alpine,2021-07-16,0,1507,0,32,0,1468,0,7,0,137,0,687,0,824,
Alpine,2021-07-17,0,1507,0,32,0,1468,0,7,0,137,0,687,0,824,
Alpine,2021-07-18,0,1507,0,32,0,1468,0,7,0,137,0,687,0,824,
Alpine,2021-07-19,0,1507,0,32,0,1468,0,7,0,137,0,687,0,824,
Alpine,2021-07-20,0,1507,0,32,0,1468,0,7,0,137,0,687,0,824,
Alpine,2021-07-21,0,1507,0,32,0,1468,0,7,0,137,0,687,0,824,
Alpine,2021-07-22,0,1507,0,32,0,1468,0,7,0,137,0,687,0,824,
Alpine,2021-07-23,0,1507,0,32,0,1468,0,7,0,137,0,687,0,824,
Alpine,2021-07-25,0,1508,0,32,0,1469,0,7,0,138,0,687,0,825,
Alpine,2021-07-26,0,1508,0,32,0,1469,0,7,0,138,0,687,0,825,
Alpine,2021-07-27,0,1508,0,32,0,1469,0,7,0,138,0,687,0,825,
Alpine,2021-07-28,0,1508,0,32,0,1469,0,7,0,138,0,687,0,825,
Alpine,2021-07-29,0,1508,0,32,0,1469,0,7,0,138,0,687,0,825,
Alpine,2021-07-31,0,1509,0,32,0,1470,0,7,0,138,0,688,0,826,
Amador,2020-12-15,0,0,0,0,0,0,0,0,0,0,0,0,0,0,
Amador,2020-12-25,0,187,0,182,0,5,0,0,0,187,0,0,0,187,
Butte,2020-12-15,0,0,0,0,0,0,0,0,0,0,0,0,0,0,
Butte,2020-12-25,0,2375,0,2353,0,22,0,0,0,2375,0,0,0,2375,
Calaveras,2020-12-15,0,0,0,0,0,0,0,0,0,0,0,0,0,0,
Calaveras,2020-12-25,0,282,0,269,0,13,0,0,0,283,0,0,0,283,
Calaveras,2021-01-01,0,600,0,535,0,65,0,0,0,599,0,1,0,600,
Colusa,2020-12-15,0,0,0,0,0,0,0,0,0,0,0,0,0,0,
Colusa,2020-12-16,0,0,0,0,0,0,0,0,0,0,0,0,0,0,
Colusa,2020-12-17,0,0,0,0,0,0,0,0,0,0,0,0,0,0,
Colusa,2020-12-19,0,1,0,1,0,0,0,0,0,1,0,0,0,1,
Colusa,2020-12-20,0,1,0,1,0,0,0,0,0,1,0,0,0,1,
Colusa,2020-12-25,0,25,0,24,0,1,0,0,0,25,0,0,0,25,
Colusa,2020-12-26,0,25,0,24,0,1,0,0,0,25,0,0,0,25,
Colusa,2021-01-01,0,111,0,50,0,61,0,0,0,111,0,0,0,111,
Colusa,2021-01-02,0,111,0,50,0,61,0,0,0,111,0,0,0,111,
Colusa,2021-01-03,0,111,0,50,0,61,0,0,0,111,0,0,0,111,
Colusa,2021-01-24,0,647,0,321,0,326,0,0,0,549,0,49,0,598,
Del Norte,2020-12-15,0,0,0,0,0,0,0,0,0,0,0,0,0,0,
Del Norte,2020-12-16,0,0,0,0,0,0,0,0,0,0,0,0,0,0,
Del Norte,2020-12-17,0,0,0,0,0,0,0,0,0,0,0,0,0,0,
Del Norte,2020-12-18,0,0,0,0,0,0,0,0,0,0,0,0,0,0,
Del Norte,2020-12-19,0,0,0,0,0,0,0,0,0,0,0,0,0,0,
Del Norte,2020-12-20,0,0,0,0,0,0,0,0,0,0,0,0,0,0,
Del Norte,2020-12-24,0,126,0,116,0,10,0,0,0,124,0,0,0,124,
Del Norte,2020-12-25,0,126,0,116,0,10,0,0,0,124,0,0,0,124,
Del Norte,2020-12-26,0,126,0,116,0,10,0,0,0,124,0,0,0,124,
Del Norte,2020-12-27,0,126,0,116,0,10,0,0,0,124,0,0,0,124,
Del Norte,2021-01-01,0,249,0,224,0,25,0,0,0,247,0,0,0,247,
Del Norte,2021-01-02,0,249,0,224,0,25,0,0,0,247,0,0,0,247,
Del Norte,2021-01-03,0,249,0,224,0,25,0,0,0,247,0,0,0,247,
Del Norte,2021-01-09,0,560,0,300,0,260,0,0,0,558,0,0,0,558,
Del Norte,2021-01-10,0,560,0,300,0,260,0,0,0,558,0,0,0,558,
Del Norte,2021-01-16,0,898,0,427,0,471,0,0,0,711,0,93,0,804,
Del Norte,2021-01-31,0,1793,0,788,0,1005,0,0,0,1192,0,300,0,1492,
Glenn,2020-12-15,0,0,0,0,0,0,0,0,0,0,0,0,0,0,
Glenn,2020-12-16,0,0,0,0,0,0,0,0,0,0,0,0,0,0,
Glenn,2020-12-18,0,1,0,1,0,0,0,0,0,1,0,0,0,1,
Glenn,2020-12-19,0,1,0,1,0,0,0,0,0,1,0,0,0,1,
Glenn,2020-12-25,0,107,0,107,0,0,0,0,0,107,0,0,0,107,
Glenn,2021-01-01,0,380,0,328,0,52,0,0,0,380,0,0,0,380,
Glenn,2021-01-03,0,384,0,332,0,52,0,0,0,384,0,0,0,384,
Glenn,2021-01-09,0,538,0,374,0,164,0,0,0,536,0,1,0,537,
Glenn,2021-02-21,0,5089,0,1753,0,3336,0,0,0,2416,0,1337,0,3753,
Humboldt,2020-12-27,0,1212,0,1129,0,83,0,0,0,1214,0,0,0,1214,
Humboldt,2021-01-03,0,2131,0,1621,0,510,0,0,0,2134,0,0,0,2134,
Imperial,2020-12-15,0,0,0,0,0,0,0,0,0,0,0,0,0,0,
Imperial,2020-12-19,0,21,0,21,0,0,0,0,0,21,0,0,0,21,
Inyo,2020-12-15,0,0,0,0,0,0,0,0,0,0,0,0,0,0,
Inyo,2020-12-16,0,0,0,0,0,0,0,0,0,0,0,0,0,0,
Inyo,2020-12-17,0,0,0,0,0,0,0,0,0,0,0,0,0,0,
Inyo,2020-12-18,0,0,0,0,0,0,0,0,0,0,0,0,0,0,
Inyo,2020-12-27,0,492,0,483,0,9,0,0,0,492,0,0,0,492,
Inyo,2021-01-02,0,643,0,590,0,53,0,0,0,643,0,0,0,643,
Inyo,2021-01-17,0,1525,0,1114,0,411,0,0,0,573,0,477,0,1050,
Inyo,2021-01-24,0,2065,0,1389,0,676,0,0,0,884,0,591,0,1475,
Inyo,2021-03-21,0,8917,0,3981,0,4881,0,55,0,1466,0,3746,0,5212,
Inyo,2021-04-18,0,12113,0,4342,0,7400,0,371,0,1810,0,5326,0,7136,
Inyo,2021-05-31,0,15816,0,5704,0,9644,0,468,0,1050,0,7603,0,8653,
Inyo,2021-06-06,0,15956,0,5743,0,9725,0,488,0,1030,0,7693,0,8723,
Inyo,2021-06-20,0,16475,0,6052,0,9904,0,519,0,769,0,8097,0,8866,
Inyo,2021-07-04,0,16726,0,6211,0,9984,0,531,0,760,0,8233,0,8993,
Inyo,2021-07-18,0,16903,0,6327,0,10041,0,535,0,773,0,8316,0,9089,
Kings,2020-12-15,0,0,0,0,0,0,0,0,0,0,0,0,0,0,
Kings,2020-12-25,0,492,0,475,0,17,0,0,0,599,0,0,0,599,
Lake,2020-12-15,0,0,0,0,0,0,0,0,0,0,0,0,0,0,
Lake,2020-12-16,0,0,0,0,0,0,0,0,0,0,0,0,0,0,
Lake,2020-12-25,0,342,0,328,0,14,0,0,0,342,0,0,0,342,
Lake,2021-01-03,0,661,0,616,0,45,0,0,0,661,0,0,0,661,
Lassen,2020-12-15,0,0,0,0,0,0,0,0,0,0,0,0,0,0,
Lassen,2020-12-25,0,48,0,48,0,0,0,0,0,48,0,0,0,48,
Lassen,2020-12-26,0,48,0,48,0,0,0,0,0,48,0,0,0,48,
Lassen,2020-12-27,0,48,0,48,0,0,0,0,0,48,0,0,0,48,
Lassen,2021-01-01,0,159,0,149,0,10,0,0,0,159,0,0,0,159,
Lassen,2021-01-03,0,160,0,149,0,11,0,0,0,160,0,0,0,160,
Lassen,2021-01-10,0,552,0,248,0,304,0,0,0,543,0,5,0,548,
Lassen,2021-01-23,0,1471,0,560,0,911,0,0,0,1151,0,150,0,1301,
Lassen,2021-01-30,0,1728,0,588,0,1140,0,0,0,1364,0,172,0,1536,
Lassen,2021-01-31,0,1728,0,588,0,1140,0,0,0,1364,0,172,0,1536,
Madera,2020-12-15,0,0,0,0,0,0,0,0,0,0,0,0,0,0,
Madera,2020-12-25,0,375,0,368,0,7,0,0,0,375,0,0,0,375,
Marin,2021-07-04,0,377308,0,238069,0,128028,0,11211,0,15424,0,185946,0,201370,
Mariposa,2020-12-15,0,0,0,0,0,0,0,0,0,0,0,0,0,0,
Mariposa,2020-12-16,0,0,0,0,0,0,0,0,0,0,0,0,0,0,
Mariposa,2020-12-19,0,94,0,94,0,0,0,0,0,97,0,0,0,97,
Mariposa,2020-12-25,0,169,0,168,0,1,0,0,0,175,0,1,0,176,
Mariposa,2021-01-03,0,256,0,180,0,76,0,0,0,262,0,1,0,263,
Mariposa,2021-01-09,0,462,0,328,0,134,0,0,0,198,0,136,0,334,
Mariposa,2021-01-10,0,462,0,328,0,134,0,0,0,198,0,136,0,334,
Mariposa,2021-01-31,0,1282,0,446,0,836,0,0,0,794,0,249,0,1043,
Mariposa,2021-04-25,0,10035,0,1474,0,8198,0,363,0,3102,0,3653,0,6755,
Mariposa,2021-06-20,0,12518,0,2324,0,9710,0,484,0,2747,0,5122,0,7869,
Mariposa,2021-07-03,0,12665,0,2397,0,9772,0,496,0,2749,0,5199,0,7948,
Mariposa,2021-07-04,0,12665,0,2397,0,9772,0,496,0,2749,0,5199,0,7948,
Mariposa,2021-07-11,0,12731,0,2435,0,9787,0,509,0,2746,0,5240,0,7986,
Mariposa,2021-07-25,0,12850,0,2497,0,9838,0,515,0,2754,0,5298,0,8052,
Mendocino,2020-12-15,0,0,0,0,0,0,0,0,0,0,0,0,0,0,
Mendocino,2020-12-16,0,0,0,0,0,0,0,0,0,0,0,0,0,0,
Mendocino,2021-01-03,0,1443,0,896,0,547,0,0,0,1283,0,0,0,1283,
Merced,2020-12-15,0,0,0,0,0,0,0,0,0,0,0,0,0,0,
Modoc,2020-12-15,0,0,0,0,0,0,0,0,0,0,0,0,0,0,
Modoc,2020-12-17,0,2,0,2,0,0,0,0,0,2,0,0,0,2,
Modoc,2020-12-18,0,2,0,2,0,0,0,0,0,2,0,0,0,2,
Modoc,2020-12-19,0,2,0,2,0,0,0,0,0,2,0,0,0,2,
Modoc,2020-12-20,0,2,0,2,0,0,0,0,0,2,0,0,0,2,
Modoc,2020-12-25,0,120,0,120,0,0,0,0,0,120,0,0,0,120,
Modoc,2020-12-26,0,120,0,120,0,0,0,0,0,120,0,0,0,120,
Modoc,2020-12-27,0,120,0,120,0,0,0,0,0,120,0,0,0,120,
Modoc,2020-12-31,0,140,0,125,0,15,0,0,0,140,0,0,0,140,
Modoc,2021-01-01,0,140,0,125,0,15,0,0,0,140,0,0,0,140,
Modoc,2021-01-03,0,143,0,126,0,17,0,0,0,143,0,0,0,143,
Modoc,2021-01-09,0,339,0,132,0,207,0,0,0,335,0,2,0,337,
Modoc,2021-01-17,0,684,0,251,0,433,0,0,0,470,0,107,0,577,
Modoc,2021-01-23,0,871,0,263,0,608,0,0,0,649,0,111,0,760,
Modoc,2021-01-24,0,871,0,263,0,608,0,0,0,649,0,111,0,760,
Modoc,2021-01-30,0,1202,0,273,0,929,0,0,0,947,0,128,0,1075,
Modoc,2021-01-31,0,1202,0,273,0,929,0,0,0,947,0,128,0,1075,
Modoc,2021-02-06,0,1586,0,305,0,1281,0,0,0,1021,0,283,0,1304,
Modoc,2021-02-07,0,1586,0,305,0,1281,0,0,0,1021,0,283,0,1304,
Modoc,2021-02-14,0,2014,0,324,0,1690,0,0,0,929,0,543,0,1472,
Modoc,2021-02-15,0,2014,0,324,0,1690,0,0,0,929,0,543,0,1472,
Modoc,2021-02-21,0,2381,0,341,0,2040,0,0,0,913,0,735,0,1648,
Modoc,2021-02-28,0,2759,0,356,0,2403,0,0,0,666,0,1047,0,1713,
Modoc,2021-03-14,0,3541,0,392,0,2999,0,150,0,582,0,1554,0,2136,
Modoc,2021-03-28,0,4019,0,415,0,3403,0,201,0,552,0,1833,0,2385,
Modoc,2021-04-04,0,4275,0,429,0,3616,0,230,0,458,0,2021,0,2479,
Modoc,2021-05-01,0,4845,0,495,0,4087,0,263,0,310,0,2395,0,2705,
Modoc,2021-05-30,0,5217,0,601,0,4304,0,312,0,249,0,2636,0,2885,
Modoc,2021-06-05,0,5266,0,606,0,4341,0,319,0,229,0,2673,0,2902,
Modoc,2021-06-06,0,5266,0,606,0,4341,0,319,0,229,0,2673,0,2902,
Modoc,2021-06-13,0,5323,0,623,0,4379,0,321,0,232,0,2701,0,2933,
Modoc,2021-06-20,0,5431,0,671,0,4425,0,335,0,254,0,2752,0,3006,
Modoc,2021-06-26,0,5490,0,690,0,4456,0,344,0,276,0,2775,0,3051,
Modoc,2021-06-27,0,5490,0,690,0,4456,0,344,0,276,0,2775,0,3051,
Modoc,2021-07-04,0,5540,0,706,0,4478,0,356,0,292,0,2798,0,3090,
Modoc,2021-07-05,0,5540,0,706,0,4478,0,356,0,292,0,2798,0,3090,
Modoc,2021-07-12,0,5632,0,747,0,4522,0,363,0,269,0,2859,0,3128,
Modoc,2021-07-17,0,5693,0,769,0,4558,0,366,0,247,0,2902,0,3149,
Modoc,2021-07-18,0,5693,0,769,0,4558,0,366,0,247,0,2902,0,3149,
Modoc,2021-07-25,0,5753,0,793,0,4590,0,370,0,243,0,2937,0,3180,
Mono,2020-12-15,0,0,0,0,0,0,0,0,0,0,0,0,0,0,
Mono,2020-12-16,0,0,0,0,0,0,0,0,0,0,0,0,0,0,
Mono,2020-12-17,0,0,0,0,0,0,0,0,0,0,0,0,0,0,
Mono,2020-12-25,0,181,0,144,0,37,0,0,0,181,0,0,0,181,
Mono,2021-01-03,0,395,0,282,0,113,0,0,0,395,0,0,0,395,
Mono,2021-01-17,0,1243,0,534,0,709,0,0,0,955,0,144,0,1099,
Mono,2021-01-29,0,3079,0,2267,0,812,0,0,0,2372,0,354,0,2726,
Mono,2021-02-14,0,6189,0,4525,0,1664,0,0,0,2211,0,1988,0,4199,
Mono,2021-03-21,0,10708,0,7076,0,3576,0,56,0,2336,0,4203,0,6539,
Mono,2021-03-28,0,11181,0,7449,0,3652,0,80,0,2667,0,4285,0,6952,
Mono,2021-04-11,0,13366,0,7876,0,5315,0,175,0,969,0,6272,0,7241,
Mono,2021-05-30,0,15687,0,8878,0,6555,0,254,0,1032,0,7438,0,8470,
Mono,2021-05-31,0,15687,0,8878,0,6555,0,254,0,1032,0,7438,0,8470,
Mono,2021-07-03,0,16378,0,9295,0,6781,0,302,0,685,0,7980,0,8665,
Mono,2021-07-04,0,16378,0,9295,0,6781,0,302,0,685,0,7980,0,8665,
Mono,2021-07-11,0,16419,0,9313,0,6798,0,308,0,685,0,8003,0,8688,
Mono,2021-07-18,0,16475,0,9342,0,6825,0,308,0,703,0,8021,0,8724,
Mono,2021-07-25,0,16595,0,9408,0,6871,0,316,0,756,0,8058,0,8814,
Monterey,2020-12-15,0,0,0,0,0,0,0,0,0,0,0,0,0,0,
Napa,2020-12-15,0,0,0,0,0,0,0,0,0,0,0,0,0,0,
Napa,2020-12-25,0,1823,0,1639,0,184,0,0,0,1824,0,0,0,1824,
Nevada,2020-12-15,0,0,0,0,0,0,0,0,0,0,0,0,0,0,
Nevada,2021-07-04,0,100457,0,53775,0,44108,0,2574,0,7050,0,47685,0,54735,
Plumas,2020-12-15,0,0,0,0,0,0,0,0,0,0,0,0,0,0,
Plumas,2020-12-16,0,0,0,0,0,0,0,0,0,0,0,0,0,0,
Plumas,2020-12-17,0,0,0,0,0,0,0,0,0,0,0,0,0,0,
Plumas,2020-12-20,0,4,0,4,0,0,0,0,0,4,0,0,0,4,
Plumas,2020-12-25,0,201,0,201,0,0,0,0,0,201,0,0,0,201,
Plumas,2020-12-26,0,201,0,201,0,0,0,0,0,201,0,0,0,201,
Plumas,2020-12-27,0,201,0,201,0,0,0,0,0,201,0,0,0,201,
Plumas,2021-01-03,0,273,0,228,0,45,0,0,0,273,0,0,0,273,
Plumas,2021-01-10,0,488,0,243,0,245,0,0,0,478,0,5,0,483,
Plumas,2021-01-17,0,977,0,455,0,522,0,0,0,591,0,193,0,784,
Plumas,2021-02-07,0,1836,0,550,0,1286,0,0,0,899,0,468,0,1367,
Plumas,2021-04-25,0,13303,0,925,0,11663,0,715,0,1415,0,6277,0,7692,
Plumas,2021-06-27,0,16149,0,1617,0,13556,0,976,0,766,0,8139,0,8905,
Plumas,2021-07-04,0,16271,0,1690,0,13591,0,990,0,758,0,8210,0,8968,
Plumas,2021-07-05,0,16271,0,1690,0,13591,0,990,0,758,0,8210,0,8968,
Plumas,2021-07-18,0,16515,0,1816,0,13683,0,1016,0,757,0,8345,0,9102,
Plumas,2021-07-31,0,16732,0,1946,0,13739,0,1047,0,770,0,8461,0,9231,
San Benito,2020-12-15,0,0,0,0,0,0,0,0,0,0,0,0,0,0,
San Benito,2021-01-01,0,721,0,598,0,123,0,0,0,721,0,0,0,721,
Santa Barbara,2020-12-25,0,2443,0,2271,0,172,0,0,0,2443,0,0,0,2443,
Shasta,2020-12-20,0,717,0,717,0,0,0,0,0,717,0,0,0,717,
Shasta,2020-12-25,0,1170,0,1160,0,10,0,0,0,1170,0,0,0,1170,
Shasta,2021-01-01,0,1649,0,1537,0,112,0,0,0,1649,0,0,0,1649,
Sierra,2020-12-15,0,0,0,0,0,0,0,0,0,0,0,0,0,0,
Sierra,2020-12-16,0,0,0,0,0,0,0,0,0,0,0,0,0,0,
Sierra,2020-12-17,0,0,0,0,0,0,0,0,0,0,0,0,0,0,
Sierra,2020-12-19,0,1,0,1,0,0,0,0,0,1,0,0,0,1,
Sierra,2020-12-20,0,1,0,1,0,0,0,0,0,1,0,0,0,1,
Sierra,2020-12-24,0,19,0,19,0,0,0,0,0,19,0,0,0,19,
Sierra,2020-12-25,0,19,0,19,0,0,0,0,0,19,0,0,0,19,
Sierra,2020-12-26,0,19,0,19,0,0,0,0,0,19,0,0,0,19,
Sierra,2020-12-27,0,19,0,19,0,0,0,0,0,19,0,0,0,19,
Sierra,2021-01-02,0,85,0,27,0,58,0,0,0,85,0,0,0,85,
Sierra,2021-01-03,0,85,0,27,0,58,0,0,0,85,0,0,0,85,
Sierra,2021-01-04,0,85,0,27,0,58,0,0,0,85,0,0,0,85,
Sierra,2021-01-08,0,171,0,32,0,139,0,0,0,169,0,1,0,170,
Sierra,2021-01-09,0,171,0,32,0,139,0,0,0,169,0,1,0,170,
Sierra,2021-01-10,0,171,0,32,0,139,0,0,0,169,0,1,0,170,
Sierra,2021-01-16,0,253,0,53,0,200,0,0,0,215,0,19,0,234,
Sierra,2021-01-17,0,253,0,53,0,200,0,0,0,215,0,19,0,234,
Sierra,2021-01-20,0,290,0,53,0,237,0,0,0,252,0,19,0,271,
Sierra,2021-01-24,0,347,0,53,0,294,0,0,0,308,0,20,0,328,
Sierra,2021-01-31,0,471,0,62,0,409,0,0,0,326,0,73,0,399,
Sierra,2021-02-06,0,641,0,72,0,569,0,0,0,316,0,163,0,479,
Sierra,2021-02-07,0,641,0,72,0,569,0,0,0,316,0,163,0,479,
Sierra,2021-02-08,0,641,0,72,0,569,0,0,0,316,0,163,0,479,
Sierra,2021-02-13,0,912,0,73,0,839,0,0,0,457,0,228,0,685,
Sierra,2021-02-14,0,912,0,73,0,839,0,0,0,457,0,228,0,685,
Sierra,2021-02-21,0,1111,0,78,0,1033,0,0,0,467,0,322,0,789,
Sierra,2021-02-22,0,1111,0,78,0,1033,0,0,0,467,0,322,0,789,
Sierra,2021-02-27,0,1251,0,84,0,1167,0,0,0,466,0,392,0,858,
Sierra,2021-02-28,0,1251,0,84,0,1167,0,0,0,466,0,392,0,858,
Sierra,2021-03-06,0,1431,0,86,0,1345,0,0,0,502,0,464,0,966,
Sierra,2021-03-07,0,1431,0,86,0,1345,0,0,0,502,0,464,0,966,
Sierra,2021-03-14,0,1715,0,88,0,1627,0,0,0,388,0,663,0,1051,
Sierra,2021-03-21,0,1919,0,89,0,1827,0,3,0,363,0,779,0,1142,
Sierra,2021-03-22,0,1919,0,89,0,1827,0,3,0,363,0,779,0,1142,
Sierra,2021-03-28,0,2055,0,89,0,1963,0,3,0,370,0,843,0,1213,
Sierra,2021-04-03,0,2187,0,92,0,2092,0,3,0,322,0,932,0,1254,
Sierra,2021-04-05,0,2188,0,92,0,2093,0,3,0,322,0,932,0,1254,
Sierra,2021-04-11,0,2292,0,97,0,2187,0,8,0,266,0,1014,0,1280,
Sierra,2021-04-16,0,2388,0,99,0,2280,0,9,0,187,0,1102,0,1289,
Sierra,2021-04-25,0,2507,0,103,0,2395,0,9,0,112,0,1198,0,1310,
Sierra,2021-05-02,0,2573,0,108,0,2456,0,9,0,91,0,1241,0,1332,
Sierra,2021-05-07,0,2602,0,112,0,2480,0,10,0,83,0,1260,0,1343,
Sierra,2021-05-09,0,2603,0,112,0,2480,0,11,0,83,0,1261,0,1344,
Sierra,2021-05-10,0,2603,0,112,0,2480,0,11,0,83,0,1261,0,1344,
Sierra,2021-05-16,0,2634,0,116,0,2498,0,20,0,89,0,1278,0,1367,
Sierra,2021-05-31,0,2691,0,134,0,2534,0,23,0,92,0,1307,0,1399,
Sierra,2021-06-05,0,2720,0,138,0,2557,0,25,0,68,0,1334,0,1402,
Sierra,2021-06-06,0,2720,0,138,0,2557,0,25,0,68,0,1334,0,1402,
Sierra,2021-06-07,0,2720,0,138,0,2557,0,25,0,68,0,1334,0,1402,
Sierra,2021-06-19,0,2765,0,160,0,2574,0,31,0,58,0,1364,0,1422,
Sierra,2021-06-20,0,2765,0,160,0,2574,0,31,0,58,0,1364,0,1422,
Sierra,2021-06-25,0,2783,0,163,0,2585,0,35,0,56,0,1376,0,1432,
Sierra,2021-06-29,0,2786,0,165,0,2585,0,36,0,58,0,1377,0,1435,
Sierra,2021-07-04,0,2794,0,170,0,2587,0,37,0,57,0,1382,0,1439,
Sierra,2021-07-05,0,2794,0,170,0,2587,0,37,0,57,0,1382,0,1439,
Sierra,2021-07-06,0,2794,0,170,0,2587,0,37,0,57,0,1382,0,1439,
Sierra,2021-07-10,0,2804,0,179,0,2588,0,37,0,57,0,1387,0,1444,
Sierra,2021-07-11,0,2804,0,179,0,2588,0,37,0,57,0,1387,0,1444,
Sierra,2021-07-17,0,2818,0,186,0,2593,0,39,0,56,0,1395,0,1451,
Sierra,2021-07-19,0,2821,0,189,0,2593,0,39,0,57,0,1396,0,1453,
Sierra,2021-07-20,0,2821,0,189,0,2593,0,39,0,57,0,1396,0,1453,
Sierra,2021-07-24,0,2835,0,195,0,2601,0,39,0,63,0,1400,0,1463,
Sierra,2021-07-25,0,2835,0,195,0,2601,0,39,0,63,0,1400,0,1463,
Sierra,2021-07-28,0,2838,0,197,0,2602,0,39,0,63,0,1401,0,1464,
Sierra,2021-07-31,0,2846,0,201,0,2606,0,39,0,63,0,1405,0,1468,
Siskiyou,2020-12-15,0,0,0,0,0,0,0,0,0,0,0,0,0,0,
Siskiyou,2020-12-25,0,453,0,453,0,0,0,0,0,453,0,0,0,453,
Siskiyou,2021-01-01,0,583,0,463,0,120,0,0,0,583,0,0,0,583,
Siskiyou,2021-01-10,0,1255,0,488,0,767,0,0,0,1234,0,11,0,1245,
Siskiyou,2021-01-24,0,3523,0,2192,0,1331,0,0,0,2605,0,460,0,3065,
Siskiyou,2021-01-31,0,4570,0,2333,0,2237,0,0,0,3411,0,577,0,3988,
Siskiyou,2021-05-30,0,30347,0,12027,0,17507,0,813,0,3027,0,14037,0,17064,
Siskiyou,2021-06-27,0,32441,0,13119,0,18424,0,898,0,2401,0,15422,0,17823,
Siskiyou,2021-07-04,0,32696,0,13250,0,18538,0,908,0,2401,0,15554,0,17955,
Stanislaus,2020-12-25,0,3030,0,2983,0,47,0,0,0,3028,0,2,0,3030,
Sutter,2020-12-25,0,522,0,511,0,11,0,0,0,522,0,0,0,522,
Tehama,2020-12-15,0,0,0,0,0,0,0,0,0,0,0,0,0,0,
Tehama,2020-12-19,0,30,0,30,0,0,0,0,0,31,0,0,0,31,
Tehama,2020-12-20,0,30,0,30,0,0,0,0,0,31,0,0,0,31,
Tehama,2020-12-25,0,216,0,200,0,16,0,0,0,217,0,0,0,217,
Tehama,2021-01-02,0,405,0,343,0,62,0,0,0,405,0,0,0,405,
Tehama,2021-01-03,0,405,0,343,0,62,0,0,0,405,0,0,0,405,
Trinity,2020-12-15,0,0,0,0,0,0,0,0,0,0,0,0,0,0,
Trinity,2020-12-16,0,0,0,0,0,0,0,0,0,0,0,0,0,0,
Trinity,2020-12-19,0,6,0,6,0,0,0,0,0,6,0,0,0,6,
Trinity,2020-12-20,0,6,0,6,0,0,0,0,0,6,0,0,0,6,
Trinity,2020-12-24,0,54,0,53,0,1,0,0,0,54,0,0,0,54,
Trinity,2020-12-25,0,54,0,53,0,1,0,0,0,54,0,0,0,54,
Trinity,2020-12-26,0,54,0,53,0,1,0,0,0,54,0,0,0,54,
Trinity,2020-12-27,0,54,0,53,0,1,0,0,0,54,0,0,0,54,
Trinity,2021-01-01,0,104,0,99,0,5,0,0,0,104,0,0,0,104,
Trinity,2021-01-02,0,104,0,99,0,5,0,0,0,104,0,0,0,104,
Trinity,2021-01-03,0,104,0,99,0,5,0,0,0,104,0,0,0,104,
Trinity,2021-01-07,0,157,0,104,0,53,0,0,0,148,0,4,0,152,
Trinity,2021-01-09,0,206,0,106,0,100,0,0,0,194,0,6,0,200,
Trinity,2021-01-10,0,206,0,106,0,100,0,0,0,194,0,6,0,200,
Trinity,2021-01-17,0,275,0,155,0,120,0,0,0,173,0,51,0,224,
Trinity,2021-01-24,0,391,0,216,0,175,0,0,0,195,0,98,0,293,
Trinity,2021-01-31,0,456,0,231,0,225,0,0,0,248,0,104,0,352,
Trinity,2021-02-28,0,2345,0,373,0,1972,0,0,0,1633,0,356,0,1989,
Tulare,2020-12-25,0,2139,0,2126,0,13,0,0,0,2156,0,0,0,2156,
Tuolumne,2020-12-15,0,0,0,0,0,0,0,0,0,0,0,0,0,0,
Tuolumne,2020-12-24,0,644,0,626,0,18,0,0,0,644,0,0,0,644,
Tuolumne,2020-12-27,0,647,0,629,0,18,0,0,0,647,0,0,0,647,
Unknown,2020-12-15,0,0,0,0,0,0,0,0,0,0,0,0,0,0,
Unknown,2020-12-16,0,0,0,0,0,0,0,0,0,0,0,0,0,0,
Unknown,2020-12-19,0,3,0,3,0,0,0,0,0,0,0,0,0,0,
Unknown,2020-12-20,0,3,0,3,0,0,0,0,0,0,0,0,0,0,
Unknown,2020-12-22,0,7,0,7,0,0,0,0,0,0,0,0,0,0,
Unknown,2020-12-23,0,7,0,7,0,0,0,0,0,0,0,0,0,0,
Unknown,2020-12-24,0,7,0,7,0,0,0,0,0,0,0,0,0,0,
Unknown,2020-12-25,0,7,0,7,0,0,0,0,0,0,0,0,0,0,
Unknown,2020-12-26,0,7,0,7,0,0,0,0,0,0,0,0,0,0,
Unknown,2020-12-27,0,7,0,7,0,0,0,0,0,0,0,0,0,0,
Unknown,2021-01-01,0,65,0,63,0,2,0,0,0,58,0,0,0,58,
Unknown,2021-01-03,0,66,0,63,0,3,0,0,0,59,0,0,0,59,
Unknown,2021-01-05,0,67,0,64,0,3,0,0,0,60,0,0,0,60,
Unknown,2021-01-08,0,141,0,136,0,5,0,0,1,134,0,0,1,134,
Unknown,2021-01-10,0,142,0,137,0,5,0,0,0,135,0,0,0,135,
Unknown,2021-01-17,0,185,0,178,0,7,0,0,0,177,0,1,0,178,
Unknown,2021-07-04,0,2882,0,1868,0,837,0,177,0,473,0,1282,0,1755,
Yuba,2020-12-15,0,0,0,0,0,0,0,0,0,0,0,0,0,0,
Yuba,2021-01-01,0,515,0,346,0,169,0,0,0,515,0,0,0,515,
Outside California,2020-12-15,11,11,11,11,0,0,0,0,11,11,0,0,11,11,Not in California
Outside California,2020-12-16,272,283,272,283,0,0,0,0,272,283,0,0,272,283,Not in California
Outside California,2020-12-17,1571,1854,1571,1854,0,0,0,0,1571,1854,0,0,1571,1854,Not in California
Outside California,2020-12-18,2428,4282,2422,4276,6,6,0,0,2428,4282,0,0,2428,4282,Not in California
Outside California,2020-12-19,970,5252,969,5245,1,7,0,0,970,5252,0,0,970,5252,Not in California
Outside California,2020-12-20,654,5906,650,5895,4,11,0,0,654,5906,0,0,654,5906,Not in California
Outside California,2020-12-21,2180,8086,2176,8071,4,15,0,0,2180,8086,0,0,2180,8086,Not in California
Outside California,2020-12-22,2040,10126,1965,10036,75,90,0,0,2040,10126,0,0,2040,10126,Not in California
Outside California,2020-12-23,1523,11649,1376,11412,147,237,0,0,1522,11647,1,1,1522,11648,Not in California
Outside California,2020-12-24,799,12448,610,12022,189,426,0,0,799,12446,0,1,799,12447,Not in California
Outside California,2020-12-25,32,12480,27,12049,5,431,0,0,32,12478,0,1,32,12479,Not in California
Outside California,2020-12-26,304,12784,203,12252,101,532,0,0,304,12782,0,1,304,12783,Not in California
Outside California,2020-12-27,196,12980,79,12331,117,649,0,0,196,12978,0,1,196,12979,Not in California
Outside California,2020-12-28,1405,14385,885,13216,520,1169,0,0,1405,14383,0,1,1405,14384,Not in California
Outside California,2020-12-29,1553,15938,1020,14236,533,1702,0,0,1553,15936,0,1,1553,15937,Not in California
Outside California,2020-12-30,1877,17815,1218,15454,659,2361,0,0,1877,17813,0,1,1877,17814,Not in California
Outside California,2020-12-31,1107,18922,595,16049,512,2873,0,0,1106,18918,1,2,1106,18920,Not in California
Outside California,2021-01-01,112,19034,31,16080,81,2954,0,0,112,19030,0,2,112,19032,Not in California
Outside California,2021-01-02,254,19288,140,16220,114,3068,0,0,253,19282,1,3,253,19285,Not in California
Outside California,2021-01-03,190,19478,94,16314,96,3164,0,0,189,19470,1,4,189,19474,Not in California
Outside California,2021-01-04,1162,20640,518,16832,644,3808,0,0,1156,20624,2,6,1156,20630,Not in California
Outside California,2021-01-05,1560,22200,828,17660,732,4540,0,0,1366,21799,192,198,1367,21997,Not in California
Outside California,2021-01-06,2590,24790,1498,19158,1092,5632,0,0,1940,23091,648,846,1940,23937,Not in California
Outside California,2021-01-07,4028,28818,2459,21617,1569,7201,0,0,2445,23957,1581,2427,2447,26384,Not in California
Outside California,2021-01-08,4372,33190,2799,24416,1573,8774,0,0,2555,24711,1805,4232,2559,28943,Not in California
Outside California,2021-01-09,1292,34482,543,24959,749,9523,0,0,959,25341,331,4563,961,29904,Not in California
Outside California,2021-01-10,314,34796,190,25149,124,9647,0,0,191,25409,123,4686,191,30095,Not in California
Outside California,2021-01-11,3201,37997,1961,27110,1240,10887,0,0,1866,25943,1333,6019,1867,31962,Not in California
Outside California,2021-01-12,3832,41829,2289,29399,1543,12430,0,0,2238,26644,1590,7609,2291,34253,Not in California
Outside California,2021-01-13,3607,45436,1784,31183,1823,14253,0,0,2428,27899,1178,8787,2433,36686,Not in California
Outside California,2021-01-14,3652,49088,1264,32447,2388,16641,0,0,3006,30276,632,9419,3009,39695,Not in California
Outside California,2021-01-15,4137,53225,998,33445,3139,19780,0,0,3665,33481,460,9879,3665,43360,Not in California
Outside California,2021-01-16,2615,55840,394,33839,2221,22001,0,0,2436,35740,177,10056,2436,45796,Not in California
Outside California,2021-01-17,532,56372,167,34006,365,22366,0,0,475,36158,57,10113,475,46271,Not in California
Outside California,2021-01-18,1195,57567,774,34780,421,22787,0,0,740,36445,454,10567,741,47012,Not in California
Outside California,2021-01-19,4113,61680,1359,36139,2754,25541,0,0,3210,38755,903,11470,3213,50225,Not in California
Outside California,2021-01-20,4429,66109,1427,37566,3002,28543,0,0,3488,41308,936,12406,3489,53714,Not in California
Outside California,2021-01-21,4187,70296,1185,38751,3002,31545,0,0,3608,44353,563,12969,3608,57322,Not in California
Outside California,2021-01-22,4547,74843,1122,39873,3425,34970,0,0,4124,48066,413,13382,4126,61448,Not in California
Outside California,2021-01-23,2195,77038,351,40224,1844,36814,0,0,2019,49912,173,13555,2019,63467,Not in California
Outside California,2021-01-24,587,77625,244,40468,343,37157,0,0,506,50337,81,13636,506,63973,Not in California
Outside California,2021-01-25,4481,82106,1871,42339,2610,39767,0,0,3593,53053,878,14514,3594,67567,Not in California
Outside California,2021-01-26,5759,87865,2657,44996,3102,42869,0,0,4886,57074,872,15386,4893,72460,Not in California
Outside California,2021-01-27,4793,92658,2364,47360,2429,45298,0,0,4136,60562,650,16036,4138,76598,Not in California
Outside California,2021-01-28,4821,97479,2399,49759,2422,47720,0,0,4280,64311,531,16567,4280,80878,Not in California
Outside California,2021-01-29,4627,102106,2739,52498,1888,49608,0,0,3814,67323,805,17372,3817,84695,Not in California
Outside California,2021-01-30,4111,106217,2061,54559,2050,51658,0,0,3868,70951,241,17613,3869,88564,Not in California
Outside California,2021-01-31,2755,108972,2358,56917,397,52055,0,0,2692,73584,61,17674,2694,91258,Not in California
Outside California,2021-02-01,5471,114443,2390,59307,3081,55136,0,0,4760,77642,702,18376,4760,96018,Not in California
Outside California,2021-02-02,6655,121098,1958,61265,4697,59833,0,0,5917,82832,727,19103,5917,101935,Not in California
Outside California,2021-02-03,7263,128361,1853,63118,5410,65243,0,0,6363,88305,891,19994,6364,108299,Not in California
Outside California,2021-02-04,6715,135076,1937,65055,4778,70021,0,0,5656,92919,1043,21037,5657,113956,Not in California
Outside California,2021-02-05,6834,141910,2175,67230,4659,74680,0,0,5693,97479,1133,22170,5693,119649,Not in California
Outside California,2021-02-06,4363,146273,2086,69316,2277,76957,0,0,3888,100905,465,22635,3891,123540,Not in California
Outside California,2021-02-07,2040,148313,1646,70962,394,77351,0,0,1954,102777,84,22719,1956,125496,Not in California
Outside California,2021-02-08,4762,153075,2781,73743,1981,79332,0,0,3688,105402,1064,23783,3689,129185,Not in California
Outside California,2021-02-09,4193,157268,1800,75543,2393,81725,0,0,2856,106951,1308,25091,2857,132042,Not in California
Outside California,2021-02-10,5346,162614,1672,77215,3674,85399,0,0,2882,107430,2413,27504,2892,134934,Not in California
Outside California,2021-02-11,4608,167222,1996,79211,2612,88011,0,0,3243,109344,1347,28851,3261,138195,Not in California
Outside California,2021-02-12,5231,172453,1877,81088,3354,91365,0,0,3345,110826,1866,30717,3348,141543,Not in California
Outside California,2021-02-13,2349,174802,664,81752,1685,93050,0,0,1763,112022,580,31297,1776,143319,Not in California
Outside California,2021-02-14,1312,176114,360,82112,952,94002,0,0,1040,112799,265,31562,1042,144361,Not in California
Outside California,2021-02-15,2511,178625,1474,83586,1037,95039,0,0,1232,112769,1265,32827,1235,145596,Not in California
Outside California,2021-02-16,6481,185106,2694,86280,3787,98826,0,0,2556,111423,3906,36733,2560,148156,Not in California
Outside California,2021-02-17,5689,190795,2680,88960,3009,101835,0,0,1798,109351,3875,40608,1803,149959,Not in California
Outside California,2021-02-18,6256,197051,3405,92365,2851,104686,0,0,2074,107277,4148,44756,2074,152033,Not in California
Outside California,2021-02-19,5520,202571,3719,96084,1801,106487,0,0,2427,106627,3079,47835,2429,154462,Not in California
Outside California,2021-02-20,3177,205748,2481,98565,696,107183,0,0,1282,106023,1887,49722,1283,155745,Not in California
Outside California,2021-02-21,2613,208361,2362,100927,251,107434,0,0,888,105199,1712,51434,888,156633,Not in California
Outside California,2021-02-22,3589,211950,2556,103483,1033,108467,0,0,1708,105037,1874,53308,1712,158345,Not in California
Outside California,2021-02-23,6600,218550,3450,106933,3150,111617,0,0,2534,103622,3965,57273,2550,160895,Not in California
Outside California,2021-02-24,6857,225407,3543,110476,3314,114931,0,0,2608,102035,4198,61471,2611,163506,Not in California
Outside California,2021-02-25,7480,232887,3560,114036,3920,118851,0,0,3314,101234,4118,65589,3317,166823,Not in California
Outside California,2021-02-26,7626,240513,3885,117921,3741,122592,0,0,3404,100524,4115,69704,3405,170228,Not in California
Outside California,2021-02-27,6274,246787,3014,120935,3259,125851,1,1,2102,98485,4144,73848,2105,172333,Not in California
Outside California,2021-02-28,2615,249402,1886,122821,728,126579,1,2,920,97729,1679,75527,923,173256,Not in California
Outside California,2021-03-01,5072,254474,3026,125847,2045,128624,1,3,1577,95833,3479,79006,1583,174839,Not in California
Outside California,2021-03-02,7811,262285,2738,128585,5073,133697,0,3,2445,92948,5332,84338,2447,177286,Not in California
Outside California,2021-03-03,8530,270815,3079,131664,5448,139145,3,6,3096,90642,5408,89746,3102,180388,Not in California
Outside California,2021-03-04,7314,278129,2829,134493,4477,143622,8,14,2670,88710,4614,94360,2682,183070,Not in California
Outside California,2021-03-05,5777,283906,2710,137203,3051,146673,16,30,3004,88987,2757,97117,3034,186104,Not in California
Outside California,2021-03-06,4831,288737,2124,139327,2547,149220,160,190,2463,89257,2361,99478,2631,188735,Not in California
Outside California,2021-03-07,1691,290428,977,140304,560,149780,154,344,993,89718,692,100170,1153,189888,Not in California
Outside California,2021-03-08,3207,293635,1906,142210,1054,150834,247,591,2259,91314,914,101084,2510,192398,Not in California
Outside California,2021-03-09,4736,298371,2438,144648,1998,152832,300,891,2808,92508,1914,102998,3108,195506,Not in California
Outside California,2021-03-10,4461,302832,2140,146788,1815,154647,506,1397,2735,94035,1711,104709,3238,198744,Not in California
Outside California,2021-03-11,6259,309091,3197,149985,2397,157044,665,2062,3325,95104,2917,107626,3986,202730,Not in California
Outside California,2021-03-12,6529,315620,3924,153909,1901,158945,704,2766,3585,96460,2926,110552,4282,207012,Not in California
Outside California,2021-03-13,3807,319427,2191,156100,1162,160107,454,3220,2594,98304,1203,111755,3047,210059,Not in California
Outside California,2021-03-14,1796,321223,941,157041,525,160632,330,3550,988,98817,801,112556,1314,211373,Not in California
Outside California,2021-03-15,4087,325310,2152,159193,1464,162096,471,4021,2170,99558,1900,114456,2641,214014,Not in California
Outside California,2021-03-16,7658,332968,4437,163630,2815,164911,406,4427,4221,100762,3414,117870,4618,218632,Not in California
Outside California,2021-03-17,8554,341522,5551,169181,2622,167533,381,4808,5100,102804,3438,121308,5480,224112,Not in California
Outside California,2021-03-18,8414,349936,5198,174379,2668,170201,548,5356,4811,104573,3587,124895,5356,229468,Not in California
Outside California,2021-03-19,7453,357389,4440,178819,2467,172668,546,5902,4379,106442,3059,127954,4928,234396,Not in California
Outside California,2021-03-20,4839,362228,3207,182026,1535,174203,97,5999,3647,109012,1175,129129,3745,238141,Not in California
Outside California,2021-03-21,2153,364381,1483,183509,577,174780,93,6092,1687,110328,461,129590,1777,239918,Not in California
Outside California,2021-03-22,3385,367766,2058,185567,1236,176016,91,6183,2284,111610,1089,130679,2371,242289,Not in California
Outside California,2021-03-23,6308,374074,3229,188796,2766,178782,313,6496,4170,113988,2103,132782,4481,246770,Not in California
Outside California,2021-03-24,7467,381541,3831,192627,3185,181967,451,6947,5082,117149,2368,135150,5529,252299,Not in California
Outside California,2021-03-25,8437,389978,3895,196522,4009,185976,533,7480,6070,121408,2344,137494,6603,258902,Not in California
Outside California,2021-03-26,6871,396849,3609,200131,3076,189052,186,7666,4465,123682,2373,139867,4647,263549,Not in California
Outside California,2021-03-27,5661,402510,3153,203284,2286,191338,222,7888,3528,125310,2119,141986,3747,267296,Not in California
Outside California,2021-03-28,3150,405660,1683,204967,1304,192642,163,8051,2021,126377,1117,143103,2184,269480,Not in California
Outside California,2021-03-29,5368,411028,2402,207369,2614,195256,352,8403,3052,127477,2305,145408,3405,272885,Not in California
Outside California,2021-03-30,7068,418096,3710,211079,2779,198035,579,8982,4158,129325,2895,148303,4743,277628,Not in California
Outside California,2021-03-31,6540,424636,3890,214969,1852,199887,798,9780,3469,130522,3061,151364,4258,281886,Not in California
Outside California,2021-04-01,7794,432430,4661,219630,2460,202347,673,10453,4495,132395,3280,154644,5153,287039,Not in California
Outside California,2021-04-02,8625,441055,4589,224219,2895,205242,1141,11594,4461,133840,4148,158792,5593,292632,Not in California
Outside California,2021-04-03,6420,447475,3828,228047,1426,206668,1166,12760,3435,135462,2973,161765,4595,297227,Not in California
Outside California,2021-04-04,1867,449342,918,228965,705,207373,244,13004,1011,135856,853,162618,1247,298474,Not in California
Outside California,2021-04-05,4336,453678,2108,231073,1530,208903,698,13702,2067,136355,2256,164874,2755,301229,Not in California
Outside California,2021-04-06,7362,461040,3963,235036,1738,210641,1661,15363,2970,136607,4369,169243,4621,305850,Not in California
Outside California,2021-04-07,8487,469527,4769,239805,1979,212620,1739,17102,3328,136517,5142,174385,5052,310902,Not in California
Outside California,2021-04-08,8458,477985,4454,244259,2034,214654,1970,19072,3401,136827,5039,179424,5349,316251,Not in California
Outside California,2021-04-09,7780,485765,3995,248254,1804,216458,1981,21053,3025,137079,4739,184163,4991,321242,Not in California
Outside California,2021-04-10,6230,491995,3058,251312,1301,217759,1871,22924,1736,136193,4478,188641,3592,324834,Not in California
Outside California,2021-04-11,2930,494925,1612,252924,661,218420,657,23581,998,135916,1927,190568,1650,326484,Not in California
Outside California,2021-04-12,4318,499243,2435,255359,1307,219727,576,24157,1926,136035,2382,192950,2501,328985,Not in California
Outside California,2021-04-13,5994,505237,3812,259171,2158,221885,24,24181,3096,136264,2890,195840,3119,332104,Not in California
Outside California,2021-04-14,5680,510917,3645,262816,2031,223916,4,24185,3126,136852,2542,198382,3130,335234,Not in California
Outside California,2021-04-15,6338,517255,3975,266791,2357,226273,6,24191,3390,137362,2887,201269,3397,338631,Not in California
Outside California,2021-04-16,6123,523378,3521,270312,2593,228866,9,24200,3406,138080,2700,203969,3418,342049,Not in California
Outside California,2021-04-17,5674,529052,3574,273886,2099,230965,1,24201,3275,138974,2381,206350,3275,345324,Not in California
Outside California,2021-04-18,2258,531310,1311,275197,946,231911,1,24202,1109,138944,1142,207492,1112,346436,Not in California
Outside California,2021-04-19,4310,535620,2093,277290,2215,234126,2,24204,2208,139069,2088,209580,2213,348649,Not in California
Outside California,2021-04-20,5684,541304,2645,279935,3038,237164,1,24205,2324,138051,3342,212922,2324,350973,Not in California
Outside California,2021-04-21,6836,548140,3001,282936,3829,240993,6,24211,2502,136245,4314,217236,2508,353481,Not in California
Outside California,2021-04-22,7191,555331,3723,286659,3465,244458,3,24214,2639,134354,4534,221770,2643,356124,Not in California
Outside California,2021-04-23,6208,561539,3242,289901,2964,247422,2,24216,2561,133298,3622,225392,2566,358690,Not in California
Outside California,2021-04-24,4868,566407,3202,293103,1661,249083,5,24221,1952,132354,2904,228296,1960,360650,Not in California
Outside California,2021-04-25,2317,568724,1315,294418,1001,250084,1,24222,1218,132480,1096,229392,1222,361872,Not in California
Outside California,2021-04-26,4346,573070,1958,296376,2359,252443,29,24251,1942,132063,2388,231780,1971,363843,Not in California
Outside California,2021-04-27,5922,578992,2277,298653,3273,255716,372,24623,2067,130669,3841,235621,2447,366290,Not in California
Outside California,2021-04-28,5135,584127,2253,300906,2483,258199,399,25022,2006,129961,3107,238728,2399,368689,Not in California
Outside California,2021-04-29,5082,589209,2424,303330,2218,260417,440,25462,1919,129182,3138,241866,2359,371048,Not in California
Outside California,2021-04-30,5181,594390,2553,305883,2197,262614,431,25893,1945,128342,3219,245085,2379,373427,Not in California
Outside California,2021-05-01,3318,597708,1919,307802,965,263579,434,26327,1343,128165,1956,247041,1779,375206,Not in California
Outside California,2021-05-02,1928,599636,1147,308949,654,264233,127,26454,840,128056,1078,248119,969,376175,Not in California
Outside California,2021-05-03,3056,602692,1693,310642,1070,265303,293,26747,1176,127651,1873,249992,1468,377643,Not in California
Outside California,2021-05-04,4157,606849,2277,312919,1429,266732,451,27198,1360,126674,2785,252777,1808,379451,Not in California
Outside California,2021-05-05,4718,611567,2679,315598,1661,268393,378,27576,1678,125703,3030,255807,2059,381510,Not in California
Outside California,2021-05-06,4716,616283,2919,318517,1457,269850,340,27916,1621,124582,3082,258889,1961,383471,Not in California
Outside California,2021-05-07,4860,621143,2835,321352,1630,271480,395,28311,1647,123435,3188,262077,2041,385512,Not in California
Outside California,2021-05-08,3372,624515,2301,323653,819,272299,252,28563,1094,122517,2264,264341,1346,386858,Not in California
Outside California,2021-05-09,1432,625947,970,324623,341,272640,121,28684,581,122373,845,265186,701,387559,Not in California
Outside California,2021-05-10,2688,628635,1273,325896,1086,273726,329,29013,933,121890,1747,266933,1264,388823,Not in California
Outside California,2021-05-11,3269,631904,1640,327536,1324,275050,305,29318,1186,121313,2073,269006,1496,390319,Not in California
Outside California,2021-05-12,3362,635266,1643,329179,1385,276435,334,29652,1275,120841,2080,271086,1608,391927,Not in California
Outside California,2021-05-13,3335,638601,1947,331126,1175,277610,213,29865,1413,120553,1914,273000,1626,393553,Not in California
Outside California,2021-05-14,3676,642277,2086,333212,1344,278954,246,30111,1606,120346,2062,275062,1855,395408,Not in California
Outside California,2021-05-15,2739,645016,1618,334830,976,279930,145,30256,1145,120053,1586,276648,1293,396701,Not in California
Outside California,2021-05-16,1705,646721,1113,335943,522,280452,70,30326,772,119965,931,277579,843,397544,Not in California
Outside California,2021-05-17,3116,649837,1664,337607,1217,281669,235,30561,1316,119721,1794,279373,1550,399094,Not in California
Outside California,2021-05-18,3310,653147,1681,339288,1316,282985,313,30874,1456,119652,1839,281212,1770,400864,Not in California
Outside California,2021-05-19,3426,656573,1725,341013,1428,284413,273,31147,1462,119433,1953,283165,1734,402598,Not in California
Outside California,2021-05-20,3237,659810,1808,342821,1173,285586,256,31403,1436,119339,1789,284954,1695,404293,Not in California
Outside California,2021-05-21,3254,663064,1812,344633,1189,286775,253,31656,1360,119072,1880,286834,1613,405906,Not in California
Outside California,2021-05-22,2861,665925,1883,346516,776,287551,202,31858,1528,119479,1324,288158,1731,407637,Not in California
Outside California,2021-05-23,1608,667533,1051,347567,479,288030,78,31936,808,119568,798,288956,887,408524,Not in California
Outside California,2021-05-24,2475,670008,1189,348756,939,288969,347,32283,1068,119587,1396,290352,1415,409939,Not in California
Outside California,2021-05-25,2435,672443,1148,349904,950,289919,337,32620,1021,119537,1404,291756,1354,411293,Not in California
Outside California,2021-05-26,2437,674880,1137,351041,942,290861,358,32978,1005,119479,1422,293178,1364,412657,Not in California
Outside California,2021-05-27,2211,677091,1089,352130,824,291685,298,33276,980,119530,1225,294403,1276,413933,Not in California
Outside California,2021-05-28,2480,679571,1251,353381,875,292560,354,33630,1106,119624,1367,295770,1461,415394,Not in California
Outside California,2021-05-29,1699,681270,853,354234,488,293048,358,33988,709,119706,985,296755,1067,416461,Not in California
Outside California,2021-05-30,946,682216,587,354821,233,293281,126,34114,472,119835,469,297224,598,417059,Not in California
Outside California,2021-05-31,442,682658,200,355021,204,293485,38,34152,195,119831,237,297461,233,417292,Not in California
Outside California,2021-06-01,2175,684833,1156,356177,714,294199,305,34457,1006,119979,1164,298625,1312,418604,Not in California
Outside California,2021-06-02,2035,686868,1014,357191,668,294867,353,34810,905,120120,1120,299745,1261,419865,Not in California
Outside California,2021-06-03,2172,689040,1196,358387,663,295530,313,35123,973,120216,1190,300935,1286,421151,Not in California
Outside California,2021-06-04,2553,691593,1425,359812,803,296333,325,35448,1078,120148,1469,302404,1401,422552,Not in California
Outside California,2021-06-05,1707,693300,1184,360996,357,296690,166,35614,750,120113,949,303353,914,423466,Not in California
Outside California,2021-06-06,939,694239,708,361704,149,296839,82,35696,437,120132,500,303853,519,423985,Not in California
Outside California,2021-06-07,1935,696174,1056,362760,547,297386,332,36028,791,120110,1143,304996,1121,425106,Not in California
Outside California,2021-06-08,2081,698255,1188,363948,550,297936,343,36371,795,119965,1281,306277,1136,426242,Not in California
Outside California,2021-06-09,1973,700228,1182,365130,504,298440,287,36658,791,119866,1173,307450,1074,427316,Not in California
Outside California,2021-06-10,1985,702213,1162,366292,511,298951,312,36970,834,119862,1148,308598,1144,428460,Not in California
Outside California,2021-06-11,2180,704393,1251,367543,596,299547,333,37303,899,119821,1274,309872,1233,429693,Not in California
Outside California,2021-06-12,1619,706012,1211,368754,275,299822,133,37436,616,119572,999,310871,750,430443,Not in California
Outside California,2021-06-13,929,706941,631,369385,198,300020,100,37536,393,119532,532,311403,492,430935,Not in California
Outside California,2021-06-14,1758,708699,988,370373,466,300486,304,37840,723,119528,1029,312432,1025,431960,Not in California
Outside California,2021-06-15,1755,710454,964,371337,513,300999,278,38118,765,119590,981,313413,1043,433003,Not in California
Outside California,2021-06-16,1714,712168,1019,372356,464,301463,231,38349,798,119714,905,314318,1029,434032,Not in California
Outside California,2021-06-17,1829,713997,1009,373365,465,301928,355,38704,810,119864,1014,315332,1164,435196,Not in California
Outside California,2021-06-18,1988,715985,1094,374459,435,302363,459,39163,826,119996,1151,316483,1283,436479,Not in California
Outside California,2021-06-19,1056,717041,698,375157,258,302621,100,39263,537,120118,512,316995,634,437113,Not in California
Outside California,2021-06-20,791,717832,571,375728,173,302794,47,39310,455,120288,331,317326,501,437614,Not in California
Outside California,2021-06-21,1285,719117,647,376375,326,303120,312,39622,685,120691,594,317920,997,438611,Not in California
Outside California,2021-06-22,1635,720752,1033,377408,351,303471,251,39873,855,121024,773,318693,1106,439717,Not in California
Outside California,2021-06-23,1694,722446,937,378345,439,303910,318,40191,798,121250,889,319582,1115,440832,Not in California
Outside California,2021-06-24,1566,724012,917,379262,368,304278,281,40472,813,121592,751,320333,1093,441925,Not in California
Outside California,2021-06-25,1766,725778,1004,380266,401,304679,361,40833,834,121857,927,321260,1192,443117,Not in California
Outside California,2021-06-26,1135,726913,735,381001,217,304896,183,41016,571,122051,560,321820,754,443871,Not in California
Outside California,2021-06-27,751,727664,586,381587,107,305003,58,41074,438,122236,310,322130,495,444366,Not in California
Outside California,2021-06-28,1417,729081,846,382433,271,305274,300,41374,726,122574,690,322820,1028,445394,Not in California
Outside California,2021-06-29,1442,730523,874,383307,331,305605,237,41611,756,122885,680,323500,991,446385,Not in California
Outside California,2021-06-30,1407,731930,811,384118,376,305981,220,41831,746,123197,654,324154,966,447351,Not in California
Outside California,2021-07-01,1406,733336,817,384935,350,306331,239,42070,759,123556,637,324791,996,448347,Not in California
Outside California,2021-07-02,1384,734720,792,385727,351,306682,241,42311,698,123817,676,325467,937,449284,Not in California
Outside California,2021-07-03,811,735531,574,386301,152,306834,85,42396,513,124119,296,325763,598,449882,Not in California
Outside California,2021-07-04,104,735635,62,386363,26,306860,16,42412,62,124157,40,325803,78,449960,Not in California
Outside California,2021-07-05,1013,736648,631,386994,311,307171,71,42483,592,124405,416,326219,664,450624,Not in California
Outside California,2021-07-06,1437,738085,830,387824,317,307488,290,42773,663,124588,769,326988,952,451576,Not in California
Outside California,2021-07-07,1500,739585,787,388611,363,307851,350,43123,732,124901,763,327751,1076,452652,Not in California
Outside California,2021-07-08,1304,740889,704,389315,308,308159,292,43415,618,125131,677,328428,907,453559,Not in California
Outside California,2021-07-09,1314,742203,737,390052,333,308492,244,43659,626,125322,679,329107,870,454429,Not in California
Outside California,2021-07-10,862,743065,614,390666,172,308664,76,43735,505,125554,348,329455,580,455009,Not in California
Outside California,2021-07-11,632,743697,473,391139,114,308778,45,43780,376,125722,253,329708,421,455430,Not in California
Outside California,2021-07-12,1292,744989,778,391917,288,309066,226,44006,649,125963,634,330342,875,456305,Not in California
Outside California,2021-07-13,1290,746279,793,392710,322,309388,175,44181,629,126113,654,330996,804,457109,Not in California
Outside California,2021-07-14,1398,747677,767,393477,398,309786,233,44414,745,126444,645,331641,976,458085,Not in California
Outside California,2021-07-15,1372,749049,781,394258,337,310123,254,44668,665,126660,704,332345,920,459005,Not in California
Outside California,2021-07-16,1445,750494,802,395060,353,310476,290,44958,737,126987,701,333046,1028,460033,Not in California
Outside California,2021-07-17,924,751418,622,395682,199,310675,103,45061,545,127259,376,333422,648,460681,Not in California
Outside California,2021-07-18,620,752038,434,396116,134,310809,52,45113,373,127440,246,333668,427,461108,Not in California
Outside California,2021-07-19,1288,753326,817,396933,254,311063,217,45330,712,127806,564,334232,930,462038,Not in California
Outside California,2021-07-20,1472,754798,790,397723,348,311411,334,45664,768,128210,698,334930,1102,463140,Not in California
Outside California,2021-07-21,1525,756323,807,398530,430,311841,288,45952,826,128633,692,335622,1115,464255,Not in California
Outside California,2021-07-22,1597,757920,912,399442,452,312293,233,46185,922,129121,666,336288,1154,465409,Not in California
Outside California,2021-07-23,1519,759439,868,400310,426,312719,225,46410,910,129657,596,336884,1132,466541,Not in California
Outside California,2021-07-24,936,760375,637,400947,217,312936,82,46492,611,130031,319,337203,693,467234,Not in California
Outside California,2021-07-25,579,760954,415,401362,134,313070,30,46522,444,130379,126,337329,474,467708,Not in California
Outside California,2021-07-26,1455,762409,810,402172,375,313445,270,46792,838,130876,611,337940,1108,468816,Not in California
Outside California,2021-07-27,1446,763855,795,402967,427,313872,224,47016,887,131434,550,338490,1108,469924,Not in California
Outside California,2021-07-28,1573,765428,862,403829,499,314371,212,47228,1003,132088,562,339052,1216,471140,Not in California
Outside California,2021-07-29,1513,766941,864,404693,412,314783,237,47465,923,132668,579,339631,1159,472299,Not in California
Outside California,2021-07-30,1503,768444,871,405564,436,315219,196,47661,952,133281,536,340167,1149,473448,Not in California
Outside California,2021-07-31,744,769188,467,406031,200,315419,77,47738,469,133557,271,340438,547,473995,Not in California
Unknown,2020-12-17,2,2,2,2,0,0,0,0,0,0,0,0,0,0,Not in California
Unknown,2020-12-18,1,3,1,3,0,0,0,0,0,0,0,0,0,0,Not in California
Unknown,2020-12-21,4,7,4,7,0,0,0,0,0,0,0,0,0,0,Not in California
Unknown,2020-12-28,1,8,1,8,0,0,0,0,1,1,0,0,1,1,Not in California
Unknown,2020-12-29,2,10,1,9,1,1,0,0,3,4,0,0,3,4,Not in California
Unknown,2020-12-30,54,64,54,63,0,1,0,0,54,58,0,0,54,58,Not in California
Unknown,2020-12-31,1,65,0,63,1,2,0,0,0,58,0,0,0,58,Not in California
Unknown,2021-01-02,1,66,0,63,1,3,0,0,1,59,0,0,1,59,Not in California
Unknown,2021-01-04,1,67,1,64,0,3,0,0,1,60,0,0,1,60,Not in California
Unknown,2021-01-06,4,71,2,66,2,5,0,0,4,64,0,0,4,64,Not in California
Unknown,2021-01-07,70,141,70,136,0,5,0,0,69,133,0,0,69,133,Not in California
Unknown,2021-01-09,1,142,1,137,0,5,0,0,1,135,0,0,1,135,Not in California
Unknown,2021-01-11,20,162,20,157,0,5,0,0,21,156,0,0,21,156,Not in California
Unknown,2021-01-12,7,169,6,163,1,6,0,0,5,161,1,1,6,162,Not in California
Unknown,2021-01-13,3,172,3,166,0,6,0,0,3,164,0,1,3,165,Not in California
Unknown,2021-01-14,4,176,4,170,0,6,0,0,4,168,0,1,4,169,Not in California
Unknown,2021-01-15,5,181,4,174,1,7,0,0,5,173,0,1,5,174,Not in California
Unknown,2021-01-16,4,185,4,178,0,7,0,0,4,177,0,1,4,178,Not in California
Unknown,2021-01-18,9,194,9,187,0,7,0,0,9,186,0,1,9,187,Not in California
Unknown,2021-01-19,5,199,5,192,0,7,0,0,4,190,0,1,4,191,Not in California
Unknown,2021-01-20,55,254,55,247,0,7,0,0,3,140,53,54,3,194,Not in California
Unknown,2021-01-21,17,271,15,262,2,9,0,0,18,157,1,55,18,212,Not in California
Unknown,2021-01-22,10,281,6,268,4,13,0,0,11,168,0,55,11,223,Not in California
Unknown,2021-01-23,8,289,4,272,4,17,0,0,8,176,0,55,8,231,Not in California
Unknown,2021-01-24,2,291,2,274,0,17,0,0,3,179,0,55,3,234,Not in California
Unknown,2021-01-25,7,298,4,278,3,20,0,0,5,182,2,57,5,239,Not in California
Unknown,2021-01-26,10,308,9,287,1,21,0,0,12,193,1,58,12,251,Not in California
Unknown,2021-01-27,9,317,9,296,0,21,0,0,7,199,1,59,7,258,Not in California
Unknown,2021-01-28,82,399,80,376,2,23,0,0,25,164,60,119,25,283,Not in California
Unknown,2021-01-29,105,504,105,481,0,23,0,0,109,272,1,120,109,392,Not in California
Unknown,2021-01-30,6,510,4,485,2,25,0,0,9,280,1,121,9,401,Not in California
Unknown,2021-01-31,2,512,2,487,0,25,0,0,3,283,0,121,3,404,Not in California
Unknown,2021-02-01,34,546,32,519,2,27,0,0,15,277,21,142,15,419,Not in California
Unknown,2021-02-02,14,560,13,532,1,28,0,0,10,283,4,146,10,429,Not in California
Unknown,2021-02-03,3,563,3,535,0,28,0,0,1,282,2,148,1,430,Not in California
Unknown,2021-02-04,16,579,12,547,4,32,0,0,8,283,7,155,8,438,Not in California
Unknown,2021-02-05,15,594,12,559,3,35,0,0,11,290,4,159,11,449,Not in California
Unknown,2021-02-06,4,598,4,563,0,35,0,0,1,288,3,162,1,450,Not in California
Unknown,2021-02-07,1,599,1,564,0,35,0,0,1,289,0,162,1,451,Not in California
Unknown,2021-02-08,5,604,4,568,1,36,0,0,2,288,3,165,2,453,Not in California
Unknown,2021-02-09,2,606,2,570,0,36,0,0,1,288,1,166,1,454,Not in California
Unknown,2021-02-10,5,611,1,571,4,40,0,0,5,293,0,166,5,459,Not in California
Unknown,2021-02-11,12,623,11,582,1,41,0,0,2,284,11,177,2,461,Not in California
Unknown,2021-02-12,7,630,5,587,2,43,0,0,2,281,5,182,2,463,Not in California
Unknown,2021-02-13,7,637,3,590,4,47,0,0,5,284,2,184,5,468,Not in California
Unknown,2021-02-14,4,641,2,592,2,49,0,0,2,284,2,186,2,470,Not in California
Unknown,2021-02-15,30,671,27,619,3,52,0,0,25,306,3,189,25,495,Not in California
Unknown,2021-02-16,14,685,9,628,5,57,0,0,5,302,9,198,5,500,Not in California
Unknown,2021-02-17,8,693,6,634,2,59,0,0,5,302,5,203,5,505,Not in California
Unknown,2021-02-18,18,711,13,647,5,64,0,0,5,293,14,217,5,510,Not in California
Unknown,2021-02-19,131,842,126,773,5,69,0,0,30,222,101,318,30,540,Not in California
Unknown,2021-02-20,3,845,2,775,1,70,0,0,2,223,1,319,2,542,Not in California
Unknown,2021-02-21,2,847,2,777,0,70,0,0,0,221,2,321,0,542,Not in California
Unknown,2021-02-22,8,855,8,785,0,70,0,0,0,213,8,329,0,542,Not in California
Unknown,2021-02-23,15,870,5,790,10,80,0,0,7,213,7,336,7,549,Not in California
Unknown,2021-02-24,10,880,2,792,8,88,0,0,8,219,2,338,8,557,Not in California
Unknown,2021-02-25,28,908,14,806,14,102,0,0,17,224,12,350,17,574,Not in California
Unknown,2021-02-26,31,939,15,821,16,118,0,0,16,225,15,365,16,590,Not in California
Unknown,2021-02-27,17,956,11,832,6,124,0,0,13,237,1,366,13,603,Not in California
Unknown,2021-02-28,8,964,5,837,3,127,0,0,6,243,0,366,6,609,Not in California
Unknown,2021-03-01,14,978,5,842,9,136,0,0,7,244,6,372,7,616,Not in California
Unknown,2021-03-02,20,998,7,849,13,149,0,0,13,252,5,377,13,629,Not in California
Unknown,2021-03-03,7,1005,4,853,3,152,0,0,6,258,0,377,6,635,Not in California
Unknown,2021-03-04,12,1017,9,862,3,155,0,0,11,269,0,377,11,646,Not in California
Unknown,2021-03-05,11,1028,4,866,7,162,0,0,10,277,2,379,10,656,Not in California
Unknown,2021-03-06,13,1041,7,873,4,166,2,2,12,289,2,381,14,670,Not in California
Unknown,2021-03-07,1,1042,0,873,0,166,1,3,1,290,1,382,2,672,Not in California
Unknown,2021-03-08,26,1068,20,893,5,171,1,4,6,277,20,402,7,679,Not in California
Unknown,2021-03-09,9,1077,4,897,2,173,3,7,5,281,4,406,8,687,Not in California
Unknown,2021-03-10,9,1086,6,903,1,174,2,9,3,279,7,413,5,692,Not in California
Unknown,2021-03-11,21,1107,4,907,3,177,14,23,2,278,17,430,16,708,Not in California
Unknown,2021-03-12,37,1144,29,936,3,180,5,28,7,259,31,461,12,720,Not in California
Unknown,2021-03-13,10,1154,1,937,5,185,4,32,0,254,9,470,4,724,Not in California
Unknown,2021-03-14,3,1157,0,937,2,187,1,33,0,252,3,473,1,725,Not in California
Unknown,2021-03-15,20,1177,8,945,10,197,2,35,14,262,6,479,16,741,Not in California
Unknown,2021-03-16,24,1201,6,951,14,211,4,39,16,273,9,488,20,761,Not in California
Unknown,2021-03-17,27,1228,8,959,18,229,1,40,27,299,2,490,28,789,Not in California
Unknown,2021-03-18,21,1249,9,968,12,241,0,40,13,306,6,496,13,802,Not in California
Unknown,2021-03-19,13,1262,7,975,6,247,0,40,9,311,4,500,9,811,Not in California
Unknown,2021-03-20,15,1277,7,982,8,255,0,40,3,308,6,506,3,814,Not in California
Unknown,2021-03-21,7,1284,2,984,5,260,0,40,6,313,1,507,6,820,Not in California
Unknown,2021-03-22,17,1301,6,990,10,270,1,41,7,313,8,515,8,828,Not in California
Unknown,2021-03-23,16,1317,3,993,7,277,6,47,4,312,11,526,10,838,Not in California
Unknown,2021-03-24,13,1330,3,996,10,287,0,47,8,315,5,531,8,846,Not in California
Unknown,2021-03-25,22,1352,12,1008,10,297,0,47,13,319,9,540,13,859,Not in California
Unknown,2021-03-26,17,1369,5,1013,7,304,5,52,8,324,8,548,13,872,Not in California
Unknown,2021-03-27,24,1393,10,1023,11,315,3,55,13,326,14,562,16,888,Not in California
Unknown,2021-03-28,8,1401,2,1025,6,321,0,55,6,331,1,563,6,894,Not in California
Unknown,2021-03-29,19,1420,8,1033,10,331,1,56,13,339,6,569,14,908,Not in California
Unknown,2021-03-30,16,1436,5,1038,11,342,0,56,9,342,6,575,9,917,Not in California
Unknown,2021-03-31,19,1455,10,1048,8,350,1,57,15,353,5,580,16,933,Not in California
Unknown,2021-04-01,20,1475,12,1060,5,355,3,60,14,365,5,585,17,950,Not in California
Unknown,2021-04-02,33,1508,13,1073,11,366,9,69,13,367,20,605,22,972,Not in California
Unknown,2021-04-03,12,1520,4,1077,8,374,0,69,10,371,6,611,10,982,Not in California
Unknown,2021-04-04,6,1526,1,1078,5,379,0,69,5,375,1,612,5,987,Not in California
Unknown,2021-04-05,16,1542,6,1084,9,388,1,70,6,373,9,621,7,994,Not in California
Unknown,2021-04-06,14,1556,8,1092,5,393,1,71,7,376,5,626,8,1002,Not in California
Unknown,2021-04-07,25,1581,17,1109,7,400,1,72,17,386,7,633,17,1019,Not in California
Unknown,2021-04-08,19,1600,11,1120,4,404,4,76,12,394,8,641,16,1035,Not in California
Unknown,2021-04-09,14,1614,10,1130,4,408,0,76,10,401,3,644,10,1045,Not in California
Unknown,2021-04-10,4,1618,3,1133,0,408,1,77,1,400,3,647,2,1047,Not in California
Unknown,2021-04-11,7,1625,6,1139,1,409,0,77,3,401,2,649,3,1050,Not in California
Unknown,2021-04-12,16,1641,5,1144,10,419,1,78,6,398,10,659,7,1057,Not in California
Unknown,2021-04-13,25,1666,9,1153,16,435,0,78,9,393,14,673,9,1066,Not in California
Unknown,2021-04-14,21,1687,2,1155,19,454,0,78,4,381,16,689,4,1070,Not in California
Unknown,2021-04-15,20,1707,7,1162,12,466,1,79,10,380,11,700,10,1080,Not in California
Unknown,2021-04-16,14,1721,8,1170,6,472,0,79,7,380,7,707,7,1087,Not in California
Unknown,2021-04-17,12,1733,9,1179,3,475,0,79,5,380,6,713,6,1093,Not in California
Unknown,2021-04-18,10,1743,3,1182,7,482,0,79,6,381,5,718,6,1099,Not in California
Unknown,2021-04-19,13,1756,2,1184,11,493,0,79,3,375,9,727,3,1102,Not in California
Unknown,2021-04-20,13,1769,6,1190,7,500,0,79,5,372,8,735,5,1107,Not in California
Unknown,2021-04-21,28,1797,13,1203,15,515,0,79,10,365,17,752,10,1117,Not in California
Unknown,2021-04-22,19,1816,10,1213,9,524,0,79,4,356,13,765,4,1121,Not in California
Unknown,2021-04-23,16,1832,6,1219,10,534,0,79,8,357,7,772,8,1129,Not in California
Unknown,2021-04-24,28,1860,18,1237,10,544,0,79,15,359,13,785,15,1144,Not in California
Unknown,2021-04-25,10,1870,4,1241,6,550,0,79,4,358,5,790,4,1148,Not in California
Unknown,2021-04-26,27,1897,12,1253,15,565,0,79,19,368,9,799,19,1167,Not in California
Unknown,2021-04-27,24,1921,12,1265,11,576,1,80,10,366,13,812,11,1178,Not in California
Unknown,2021-04-28,26,1947,20,1285,5,581,1,81,10,361,16,828,11,1189,Not in California
Unknown,2021-04-29,23,1970,15,1300,8,589,0,81,11,358,14,842,11,1200,Not in California
Unknown,2021-04-30,21,1991,9,1309,8,597,4,85,11,362,11,853,15,1215,Not in California
Unknown,2021-05-01,21,2012,15,1324,6,603,0,85,12,366,8,861,12,1227,Not in California
Unknown,2021-05-02,10,2022,4,1328,6,609,0,85,1,360,7,868,1,1228,Not in California
Unknown,2021-05-03,15,2037,9,1337,4,613,2,87,6,360,8,876,8,1236,Not in California
Unknown,2021-05-04,15,2052,5,1342,4,617,6,93,3,357,12,888,9,1245,Not in California
Unknown,2021-05-05,16,2068,5,1347,9,626,2,95,9,360,8,896,11,1256,Not in California
Unknown,2021-05-06,31,2099,15,1362,8,634,8,103,10,356,22,918,18,1274,Not in California
Unknown,2021-05-07,20,2119,11,1373,6,640,3,106,10,357,12,930,13,1287,Not in California
Unknown,2021-05-08,11,2130,7,1380,2,642,2,108,4,357,6,936,6,1293,Not in California
Unknown,2021-05-09,14,2144,4,1384,7,649,3,111,8,362,6,942,11,1304,Not in California
Unknown,2021-05-10,9,2153,2,1386,4,653,3,114,3,363,5,947,6,1310,Not in California
Unknown,2021-05-11,15,2168,6,1392,5,658,4,118,6,364,9,956,10,1320,Not in California
Unknown,2021-05-12,9,2177,3,1395,5,663,1,119,3,363,5,961,4,1324,Not in California
Unknown,2021-05-13,12,2189,6,1401,1,664,5,124,7,368,8,969,13,1337,Not in California
Unknown,2021-05-14,15,2204,12,1413,2,666,1,125,14,381,1,970,14,1351,Not in California
Unknown,2021-05-15,12,2216,10,1423,2,668,0,125,9,387,3,973,9,1360,Not in California
Unknown,2021-05-16,16,2232,11,1434,4,672,1,126,10,392,6,979,11,1371,Not in California
Unknown,2021-05-17,15,2247,10,1444,3,675,2,128,4,388,10,989,6,1377,Not in California
Unknown,2021-05-18,20,2267,13,1457,5,680,2,130,10,390,10,999,12,1389,Not in California
Unknown,2021-05-19,27,2294,20,1477,6,686,1,131,11,387,15,1014,12,1401,Not in California
Unknown,2021-05-20,15,2309,10,1487,4,690,1,132,7,388,7,1021,8,1409,Not in California
Unknown,2021-05-21,19,2328,9,1496,6,696,4,136,8,389,11,1032,12,1421,Not in California
Unknown,2021-05-22,25,2353,19,1515,5,701,1,137,11,390,11,1043,12,1433,Not in California
Unknown,2021-05-23,7,2360,5,1520,2,703,0,137,7,396,1,1044,7,1440,Not in California
Unknown,2021-05-24,8,2368,5,1525,2,705,1,138,4,397,4,1048,5,1445,Not in California
Unknown,2021-05-25,16,2384,6,1531,4,709,6,144,7,402,8,1056,13,1458,Not in California
Unknown,2021-05-26,9,2393,6,1537,2,711,1,145,5,404,4,1060,6,1464,Not in California
Unknown,2021-05-27,16,2409,10,1547,4,715,2,147,6,403,9,1069,8,1472,Not in California
Unknown,2021-05-28,22,2431,11,1558,5,720,6,153,13,412,10,1079,19,1491,Not in California
Unknown,2021-05-29,18,2449,17,1575,1,721,0,153,14,422,4,1083,14,1505,Not in California
Unknown,2021-05-30,17,2466,15,1590,0,721,2,155,12,431,5,1088,14,1519,Not in California
Unknown,2021-05-31,1,2467,1,1591,0,721,0,155,0,430,1,1089,0,1519,Not in California
Unknown,2021-06-01,21,2488,9,1600,6,727,6,161,10,435,11,1100,16,1535,Not in California
Unknown,2021-06-02,7,2495,3,1603,4,731,0,161,2,433,4,1104,2,1537,Not in California
Unknown,2021-06-03,11,2506,11,1614,0,731,0,161,7,436,4,1108,7,1544,Not in California
Unknown,2021-06-04,23,2529,14,1628,9,740,0,161,11,435,12,1120,11,1555,Not in California
Unknown,2021-06-05,30,2559,22,1650,7,747,1,162,17,441,12,1132,18,1573,Not in California
Unknown,2021-06-06,26,2585,17,1667,6,753,3,165,11,440,15,1147,14,1587,Not in California
Unknown,2021-06-07,16,2601,8,1675,7,760,1,166,9,443,7,1154,10,1597,Not in California
Unknown,2021-06-08,12,2613,5,1680,4,764,3,169,4,442,8,1162,7,1604,Not in California
Unknown,2021-06-09,20,2633,13,1693,7,771,0,169,8,440,10,1172,8,1612,Not in California
Unknown,2021-06-10,10,2643,7,1700,3,774,0,169,5,440,5,1177,5,1617,Not in California
Unknown,2021-06-11,5,2648,3,1703,1,775,1,170,3,442,2,1179,4,1621,Not in California
Unknown,2021-06-12,14,2662,10,1713,4,779,0,170,8,444,6,1185,8,1629,Not in California
Unknown,2021-06-13,8,2670,4,1717,4,783,0,170,2,440,6,1191,2,1631,Not in California
Unknown,2021-06-14,11,2681,9,1726,2,785,0,170,4,439,5,1196,4,1635,Not in California
Unknown,2021-06-15,17,2698,9,1735,7,792,1,171,7,436,11,1207,8,1643,Not in California
Unknown,2021-06-16,7,2705,4,1739,3,795,0,171,5,439,2,1209,5,1648,Not in California
Unknown,2021-06-17,13,2718,7,1746,4,799,2,173,10,448,3,1212,12,1660,Not in California
Unknown,2021-06-18,12,2730,9,1755,3,802,0,173,5,446,7,1219,5,1665,Not in California
Unknown,2021-06-19,12,2742,10,1765,2,804,0,173,2,439,9,1228,2,1667,Not in California
Unknown,2021-06-20,4,2746,3,1768,1,805,0,173,1,438,2,1230,1,1668,Not in California
Unknown,2021-06-21,12,2758,8,1776,4,809,0,173,8,442,4,1234,8,1676,Not in California
Unknown,2021-06-22,14,2772,9,1785,5,814,0,173,9,447,4,1238,9,1685,Not in California
Unknown,2021-06-23,7,2779,2,1787,4,818,1,174,5,450,3,1241,6,1691,Not in California
Unknown,2021-06-24,12,2791,6,1793,5,823,1,175,7,453,5,1246,8,1699,Not in California
Unknown,2021-06-25,13,2804,12,1805,1,824,0,175,8,457,4,1250,8,1707,Not in California
Unknown,2021-06-26,9,2813,9,1814,0,824,0,175,7,462,2,1252,7,1714,Not in California
Unknown,2021-06-27,18,2831,13,1827,3,827,2,177,8,462,10,1262,10,1724,Not in California
Unknown,2021-06-28,14,2845,11,1838,3,830,0,177,9,466,5,1267,9,1733,Not in California
Unknown,2021-06-29,6,2851,4,1842,2,832,0,177,5,470,1,1268,5,1738,Not in California
Unknown,2021-06-30,10,2861,9,1851,1,833,0,177,6,472,4,1272,6,1744,Not in California
Unknown,2021-07-01,10,2871,9,1860,1,834,0,177,5,473,4,1276,5,1749,Not in California
Unknown,2021-07-02,5,2876,2,1862,3,837,0,177,2,472,3,1279,2,1751,Not in California
Unknown,2021-07-03,6,2882,6,1868,0,837,0,177,4,473,3,1282,4,1755,Not in California
Unknown,2021-07-05,18,2900,13,1881,4,841,1,178,13,482,5,1287,14,1769,Not in California
Unknown,2021-07-06,9,2909,6,1887,3,844,0,178,6,485,3,1290,6,1775,Not in California
Unknown,2021-07-07,21,2930,16,1903,3,847,2,180,13,492,8,1298,15,1790,Not in California
Unknown,2021-07-08,22,2952,19,1922,3,850,0,180,15,500,7,1305,15,1805,Not in California
Unknown,2021-07-09,9,2961,5,1927,2,852,2,182,3,499,6,1311,5,1810,Not in California
Unknown,2021-07-10,10,2971,6,1933,4,856,0,182,6,501,4,1315,6,1816,Not in California
Unknown,2021-07-11,5,2976,5,1938,0,856,0,182,4,504,1,1316,4,1820,Not in California
Unknown,2021-07-12,6,2982,4,1942,2,858,0,182,2,502,4,1320,2,1822,Not in California
Unknown,2021-07-13,12,2994,11,1953,1,859,0,182,9,508,3,1323,9,1831,Not in California
Unknown,2021-07-14,8,3002,4,1957,4,863,0,182,4,508,4,1327,4,1835,Not in California
Unknown,2021-07-15,19,3021,10,1967,8,871,1,183,10,510,9,1336,11,1846,Not in California
Unknown,2021-07-16,12,3033,10,1977,2,873,0,183,8,514,4,1340,8,1854,Not in California
Unknown,2021-07-17,8,3041,8,1985,0,873,0,183,7,520,1,1341,7,1861,Not in California
Unknown,2021-07-18,7,3048,7,1992,0,873,0,183,3,519,4,1345,3,1864,Not in California
Unknown,2021-07-19,10,3058,8,2000,2,875,0,183,5,519,5,1350,5,1869,Not in California
Unknown,2021-07-20,14,3072,8,2008,5,880,1,184,3,512,11,1361,4,1873,Not in California
Unknown,2021-07-21,7,3079,6,2014,1,881,0,184,5,515,2,1363,5,1878,Not in California
Unknown,2021-07-22,11,3090,8,2022,3,884,0,184,6,516,5,1368,6,1884,Not in California
Unknown,2021-07-23,19,3109,16,2038,3,887,0,184,17,531,2,1370,17,1901,Not in California
Unknown,2021-07-24,7,3116,6,2044,1,888,0,184,5,534,2,1372,5,1906,Not in California
Unknown,2021-07-25,5,3121,3,2047,1,889,1,185,4,538,1,1373,5,1911,Not in California
Unknown,2021-07-26,11,3132,10,2057,1,890,0,185,7,541,4,1377,7,1918,Not in California
Unknown,2021-07-27,15,3147,12,2069,3,893,0,185,11,548,4,1381,11,1929,Not in California
Unknown,2021-07-28,16,3163,9,2078,7,900,0,185,13,558,3,1384,13,1942,Not in California
Unknown,2021-07-29,16,3179,14,2092,2,902,0,185,3,548,13,1397,3,1945,Not in California
Unknown,2021-07-30,5,3184,4,2096,1,903,0,185,4,551,1,1398,4,1949,Not in California
Unknown,2021-07-31,6,3190,3,2099,3,906,0,185,5,555,1,1399,5,1954,Not in California
Alameda,2020-12-15,41,41,41,41,0,0,0,0,41,41,0,0,41,41,California
Alameda,2020-12-16,211,252,211,252,0,0,0,0,211,252,0,0,211,252,California
Alameda,2020-12-17,506,758,506,758,0,0,0,0,506,758,0,0,506,758,California
Alameda,2020-12-18,1900,2658,1899,2657,1,1,0,0,1900,2658,0,0,1900,2658,California
Alameda,2020-12-19,1408,4066,1408,4065,0,1,0,0,1408,4066,0,0,1408,4066,California
Alameda,2020-12-20,1172,5238,1171,5236,1,2,0,0,1171,5236,1,1,1171,5237,California
Alameda,2020-12-21,1832,7070,1830,7066,2,4,0,0,1831,7067,0,1,1831,7068,California
Alameda,2020-12-22,2083,9153,2030,9096,53,57,0,0,2082,9148,1,2,2082,9150,California
Alameda,2020-12-23,1926,11079,1671,10767,255,312,0,0,1925,11072,1,3,1925,11075,California
Alameda,2020-12-24,1199,12278,743,11510,456,768,0,0,1199,12271,0,3,1199,12274,California
Alameda,2020-12-25,155,12433,122,11632,33,801,0,0,155,12426,0,3,155,12429,California
Alameda,2020-12-26,843,13276,319,11951,524,1325,0,0,843,13269,0,3,843,13272,California
Alameda,2020-12-27,486,13762,250,12201,236,1561,0,0,486,13755,0,3,486,13758,California
Alameda,2020-12-28,1865,15627,962,13163,903,2464,0,0,1865,15620,0,3,1865,15623,California
Alameda,2020-12-29,2468,18095,1076,14239,1392,3856,0,0,2467,18087,0,3,2467,18090,California
Alameda,2020-12-30,3066,21161,1326,15565,1740,5596,0,0,3066,21153,0,3,3066,21156,California
Alameda,2020-12-31,1793,22954,448,16013,1345,6941,0,0,1790,22941,2,5,1790,22946,California
Alameda,2021-01-01,179,23133,74,16087,105,7046,0,0,177,23116,2,7,177,23123,California
Alameda,2021-01-02,725,23858,523,16610,202,7248,0,0,724,23840,0,7,724,23847,California
Alameda,2021-01-03,328,24186,214,16824,114,7362,0,0,325,24162,3,10,325,24172,California
Alameda,2021-01-04,1603,25789,909,17733,694,8056,0,0,1591,25742,11,21,1591,25763,California
Alameda,2021-01-05,2203,27992,1273,19006,930,8986,0,0,1948,27438,252,273,1948,27711,California
Alameda,2021-01-06,3239,31231,1798,20804,1441,10427,0,0,2369,28942,868,1141,2372,30083,California
Alameda,2021-01-07,3800,35031,2133,22937,1667,12094,0,0,2626,30408,1165,2306,2631,32714,California
Alameda,2021-01-08,4750,39781,2705,25642,2045,14139,0,0,3030,31728,1715,4021,3035,35749,California
Alameda,2021-01-09,2015,41796,1373,27015,642,14781,0,0,1156,32025,859,4880,1156,36905,California
Alameda,2021-01-10,1058,42854,837,27852,221,15002,0,0,426,31819,632,5512,426,37331,California
Alameda,2021-01-11,4688,47542,3553,31405,1135,16137,0,0,2876,32892,1810,7322,2883,40214,California
Alameda,2021-01-12,4865,52407,3275,34680,1590,17727,0,0,3471,34976,1390,8712,3474,43688,California
Alameda,2021-01-13,5064,57471,2706,37386,2358,20085,0,0,3860,37639,1199,9911,3862,47550,California
Alameda,2021-01-14,5663,63134,2813,40199,2850,22935,0,0,4758,41505,895,10806,4761,52311,California
Alameda,2021-01-15,5805,68939,2314,42513,3491,26426,0,0,5032,45777,764,11570,5036,57347,California
Alameda,2021-01-16,2957,71896,1375,43888,1582,28008,0,0,2696,48212,262,11832,2697,60044,California
Alameda,2021-01-17,1873,73769,1090,44978,783,28791,0,0,1667,49674,206,12038,1668,61712,California
Alameda,2021-01-18,3146,76915,2023,47001,1123,29914,0,0,2555,51646,585,12623,2557,64269,California
Alameda,2021-01-19,5488,82403,3306,50307,2182,32096,0,0,4296,54754,1190,13813,4298,68567,California
Alameda,2021-01-20,6878,89281,4207,54514,2671,34767,0,0,5585,59066,1279,15092,5591,74158,California
Alameda,2021-01-21,8132,97413,3766,58280,4366,39133,0,0,7271,65490,852,15944,7276,81434,California
Alameda,2021-01-22,6833,104246,2038,60318,4795,43928,0,0,5688,70044,1135,17079,5689,87123,California
Alameda,2021-01-23,3266,107512,943,61261,2323,46251,0,0,2719,72218,545,17624,2719,89842,California
Alameda,2021-01-24,2015,109527,655,61916,1360,47611,0,0,1746,73698,266,17890,1746,91588,California
Alameda,2021-01-25,5159,114686,1984,63900,3175,50786,0,0,3596,75741,1555,19445,3598,95186,California
Alameda,2021-01-26,7316,122002,2307,66207,5009,55795,0,0,5432,79299,1875,21320,5433,100619,California
Alameda,2021-01-27,6683,128685,2054,68261,4629,60424,0,0,4831,82286,1844,23164,4831,105450,California
Alameda,2021-01-28,7833,136518,2549,70810,5284,65708,0,0,5609,85689,2208,25372,5611,111061,California
Alameda,2021-01-29,7975,144493,3191,74001,4784,70492,0,0,6130,89987,1833,27205,6131,117192,California
Alameda,2021-01-30,3420,147913,1677,75678,1743,72235,0,0,2709,91992,705,27910,2710,119902,California
Alameda,2021-01-31,1920,149833,947,76625,973,73208,0,0,1680,93436,236,28146,1680,121582,California
Alameda,2021-02-01,6461,156294,3861,80486,2600,75808,0,0,4317,95619,2135,30281,4318,125900,California
Alameda,2021-02-02,7035,163329,3798,84284,3237,79045,0,0,4681,97957,2343,32624,4681,130581,California
Alameda,2021-02-03,7061,170390,3737,88021,3324,82369,0,0,4324,99557,2729,35353,4329,134910,California
Alameda,2021-02-04,9439,179829,4105,92126,5334,87703,0,0,6298,102733,3128,38481,6304,141214,California
Alameda,2021-02-05,10253,190082,5347,97473,4906,92609,0,0,6350,105194,3895,42376,6356,147570,California
Alameda,2021-02-06,6945,197027,4404,101877,2541,95150,0,0,5797,109847,1145,43521,5798,153368,California
Alameda,2021-02-07,3572,200599,2880,104757,692,95842,0,0,2625,111530,943,44464,2626,155994,California
Alameda,2021-02-08,8086,208685,5771,110528,2315,98157,0,0,5506,114471,2567,47031,5508,161502,California
Alameda,2021-02-09,9685,218370,5791,116319,3894,102051,0,0,6023,116846,3650,50681,6025,167527,California
Alameda,2021-02-10,11509,229879,6788,123107,4721,106772,0,0,6444,118249,5048,55729,6451,173978,California
Alameda,2021-02-11,13994,243873,8068,131175,5926,112698,0,0,8091,120459,5884,61613,8094,182072,California
Alameda,2021-02-12,12525,256398,5700,136875,6825,119523,0,0,7759,123475,4746,66359,7762,189834,California
Alameda,2021-02-13,7822,264220,4077,140952,3745,123268,0,0,5854,127371,1960,68319,5856,195690,California
Alameda,2021-02-14,4044,268264,2544,143496,1500,124768,0,0,2862,129060,1176,69495,2865,198555,California
Alameda,2021-02-15,5686,273950,3213,146709,2473,127241,0,0,3684,130751,1997,71492,3688,202243,California
Alameda,2021-02-16,12565,286515,7021,153730,5544,132785,0,0,9313,136834,3239,74731,9322,211565,California
Alameda,2021-02-17,14184,300699,8432,162162,5752,138537,0,0,10496,143666,3666,78397,10498,222063,California
Alameda,2021-02-18,15960,316659,10141,172303,5819,144356,0,0,11583,150896,4359,82756,11589,233652,California
Alameda,2021-02-19,17977,334636,11684,183987,6293,150649,0,0,11833,156615,6120,88876,11839,245491,California
Alameda,2021-02-20,12154,346790,9833,193820,2321,152970,0,0,9310,163093,2837,91713,9315,254806,California
Alameda,2021-02-21,7966,354756,6990,200810,976,153946,0,0,5361,165862,2593,94306,5362,260168,California
Alameda,2021-02-22,11365,366121,8406,209216,2959,156905,0,0,7144,168814,4202,98508,7154,267322,California
Alameda,2021-02-23,13538,379659,8218,217434,5320,162225,0,0,8374,172046,5148,103656,8380,275702,California
Alameda,2021-02-24,15432,395091,8632,226066,6800,169025,0,0,9974,176640,5385,109041,9979,285681,California
Alameda,2021-02-25,16465,411556,9531,235597,6934,175959,0,0,10404,181038,6016,115057,10414,296095,California
Alameda,2021-02-26,19247,430803,11194,246791,8053,184012,0,0,12187,186227,7004,122061,12193,308288,California
Alameda,2021-02-27,15716,446519,11581,258372,4133,188145,2,2,9711,189986,5958,128019,9717,318005,California
Alameda,2021-02-28,10434,456953,8706,267078,1726,189871,2,4,6695,192973,3711,131730,6698,324703,California
Alameda,2021-03-01,14486,471439,10008,277086,4464,194335,14,18,8815,196194,5615,137345,8836,333539,California
Alameda,2021-03-02,15316,486755,10999,288085,4315,198650,2,20,10020,200958,5266,142611,10030,343569,California
Alameda,2021-03-03,16072,502827,10494,298579,5574,204224,4,24,10957,206842,5082,147693,10966,354535,California
Alameda,2021-03-04,17663,520490,11309,309888,6352,210576,2,26,11093,211409,6528,154221,11095,365630,California
Alameda,2021-03-05,16394,536884,10732,320620,5650,216226,12,38,11029,217140,5317,159538,11048,376678,California
Alameda,2021-03-06,14683,551567,10367,330987,4055,220281,261,299,9675,222120,4955,164493,9935,386613,California
Alameda,2021-03-07,9921,561488,8518,339505,1184,221465,219,518,6995,226442,2894,167387,7216,393829,California
Alameda,2021-03-08,11969,573457,7461,346966,4111,225576,397,915,8913,232740,3007,170394,9305,403134,California
Alameda,2021-03-09,14692,588149,10311,357277,3938,229514,443,1358,7973,234472,6681,177075,8413,411547,California
Alameda,2021-03-10,17496,605645,12088,369365,4850,234364,558,1916,7854,233268,9602,186677,8398,419945,California
Alameda,2021-03-11,19724,625369,11559,380924,6453,240817,1712,3628,6691,228612,13000,199677,8344,428289,California
Alameda,2021-03-12,21364,646733,12505,393429,7153,247970,1706,5334,7332,223616,13994,213671,8998,437287,California
Alameda,2021-03-13,16130,662863,10348,403777,4772,252742,1010,6344,5107,218728,10986,224657,6098,443385,California
Alameda,2021-03-14,10870,673733,8029,411806,2063,254805,778,7122,3261,215166,7585,232242,4023,447408,California
Alameda,2021-03-15,14478,688211,9465,421271,4487,259292,526,7648,6104,213450,8334,240576,6618,454026,California
Alameda,2021-03-16,17242,705453,11210,432481,5494,264786,538,8186,7187,211179,9994,250570,7723,461749,California
Alameda,2021-03-17,17680,723133,10036,442517,6914,271700,730,8916,8118,210504,9514,260084,8839,470588,California
Alameda,2021-03-18,19380,742513,10609,453126,7876,279576,895,9811,8649,209342,10697,270781,9535,480123,California
Alameda,2021-03-19,19600,762113,10780,463906,7041,286617,1779,11590,7619,206793,11918,282699,9369,489492,California
Alameda,2021-03-20,15809,777922,10379,474285,4573,291190,857,12447,6187,204238,9584,292283,7029,496521,California
Alameda,2021-03-21,9241,787163,7266,481551,1416,292606,559,13006,3312,202192,5914,298197,3868,500389,California
Alameda,2021-03-22,15191,802354,10234,491785,3949,296555,1008,14014,6814,201663,8339,306536,7810,508199,California
Alameda,2021-03-23,19478,821832,11824,503609,6841,303396,813,14827,9790,202631,9630,316166,10598,518797,California
Alameda,2021-03-24,19496,841328,11734,515343,6735,310131,1027,15854,8385,200990,11039,327205,9398,528195,California
Alameda,2021-03-25,20726,862054,11460,526803,7842,317973,1424,17278,9369,200484,11277,338482,10771,538966,California
Alameda,2021-03-26,21114,883168,12690,539493,6852,324825,1572,18850,8431,197837,12625,351107,9978,548944,California
Alameda,2021-03-27,18433,901601,12567,552060,4916,329741,950,19800,7439,195279,10932,362039,8374,557318,California
Alameda,2021-03-28,10687,912288,8720,560780,1763,331504,204,20004,3429,191676,7237,369276,3634,560952,California
Alameda,2021-03-29,14855,927143,9461,570241,4401,335905,993,20997,5883,189617,8924,378200,6865,567817,California
Alameda,2021-03-30,18763,945906,9845,580086,7183,343088,1735,22732,9353,191318,9368,387568,11069,578886,California
Alameda,2021-03-31,19496,965402,10208,590294,7170,350258,2118,24850,9027,192015,10426,397994,11123,590009,California
Alameda,2021-04-01,23401,988803,9952,600246,7734,357992,5715,30565,11030,196353,12301,410295,16639,606648,California
Alameda,2021-04-02,24241,1013044,9858,610104,8470,366462,5913,36478,11744,201457,12450,422745,17554,624202,California
Alameda,2021-04-03,20356,1033400,9809,619913,5672,372134,4875,41353,10253,206448,10072,432817,15063,639265,California
Alameda,2021-04-04,9955,1043355,3997,623910,2252,374386,3706,45059,3468,207115,6465,439282,7132,646397,California
Alameda,2021-04-05,17904,1061259,7529,631439,5558,379944,4817,49876,7332,208689,10538,449820,12112,658509,California
Alameda,2021-04-06,22268,1083527,10686,642125,5701,385645,5881,55757,10140,212561,12082,461902,15954,674463,California
Alameda,2021-04-07,22688,1106215,11633,653758,5565,391210,5490,61247,11462,218280,11179,473081,16898,691361,California
Alameda,2021-04-08,25652,1131867,11550,665308,6068,397278,8034,69281,11009,222699,14558,487639,18977,710338,California
Alameda,2021-04-09,23518,1155385,10717,676025,7540,404818,5261,74542,12120,228694,11354,498993,17349,727687,California
Alameda,2021-04-10,19384,1174769,7510,683535,5677,410495,6197,80739,8288,232071,11062,510055,14439,742126,California
Alameda,2021-04-11,11051,1185820,4856,688391,2234,412729,3961,84700,4527,234017,6501,516556,8447,750573,California
Alameda,2021-04-12,18247,1204067,11870,700261,4399,417128,1978,86678,10325,238434,7877,524433,12294,762867,California
Alameda,2021-04-13,23277,1227344,14821,715082,8395,425523,61,86739,17141,249562,6080,530513,17208,780075,California
Alameda,2021-04-14,23375,1250719,15371,730453,8001,433524,3,86742,15694,257630,7634,538147,15702,795777,California
Alameda,2021-04-15,24282,1275001,15470,745923,8806,442330,6,86748,16000,265435,8209,546356,16014,811791,California
Alameda,2021-04-16,24737,1299738,14550,760473,10180,452510,7,86755,15832,272455,8834,555190,15854,827645,California
Alameda,2021-04-17,21150,1320888,14598,775071,6550,459060,2,86757,14609,280582,6499,561689,14626,842271,California
Alameda,2021-04-18,10406,1331294,8061,783132,2345,461405,0,86757,7197,284619,3169,564858,7206,849477,California
Alameda,2021-04-19,15881,1347175,9883,793015,5997,467402,1,86758,9173,287140,6663,571521,9184,858661,California
Alameda,2021-04-20,18856,1366031,11686,804701,7168,474570,2,86760,10265,288897,8530,580051,10287,868948,California
Alameda,2021-04-21,20332,1386363,12192,816893,8126,482696,14,86774,11756,292188,8498,588549,11789,880737,California
Alameda,2021-04-22,22157,1408520,14329,831222,7822,490518,6,86780,11779,293692,10310,598859,11814,892551,California
Alameda,2021-04-23,22528,1431048,14688,845910,7836,498354,4,86784,12594,296457,9862,608721,12627,905178,California
Alameda,2021-04-24,19143,1450191,14540,860450,4594,502948,9,86793,10148,297689,8943,617664,10175,915353,California
Alameda,2021-04-25,9057,1459248,7064,867514,1992,504940,1,86794,5955,300583,3074,620738,5968,921321,California
Alameda,2021-04-26,14917,1474165,10356,877870,4533,509473,28,86822,9177,304101,5698,626436,9216,930537,California
Alameda,2021-04-27,16709,1490874,9933,887803,6406,515879,370,87192,7879,303601,8772,635208,8272,938809,California
Alameda,2021-04-28,17110,1507984,10928,898731,5715,521594,467,87659,6899,300822,10163,645371,7384,946193,California
Alameda,2021-04-29,17809,1525793,10752,909483,6722,528316,335,87994,6660,296755,11085,656456,7018,953211,California
Alameda,2021-04-30,20651,1546444,12911,922394,7397,535713,343,88337,8533,293666,12013,668469,8924,962135,California
Alameda,2021-05-01,14208,1560652,9485,931879,4512,540225,211,88548,5347,290434,8816,677285,5584,967719,California
Alameda,2021-05-02,7121,1567773,4977,936856,1971,542196,173,88721,2891,289292,4210,681495,3068,970787,California
Alameda,2021-05-03,14805,1582578,11148,948004,3334,545530,323,89044,2876,280663,11860,693355,3231,974018,California
Alameda,2021-05-04,19048,1601626,13777,961781,4906,550436,365,89409,3831,269765,15131,708486,4233,978251,California
Alameda,2021-05-05,18967,1620593,13862,975643,4590,555026,515,89924,3869,259142,15029,723515,4406,982657,California
Alameda,2021-05-06,19532,1640125,14853,990496,3981,559007,698,90622,3811,248038,15630,739145,4526,987183,California
Alameda,2021-05-07,19538,1659663,13173,1003669,5946,564953,419,91041,4492,238000,14966,754111,4928,992111,California
Alameda,2021-05-08,17188,1676851,11893,1015562,5082,570035,213,91254,3294,227677,13845,767956,3522,995633,California
Alameda,2021-05-09,8597,1685448,7039,1022601,1414,571449,144,91398,1331,221913,7243,775199,1479,997112,California
Alameda,2021-05-10,10468,1695916,7236,1029837,2902,574351,330,91728,2507,216840,7920,783119,2847,999959,California
Alameda,2021-05-11,15791,1711707,8692,1038529,6780,581131,319,92047,2827,207115,12906,796025,3181,1003140,California
Alameda,2021-05-12,13570,1725277,9056,1047585,4062,585193,452,92499,2726,199535,10794,806819,3214,1006354,California
Alameda,2021-05-13,18081,1743358,13011,1060596,4525,589718,545,93044,5708,193514,12314,819133,6293,1012647,California
Alameda,2021-05-14,20896,1764254,14212,1074808,6220,595938,464,93508,7069,187318,13744,832877,7548,1020195,California
Alameda,2021-05-15,17450,1781704,12724,1087532,4492,600430,234,93742,5969,182098,11427,844304,6207,1026402,California
Alameda,2021-05-16,8946,1790650,7692,1095224,1149,601579,105,93847,3151,179600,5758,850062,3260,1029662,California
Alameda,2021-05-17,13579,1804229,10147,1105371,2902,604481,530,94377,4185,174976,9351,859413,4727,1034389,California
Alameda,2021-05-18,14270,1818499,10387,1115758,3455,607936,428,94805,4975,171131,9250,868663,5405,1039794,California
Alameda,2021-05-19,14515,1833014,9953,1125711,4222,612158,340,95145,5871,168756,8588,877251,6213,1046007,California
Alameda,2021-05-20,13458,1846472,8878,1134589,4042,616200,538,95683,5747,167386,7656,884907,6286,1052293,California
Alameda,2021-05-21,15301,1861773,10051,1144640,4981,621181,269,95952,5059,162552,10169,895076,5335,1057628,California
Alameda,2021-05-22,10386,1872159,7521,1152161,2696,623877,169,96121,4175,160724,6176,901252,4348,1061976,California
Alameda,2021-05-23,5155,1877314,3967,1156128,1097,624974,91,96212,1674,159032,3459,904711,1767,1063743,California
Alameda,2021-05-24,7272,1884586,4234,1160362,2779,627753,259,96471,2814,157693,4416,909127,3077,1066820,California
Alameda,2021-05-25,8031,1892617,5191,1165553,2576,630329,264,96735,3516,156994,4477,913604,3778,1070598,California
Alameda,2021-05-26,8278,1900895,5180,1170733,2797,633126,301,97036,3572,156188,4674,918278,3868,1074466,California
Alameda,2021-05-27,8186,1909081,4884,1175617,2900,636026,402,97438,3345,155137,4793,923071,3742,1078208,California
Alameda,2021-05-28,8622,1917703,5044,1180661,3350,639376,228,97666,3598,153975,4991,928062,3829,1082037,California
Alameda,2021-05-29,4941,1922644,2983,1183644,1772,641148,186,97852,2437,154121,2478,930540,2624,1084661,California
Alameda,2021-05-30,2466,1925110,1618,1185262,759,641907,89,97941,973,153702,1481,932021,1062,1085723,California
Alameda,2021-05-31,1166,1926276,866,1186128,246,642153,54,97995,348,153303,801,932822,402,1086125,California
Alameda,2021-06-01,7187,1933463,4987,1191115,1889,644042,311,98306,2957,152367,4201,937023,3265,1089390,California
Alameda,2021-06-02,5831,1939294,3630,1194745,1975,646017,226,98532,2188,151165,3608,940631,2406,1091796,California
Alameda,2021-06-03,8500,1947794,6392,1201137,1806,647823,302,98834,2770,148542,5690,946321,3067,1094863,California
Alameda,2021-06-04,10441,1958235,7682,1208819,2517,650340,242,99076,2820,144022,7581,953902,3061,1097924,California
Alameda,2021-06-05,8096,1966331,5880,1214699,2053,652393,163,99239,1779,139680,6281,960183,1939,1099863,California
Alameda,2021-06-06,3695,1970026,3334,1218033,280,652673,81,99320,850,137780,2833,963016,933,1100796,California
Alameda,2021-06-07,5854,1975880,4261,1222294,1413,654086,180,99500,1721,135573,4109,967125,1902,1102698,California
Alameda,2021-06-08,7261,1983141,5807,1228101,1209,655295,245,99745,2099,132777,5137,972262,2341,1105039,California
Alameda,2021-06-09,7314,1990455,5970,1234071,1140,656435,204,99949,1679,129044,5610,977872,1877,1106916,California
Alameda,2021-06-10,7996,1998451,6692,1240763,1001,657436,303,100252,2117,125608,5854,983726,2418,1109334,California
Alameda,2021-06-11,8069,2006520,6175,1246938,1668,659104,226,100478,2465,122726,5575,989301,2693,1112027,California
Alameda,2021-06-12,5512,2012032,4223,1251161,1103,660207,186,100664,1368,120165,4120,993421,1559,1113586,California
Alameda,2021-06-13,2316,2014348,1766,1252927,428,660635,122,100786,665,119311,1639,995060,785,1114371,California
Alameda,2021-06-14,4600,2018948,3458,1256385,930,661565,212,100998,1555,118052,3023,998083,1764,1116135,California
Alameda,2021-06-15,6032,2024980,4383,1260768,1367,662932,282,101280,1797,115936,4194,1002277,2078,1118213,California
Alameda,2021-06-16,5206,2030186,4158,1264926,844,663776,204,101484,1543,114036,3644,1005921,1744,1119957,California
Alameda,2021-06-17,5659,2035845,4564,1269490,857,664633,238,101722,1874,112399,3751,1009672,2114,1122071,California
Alameda,2021-06-18,5978,2041823,4506,1273996,1217,665850,255,101977,2005,110711,3944,1013616,2256,1124327,California
Alameda,2021-06-19,3463,2045286,2620,1276616,685,666535,158,102135,1064,109546,2386,1016002,1221,1125548,California
Alameda,2021-06-20,1403,2046689,1171,1277787,186,666721,46,102181,522,109238,874,1016876,566,1126114,California
Alameda,2021-06-21,2732,2049421,1853,1279640,716,667437,163,102344,1397,109483,1315,1018191,1560,1127674,California
Alameda,2021-06-22,4606,2054027,3565,1283205,842,668279,199,102543,1420,107933,3167,1021358,1617,1129291,California
Alameda,2021-06-23,3511,2057538,2700,1285905,627,668906,184,102727,1189,106994,2307,1023665,1368,1130659,California
Alameda,2021-06-24,4407,2061945,3515,1289420,656,669562,236,102963,1511,105866,2873,1026538,1745,1132404,California
Alameda,2021-06-25,4643,2066588,3475,1292895,960,670522,208,103171,1718,104885,2906,1029444,1925,1134329,California
Alameda,2021-06-26,3083,2069671,2266,1295161,649,671171,168,103339,1069,104128,1994,1031438,1237,1135566,California
Alameda,2021-06-27,1296,2070967,1064,1296225,186,671357,46,103385,509,103903,780,1032218,555,1136121,California
Alameda,2021-06-28,2904,2073871,2359,1298584,350,671707,195,103580,1133,103481,1749,1033967,1327,1137448,California
Alameda,2021-06-29,3702,2077573,2961,1301545,602,672309,139,103719,1300,102533,2385,1036352,1437,1138885,California
Alameda,2021-06-30,2890,2080463,2240,1303785,519,672828,131,103850,1072,101929,1805,1038157,1201,1140086,California
Alameda,2021-07-01,3475,2083938,2727,1306512,597,673425,151,104001,1240,101105,2212,1040369,1388,1141474,California
Alameda,2021-07-02,3999,2087937,2998,1309510,830,674255,171,104172,1463,100222,2509,1042878,1626,1143100,California
Alameda,2021-07-03,2053,2089990,1499,1311009,464,674719,90,104262,808,99888,1231,1044109,897,1143997,California
Alameda,2021-07-04,97,2090087,62,1311071,30,674749,5,104267,42,99882,53,1044162,47,1144044,California
Alameda,2021-07-05,1620,2091707,1347,1312418,215,674964,58,104325,719,99767,890,1045052,775,1144819,California
Alameda,2021-07-06,3615,2095322,2909,1315327,600,675564,106,104431,1220,98721,2372,1047424,1326,1146145,California
Alameda,2021-07-07,2775,2098097,2019,1317346,578,676142,178,104609,983,98114,1765,1049189,1158,1147303,California
Alameda,2021-07-08,2821,2100918,2234,1319580,439,676581,148,104757,1033,97531,1760,1050949,1177,1148480,California
Alameda,2021-07-09,3559,2104477,2774,1322354,634,677215,151,104908,1397,96945,2133,1053082,1547,1150027,California
Alameda,2021-07-10,2184,2106661,1597,1323951,467,677682,120,105028,849,96603,1312,1054394,970,1150997,California
Alameda,2021-07-11,1018,2107679,804,1324755,151,677833,63,105091,394,96441,618,1055012,456,1151453,California
Alameda,2021-07-12,2585,2110264,1990,1326745,462,678295,133,105224,1018,96038,1551,1056563,1148,1152601,California
Alameda,2021-07-13,2718,2112982,2117,1328862,457,678752,144,105368,1133,95753,1561,1058124,1276,1153877,California
Alameda,2021-07-14,2180,2115162,1636,1330498,419,679171,125,105493,965,95637,1201,1059325,1085,1154962,California
Alameda,2021-07-15,2494,2117656,2001,1332499,406,679577,87,105580,1106,95463,1366,1060691,1192,1156154,California
Alameda,2021-07-16,3244,2120900,2578,1335077,557,680134,109,105689,1426,95204,1792,1062483,1533,1157687,California
Alameda,2021-07-17,2079,2122979,1620,1336697,390,680524,69,105758,931,95074,1130,1063613,1000,1158687,California
Alameda,2021-07-18,1037,2124016,817,1337514,122,680646,98,105856,467,95079,560,1064173,565,1159252,California
Alameda,2021-07-19,2519,2126535,1999,1339513,419,681065,101,105957,1245,95177,1247,1065420,1345,1160597,California
Alameda,2021-07-20,2569,2129104,2043,1341556,415,681480,111,106068,1275,95299,1259,1066679,1381,1161978,California
Alameda,2021-07-21,2401,2131505,1887,1343443,408,681888,106,106174,1187,95404,1184,1067863,1289,1163267,California
Alameda,2021-07-22,2501,2134006,1957,1345400,415,682303,129,106303,1278,95609,1201,1069064,1406,1164673,California
Alameda,2021-07-23,3318,2137324,2613,1348013,561,682864,144,106447,1602,95671,1679,1070743,1741,1166414,California
Alameda,2021-07-24,2192,2139516,1673,1349686,433,683297,86,106533,1141,95876,1022,1071765,1227,1167641,California
Alameda,2021-07-25,711,2140227,596,1350282,108,683405,7,106540,510,96201,192,1071957,517,1168158,California
Alameda,2021-07-26,2425,2142652,1829,1352111,463,683868,133,106673,1420,96769,984,1072941,1552,1169710,California
Alameda,2021-07-27,2822,2145474,2245,1354356,443,684311,134,106807,1578,97273,1206,1074147,1710,1171420,California
Alameda,2021-07-28,2272,2147746,1727,1356083,428,684739,117,106924,1282,97715,955,1075102,1397,1172817,California
Alameda,2021-07-29,2708,2150454,2179,1358262,393,685132,136,107060,1517,98208,1159,1076261,1652,1174469,California
Alameda,2021-07-30,3340,2153794,2681,1360943,505,685637,154,107214,1809,98684,1483,1077744,1959,1176428,California
Alameda,2021-07-31,1546,2155340,1216,1362159,249,685886,81,107295,888,99016,636,1078380,968,1177396,California
Alpine,2020-12-18,2,2,2,2,0,0,0,0,2,2,0,0,2,2,California
Alpine,2020-12-19,2,4,2,4,0,0,0,0,2,4,0,0,2,4,California
Alpine,2020-12-21,1,5,1,5,0,0,0,0,1,5,0,0,1,5,California
Alpine,2020-12-29,1,6,0,5,1,1,0,0,1,6,0,0,1,6,California
Alpine,2020-12-30,14,20,0,5,14,15,0,0,14,20,0,0,14,20,California
Alpine,2020-12-31,1,21,0,5,1,16,0,0,1,21,0,0,1,21,California
Alpine,2021-01-01,1,22,0,5,1,17,0,0,1,22,0,0,1,22,California
Alpine,2021-01-02,1,23,1,6,0,17,0,0,1,23,0,0,1,23,California
Alpine,2021-01-04,10,33,0,6,10,27,0,0,10,33,0,0,10,33,California
Alpine,2021-01-05,8,41,0,6,8,35,0,0,8,41,0,0,8,41,California
Alpine,2021-01-06,31,72,0,6,31,66,0,0,31,72,0,0,31,72,California
Alpine,2021-01-07,8,80,0,6,8,74,0,0,8,80,0,0,8,80,California
Alpine,2021-01-08,4,84,2,8,2,76,0,0,2,80,2,2,2,82,California
Alpine,2021-01-09,2,86,2,10,0,76,0,0,0,78,2,4,0,82,California
Alpine,2021-01-11,32,118,1,11,31,107,0,0,31,108,1,5,31,113,California
Alpine,2021-01-13,35,153,0,11,35,142,0,0,35,143,0,5,35,148,California
Alpine,2021-01-14,1,154,0,11,1,143,0,0,1,144,0,5,1,149,California
Alpine,2021-01-15,1,155,0,11,1,144,0,0,1,145,0,5,1,150,California
Alpine,2021-01-18,1,156,1,12,0,144,0,0,1,146,0,5,1,151,California
Alpine,2021-01-20,21,177,0,12,21,165,0,0,21,167,0,5,21,172,California
Alpine,2021-01-21,1,178,0,12,1,166,0,0,1,168,0,5,1,173,California
Alpine,2021-01-22,33,211,0,12,33,199,0,0,33,201,0,5,33,206,California
Alpine,2021-01-23,1,212,1,13,0,199,0,0,0,200,1,6,0,206,California
Alpine,2021-01-25,17,229,0,13,17,216,0,0,17,217,0,6,17,223,California
Alpine,2021-01-26,1,230,0,13,1,217,0,0,0,216,1,7,0,223,California
Alpine,2021-01-28,1,231,0,13,1,218,0,0,0,215,1,8,0,223,California
Alpine,2021-01-29,1,232,0,13,1,219,0,0,1,216,0,8,1,224,California
Alpine,2021-02-01,25,257,0,13,25,244,0,0,7,205,18,26,7,231,California
Alpine,2021-02-03,34,291,0,13,34,278,0,0,10,191,24,50,10,241,California
Alpine,2021-02-04,9,300,1,14,8,286,0,0,4,190,5,55,4,245,California
Alpine,2021-02-05,31,331,1,15,30,316,0,0,11,181,20,75,11,256,California
Alpine,2021-02-08,32,363,0,15,32,348,0,0,4,157,28,103,4,260,California
Alpine,2021-02-10,34,397,0,15,34,382,0,0,0,123,34,137,0,260,California
Alpine,2021-02-11,6,403,0,15,6,388,0,0,3,123,3,140,3,263,California
Alpine,2021-02-12,1,404,0,15,1,389,0,0,0,122,1,141,0,263,California
Alpine,2021-02-17,23,427,0,15,23,412,0,0,3,105,20,161,3,266,California
Alpine,2021-02-18,2,429,0,15,2,414,0,0,1,105,1,162,1,267,California
Alpine,2021-02-19,34,463,1,16,33,447,0,0,2,75,32,194,2,269,California
Alpine,2021-02-22,28,491,0,16,28,475,0,0,8,63,20,214,8,277,California
Alpine,2021-02-25,5,496,0,16,5,480,0,0,5,68,0,214,5,282,California
Alpine,2021-02-26,30,526,1,17,29,509,0,0,29,96,1,215,29,311,California
Alpine,2021-02-27,2,528,1,18,1,510,0,0,1,96,1,216,1,312,California
Alpine,2021-03-01,36,564,0,18,36,546,0,0,26,112,10,226,26,338,California
Alpine,2021-03-03,28,592,0,18,28,574,0,0,17,118,11,237,17,355,California
Alpine,2021-03-04,10,602,0,18,10,584,0,0,10,128,0,237,10,365,California
Alpine,2021-03-05,29,631,0,18,29,613,0,0,22,143,7,244,22,387,California
Alpine,2021-03-08,31,662,0,18,31,644,0,0,29,170,2,246,29,416,California
Alpine,2021-03-10,73,735,0,18,73,717,0,0,73,243,0,246,73,489,California
Alpine,2021-03-11,35,770,0,18,35,752,0,0,31,270,4,250,31,520,California
Alpine,2021-03-12,19,789,0,18,19,771,0,0,17,285,2,252,17,537,California
Alpine,2021-03-15,20,809,0,18,20,791,0,0,19,303,1,253,19,556,California
Alpine,2021-03-17,23,832,0,18,22,813,1,1,19,319,4,257,20,576,California
Alpine,2021-03-18,35,867,0,18,35,848,0,1,34,352,1,258,34,610,California
Alpine,2021-03-19,2,869,1,19,1,849,0,1,1,352,1,259,1,611,California
Alpine,2021-03-22,24,893,0,19,24,873,0,1,15,358,9,268,15,626,California
Alpine,2021-03-24,19,912,0,19,19,892,0,1,8,355,11,279,8,634,California
Alpine,2021-03-25,34,946,0,19,33,925,1,2,27,377,6,285,28,662,California
Alpine,2021-03-27,1,947,0,19,1,926,0,2,0,376,1,286,0,662,California
Alpine,2021-03-28,1,948,1,20,0,926,0,2,1,377,0,286,1,663,California
Alpine,2021-03-29,19,967,0,20,18,944,1,3,2,363,17,303,3,666,California
Alpine,2021-04-01,18,985,0,20,18,962,0,3,8,361,10,313,8,674,California
Alpine,2021-04-02,99,1084,0,20,99,1061,0,3,45,353,53,366,45,719,California
Alpine,2021-04-05,3,1087,0,20,3,1064,0,3,0,350,3,369,0,719,California
Alpine,2021-04-06,2,1089,1,21,1,1065,0,3,1,350,1,370,1,720,California
Alpine,2021-04-07,117,1206,0,21,116,1181,1,4,30,295,86,456,31,751,California
Alpine,2021-04-08,35,1241,0,21,35,1216,0,4,10,280,25,481,10,761,California
Alpine,2021-04-09,2,1243,0,21,2,1218,0,4,2,282,0,481,2,763,California
Alpine,2021-04-14,47,1290,0,21,47,1265,0,4,10,255,37,518,10,773,California
Alpine,2021-04-15,35,1325,0,21,35,1300,0,4,3,226,32,550,3,776,California
Alpine,2021-04-19,1,1326,0,21,1,1301,0,4,1,227,0,550,1,777,California
Alpine,2021-04-21,31,1357,0,21,31,1332,0,4,15,226,16,566,15,792,California
Alpine,2021-04-22,24,1381,0,21,24,1356,0,4,1,204,23,589,1,793,California
Alpine,2021-04-25,1,1382,1,22,0,1356,0,4,0,203,1,590,0,793,California
Alpine,2021-04-27,1,1383,0,22,1,1357,0,4,1,204,0,590,1,794,California
Alpine,2021-04-28,36,1419,0,22,36,1393,0,4,6,180,30,620,6,800,California
Alpine,2021-04-29,6,1425,0,22,6,1399,0,4,0,174,6,626,0,800,California
Alpine,2021-04-30,2,1427,1,23,0,1399,1,5,1,175,1,627,2,802,California
Alpine,2021-05-02,1,1428,0,23,0,1399,1,6,0,175,1,628,1,803,California
Alpine,2021-05-05,17,1445,0,23,17,1416,0,6,4,166,13,641,4,807,California
Alpine,2021-05-06,8,1453,0,23,8,1424,0,6,0,158,8,649,0,807,California
Alpine,2021-05-07,1,1454,0,23,1,1425,0,6,0,157,1,650,0,807,California
Alpine,2021-05-10,1,1455,0,23,1,1426,0,6,1,158,0,650,1,808,California
Alpine,2021-05-12,1,1456,0,23,0,1426,1,7,0,158,1,651,1,809,California
Alpine,2021-05-13,3,1459,0,23,3,1429,0,7,0,155,3,654,0,809,California
Alpine,2021-05-17,2,1461,0,23,2,1431,0,7,1,155,1,655,1,810,California
Alpine,2021-05-18,1,1462,0,23,1,1432,0,7,1,156,0,655,1,811,California
Alpine,2021-05-19,15,1477,0,23,15,1447,0,7,0,141,15,670,0,811,California
Alpine,2021-05-21,1,1478,1,24,0,1447,0,7,0,140,1,671,0,811,California
Alpine,2021-05-25,1,1479,0,24,1,1448,0,7,0,139,1,672,0,811,California
Alpine,2021-05-27,3,1482,2,26,1,1449,0,7,3,142,0,672,3,814,California
Alpine,2021-05-28,2,1484,1,27,1,1450,0,7,2,144,0,672,2,816,California
Alpine,2021-05-29,1,1485,0,27,1,1451,0,7,1,145,0,672,1,817,California
Alpine,2021-06-02,8,1493,0,27,8,1459,0,7,1,139,7,679,1,818,California
Alpine,2021-06-04,1,1494,0,27,1,1460,0,7,1,140,0,679,1,819,California
Alpine,2021-06-07,1,1495,0,27,1,1461,0,7,0,139,1,680,0,819,California
Alpine,2021-06-10,1,1496,1,28,0,1461,0,7,1,140,0,680,1,820,California
Alpine,2021-06-15,2,1498,1,29,1,1462,0,7,0,138,2,682,0,820,California
Alpine,2021-06-18,1,1499,1,30,0,1462,0,7,0,137,1,683,0,820,California
Alpine,2021-06-19,1,1500,1,31,0,1462,0,7,0,136,1,684,0,820,California
Alpine,2021-06-25,1,1501,0,31,1,1463,0,7,0,135,1,685,0,820,California
Alpine,2021-06-29,1,1502,0,31,1,1464,0,7,1,136,0,685,1,821,California
Alpine,2021-06-30,1,1503,0,31,1,1465,0,7,0,135,1,686,0,821,California
Alpine,2021-07-01,1,1504,1,32,0,1465,0,7,0,134,1,687,0,821,California
Alpine,2021-07-06,1,1505,0,32,1,1466,0,7,1,135,0,687,1,822,California
Alpine,2021-07-07,2,1507,0,32,2,1468,0,7,2,137,0,687,2,824,California
Alpine,2021-07-24,1,1508,0,32,1,1469,0,7,1,138,0,687,1,825,California
Alpine,2021-07-30,1,1509,0,32,1,1470,0,7,0,138,1,688,1,826,California
Amador,2020-12-16,3,3,3,3,0,0,0,0,3,3,0,0,3,3,California
Amador,2020-12-17,5,8,5,8,0,0,0,0,5,8,0,0,5,8,California
Amador,2020-12-18,48,56,48,56,0,0,0,0,48,56,0,0,48,56,California
Amador,2020-12-19,16,72,16,72,0,0,0,0,16,72,0,0,16,72,California
Amador,2020-12-20,4,76,4,76,0,0,0,0,4,76,0,0,4,76,California
Amador,2020-12-21,30,106,30,106,0,0,0,0,30,106,0,0,30,106,California
Amador,2020-12-22,35,141,34,140,1,1,0,0,35,141,0,0,35,141,California
Amador,2020-12-23,41,182,39,179,2,3,0,0,41,182,0,0,41,182,California
Amador,2020-12-24,5,187,3,182,2,5,0,0,5,187,0,0,5,187,California
Amador,2020-12-26,5,192,4,186,1,6,0,0,5,192,0,0,5,192,California
Amador,2020-12-27,1,193,0,186,1,7,0,0,1,193,0,0,1,193,California
Amador,2020-12-28,31,224,27,213,4,11,0,0,31,224,0,0,31,224,California
Amador,2020-12-29,25,249,18,231,7,18,0,0,25,249,0,0,25,249,California
Amador,2020-12-30,123,372,77,308,46,64,0,0,123,372,0,0,123,372,California
Amador,2020-12-31,196,568,170,478,26,90,0,0,196,568,0,0,196,568,California
Amador,2021-01-01,2,570,0,478,2,92,0,0,2,570,0,0,2,570,California
Amador,2021-01-02,59,629,59,537,0,92,0,0,59,629,0,0,59,629,California
Amador,2021-01-03,67,696,18,555,49,141,0,0,67,696,0,0,67,696,California
Amador,2021-01-04,126,822,2,557,124,265,0,0,126,822,0,0,126,822,California
Amador,2021-01-05,33,855,3,560,30,295,0,0,32,853,1,1,32,854,California
Amador,2021-01-06,40,895,11,571,29,324,0,0,36,885,4,5,36,890,California
Amador,2021-01-07,234,1129,72,643,162,486,0,0,223,1097,11,16,223,1113,California
Amador,2021-01-08,88,1217,73,716,15,501,0,0,42,1094,46,62,43,1156,California
Amador,2021-01-09,12,1229,12,728,0,501,0,0,2,1087,10,72,3,1159,California
Amador,2021-01-10,6,1235,4,732,2,503,0,0,2,1085,4,76,2,1161,California
Amador,2021-01-11,125,1360,43,775,82,585,0,0,89,1139,36,112,90,1251,California
Amador,2021-01-12,72,1432,55,830,17,602,0,0,42,1151,30,142,42,1293,California
Amador,2021-01-13,42,1474,24,854,18,620,0,0,29,1168,12,154,29,1322,California
Amador,2021-01-14,150,1624,22,876,128,748,0,0,140,1299,10,164,141,1463,California
Amador,2021-01-15,63,1687,27,903,36,784,0,0,53,1342,10,174,53,1516,California
Amador,2021-01-16,18,1705,12,915,6,790,0,0,12,1349,6,180,13,1529,California
Amador,2021-01-17,27,1732,5,920,22,812,0,0,27,1376,0,180,27,1556,California
Amador,2021-01-18,30,1762,26,946,4,816,0,0,9,1364,21,201,9,1565,California
Amador,2021-01-19,127,1889,100,1046,27,843,0,0,81,1400,45,246,81,1646,California
Amador,2021-01-20,179,2068,29,1075,150,993,0,0,165,1552,13,259,165,1811,California
Amador,2021-01-21,265,2333,233,1308,32,1025,0,0,152,1592,113,372,153,1964,California
Amador,2021-01-22,140,2473,74,1382,66,1091,0,0,133,1718,7,379,133,2097,California
Amador,2021-01-23,62,2535,33,1415,29,1120,0,0,59,1774,3,382,59,2156,California
Amador,2021-01-24,30,2565,12,1427,18,1138,0,0,26,1796,4,386,26,2182,California
Amador,2021-01-25,60,2625,29,1456,31,1169,0,0,42,1820,18,404,42,2224,California
Amador,2021-01-26,246,2871,18,1474,228,1397,0,0,236,2046,10,414,236,2460,California
Amador,2021-01-27,312,3183,37,1511,275,1672,0,0,263,2264,46,460,264,2724,California
Amador,2021-01-28,378,3561,100,1611,278,1950,0,0,294,2475,84,544,295,3019,California
Amador,2021-01-29,107,3668,33,1644,74,2024,0,0,92,2552,15,559,92,3111,California
Amador,2021-01-30,198,3866,37,1681,161,2185,0,0,193,2740,5,564,193,3304,California
Amador,2021-01-31,34,3900,29,1710,5,2190,0,0,33,2772,1,565,33,3337,California
Amador,2021-02-01,65,3965,22,1732,43,2233,0,0,37,2781,28,593,37,3374,California
Amador,2021-02-02,218,4183,70,1802,148,2381,0,0,131,2827,85,678,131,3505,California
Amador,2021-02-03,141,4324,39,1841,102,2483,0,0,88,2863,52,730,88,3593,California
Amador,2021-02-04,254,4578,77,1918,177,2660,0,0,165,2943,88,818,168,3761,California
Amador,2021-02-05,341,4919,64,1982,277,2937,0,0,322,3247,18,836,322,4083,California
Amador,2021-02-06,127,5046,84,2066,43,2980,0,0,123,3366,4,840,123,4206,California
Amador,2021-02-07,38,5084,34,2100,4,2984,0,0,34,3397,4,844,35,4241,California
Amador,2021-02-08,92,5176,64,2164,28,3012,0,0,75,3455,17,861,75,4316,California
Amador,2021-02-09,176,5352,80,2244,96,3108,0,0,109,3497,67,928,109,4425,California
Amador,2021-02-10,985,6337,80,2324,905,4013,0,0,950,4413,34,962,950,5375,California
Amador,2021-02-11,314,6651,122,2446,192,4205,0,0,199,4501,113,1075,201,5576,California
Amador,2021-02-12,338,6989,121,2567,217,4422,0,0,262,4687,76,1151,262,5838,California
Amador,2021-02-13,178,7167,82,2649,96,4518,0,0,153,4815,25,1176,153,5991,California
Amador,2021-02-14,124,7291,54,2703,70,4588,0,0,106,4903,18,1194,106,6097,California
Amador,2021-02-15,189,7480,61,2764,128,4716,0,0,172,5059,16,1210,172,6269,California
Amador,2021-02-16,472,7952,56,2820,416,5132,0,0,430,5448,42,1252,431,6700,California
Amador,2021-02-17,270,8222,88,2908,182,5314,0,0,170,5518,100,1352,170,6870,California
Amador,2021-02-18,397,8619,99,3007,298,5612,0,0,332,5785,65,1417,332,7202,California
Amador,2021-02-19,199,8818,76,3083,123,5735,0,0,112,5810,87,1504,112,7314,California
Amador,2021-02-20,104,8922,34,3117,70,5805,0,0,66,5838,38,1542,66,7380,California
Amador,2021-02-21,55,8977,36,3153,19,5824,0,0,18,5821,35,1577,18,7398,California
Amador,2021-02-22,68,9045,26,3179,42,5866,0,0,33,5820,34,1611,33,7431,California
Amador,2021-02-23,327,9372,58,3237,269,6135,0,0,138,5770,189,1800,139,7570,California
Amador,2021-02-24,403,9775,63,3300,340,6475,0,0,264,5899,135,1935,264,7834,California
Amador,2021-02-25,543,10318,130,3430,413,6888,0,0,284,5926,257,2192,284,8118,California
Amador,2021-02-26,645,10963,82,3512,563,7451,0,0,517,6316,127,2319,517,8635,California
Amador,2021-02-27,317,11280,107,3619,210,7661,0,0,104,6210,212,2531,106,8741,California
Amador,2021-02-28,130,11410,59,3678,71,7732,0,0,64,6210,66,2597,66,8807,California
Amador,2021-03-01,206,11616,75,3753,131,7863,0,0,129,6263,77,2674,130,8937,California
Amador,2021-03-02,395,12011,74,3827,321,8184,0,0,335,6539,60,2734,336,9273,California
Amador,2021-03-03,255,12266,91,3918,164,8348,0,0,170,6626,84,2818,171,9444,California
Amador,2021-03-04,498,12764,116,4034,382,8730,0,0,394,6918,103,2921,395,9839,California
Amador,2021-03-05,527,13291,87,4121,440,9170,0,0,292,6980,233,3154,295,10134,California
Amador,2021-03-06,103,13394,50,4171,52,9222,1,1,57,6992,46,3200,58,10192,California
Amador,2021-03-07,94,13488,45,4216,49,9271,0,1,25,6948,69,3269,25,10217,California
Amador,2021-03-08,158,13646,75,4291,82,9353,1,2,92,6975,66,3335,93,10310,California
Amador,2021-03-09,382,14028,55,4346,327,9680,0,2,289,7175,90,3425,290,10600,California
Amador,2021-03-10,522,14550,79,4425,441,10121,2,4,111,6879,411,3836,115,10715,California
Amador,2021-03-11,485,15035,126,4551,348,10469,11,15,303,7016,180,4016,317,11032,California
Amador,2021-03-12,586,15621,70,4621,509,10978,7,22,343,7129,242,4258,355,11387,California
Amador,2021-03-13,122,15743,17,4638,98,11076,7,29,77,7174,44,4302,89,11476,California
Amador,2021-03-14,98,15841,17,4655,79,11155,2,31,20,7118,78,4380,22,11498,California
Amador,2021-03-15,180,16021,26,4681,147,11302,7,38,52,7050,128,4508,60,11558,California
Amador,2021-03-16,456,16477,55,4736,392,11694,9,47,140,6886,314,4822,150,11708,California
Amador,2021-03-17,387,16864,47,4783,337,12031,3,50,264,7032,121,4943,267,11975,California
Amador,2021-03-18,519,17383,105,4888,410,12441,4,54,256,7035,261,5204,264,12239,California
Amador,2021-03-19,552,17935,57,4945,478,12919,17,71,391,7288,159,5363,412,12651,California
Amador,2021-03-20,115,18050,47,4992,67,12986,1,72,49,7276,65,5428,53,12704,California
Amador,2021-03-21,52,18102,34,5026,17,13003,1,73,27,7282,24,5452,30,12734,California
Amador,2021-03-22,116,18218,35,5061,52,13055,29,102,49,7293,67,5519,78,12812,California
Amador,2021-03-23,441,18659,47,5108,387,13442,7,109,277,7415,163,5682,285,13097,California
Amador,2021-03-24,351,19010,41,5149,56,13498,254,363,39,7397,311,5993,293,13390,California
Amador,2021-03-25,617,19627,89,5238,521,14019,7,370,400,7588,216,6209,407,13797,California
Amador,2021-03-26,752,20379,45,5283,701,14720,6,376,282,7412,467,6676,291,14088,California
Amador,2021-03-27,91,20470,16,5299,73,14793,2,378,29,7383,62,6738,33,14121,California
Amador,2021-03-28,70,20540,16,5315,52,14845,2,380,10,7337,59,6797,13,14134,California
Amador,2021-03-29,184,20724,31,5346,152,14997,1,381,80,7323,101,6898,87,14221,California
Amador,2021-03-30,537,21261,27,5373,509,15506,1,382,288,7364,248,7146,289,14510,California
Amador,2021-03-31,202,21463,58,5431,139,15645,5,387,44,7257,156,7302,49,14559,California
Amador,2021-04-01,621,22084,91,5522,530,16175,0,387,266,7174,351,7653,268,14827,California
Amador,2021-04-02,617,22701,40,5562,564,16739,13,400,384,7341,232,7885,399,15226,California
Amador,2021-04-03,89,22790,27,5589,43,16782,19,419,23,7320,66,7951,45,15271,California
Amador,2021-04-04,39,22829,3,5592,30,16812,6,425,15,7317,24,7975,21,15292,California
Amador,2021-04-05,143,22972,50,5642,77,16889,16,441,47,7287,95,8070,65,15357,California
Amador,2021-04-06,504,23476,37,5679,449,17338,18,459,221,7245,281,8351,239,15596,California
Amador,2021-04-07,102,23578,35,5714,47,17385,20,479,44,7254,55,8406,64,15660,California
Amador,2021-04-08,499,24077,85,5799,392,17777,22,501,220,7220,277,8683,243,15903,California
Amador,2021-04-09,487,24564,23,5822,444,18221,20,521,213,7177,273,8956,230,16133,California
Amador,2021-04-10,51,24615,15,5837,27,18248,9,530,21,7177,30,8986,30,16163,California
Amador,2021-04-11,50,24665,24,5861,22,18270,4,534,22,7176,27,9013,26,16189,California
Amador,2021-04-12,99,24764,28,5889,62,18332,9,543,41,7168,58,9071,50,16239,California
Amador,2021-04-13,346,25110,48,5937,298,18630,0,543,65,6957,277,9348,66,16305,California
Amador,2021-04-14,283,25393,30,5967,253,18883,0,543,56,6790,224,9572,57,16362,California
Amador,2021-04-15,339,25732,78,6045,261,19144,0,543,70,6602,258,9830,70,16432,California
Amador,2021-04-16,493,26225,31,6076,462,19606,0,543,382,6875,110,9940,383,16815,California
Amador,2021-04-17,66,26291,35,6111,31,19637,0,543,30,6869,36,9976,30,16845,California
Amador,2021-04-18,35,26326,10,6121,25,19662,0,543,12,6858,23,9999,12,16857,California
Amador,2021-04-19,72,26398,30,6151,42,19704,0,543,29,6848,41,10040,31,16888,California
Amador,2021-04-20,441,26839,57,6208,384,20088,0,543,109,6634,325,10365,111,16999,California
Amador,2021-04-21,89,26928,34,6242,54,20142,1,544,43,6634,44,10409,44,17043,California
Amador,2021-04-22,518,27446,78,6320,439,20581,1,545,100,6335,400,10809,101,17144,California
Amador,2021-04-23,368,27814,47,6367,321,20902,0,545,289,6552,74,10883,291,17435,California
Amador,2021-04-24,52,27866,25,6392,27,20929,0,545,30,6561,21,10904,30,17465,California
Amador,2021-04-25,45,27911,19,6411,26,20955,0,545,29,6574,16,10920,29,17494,California
Amador,2021-04-26,98,28009,30,6441,67,21022,1,546,46,6572,51,10971,49,17543,California
Amador,2021-04-27,499,28508,41,6482,457,21479,1,547,88,6256,406,11377,90,17633,California
Amador,2021-04-28,70,28578,30,6512,37,21516,3,550,41,6271,29,11406,44,17677,California
Amador,2021-04-29,230,28808,74,6586,48,21564,108,658,69,6286,161,11567,176,17853,California
Amador,2021-04-30,343,29151,27,6613,312,21876,4,662,86,6120,257,11824,91,17944,California
Amador,2021-05-01,48,29199,16,6629,27,21903,5,667,27,6133,19,11843,32,17976,California
Amador,2021-05-02,28,29227,14,6643,11,21914,3,670,11,6131,17,11860,15,17991,California
Amador,2021-05-03,70,29297,36,6679,24,21938,10,680,29,6129,41,11901,39,18030,California
Amador,2021-05-04,465,29762,28,6707,430,22368,7,687,66,5803,399,12300,73,18103,California
Amador,2021-05-05,210,29972,156,6863,46,22414,8,695,162,5927,45,12345,169,18272,California
Amador,2021-05-06,109,30081,56,6919,48,22462,5,700,63,5951,44,12389,68,18340,California
Amador,2021-05-07,131,30212,30,6949,94,22556,7,707,69,5965,62,12451,76,18416,California
Amador,2021-05-08,43,30255,10,6959,30,22586,3,710,21,5967,22,12473,24,18440,California
Amador,2021-05-09,17,30272,1,6960,10,22596,6,716,4,5964,13,12486,10,18450,California
Amador,2021-05-10,58,30330,12,6972,43,22639,3,719,25,5959,33,12519,28,18478,California
Amador,2021-05-11,98,30428,31,7003,41,22680,26,745,44,5975,54,12573,70,18548,California
Amador,2021-05-12,71,30499,25,7028,43,22723,3,748,35,5977,36,12609,38,18586,California
Amador,2021-05-13,79,30578,41,7069,32,22755,6,754,38,5981,40,12649,44,18630,California
Amador,2021-05-14,402,30980,36,7105,361,23116,5,759,90,5767,311,12960,97,18727,California
Amador,2021-05-15,49,31029,19,7124,20,23136,10,769,23,5775,26,12986,34,18761,California
Amador,2021-05-16,40,31069,14,7138,26,23162,0,769,17,5769,23,13009,17,18778,California
Amador,2021-05-17,77,31146,24,7162,51,23213,2,771,35,5766,41,13050,38,18816,California
Amador,2021-05-18,249,31395,168,7330,46,23259,35,806,167,5887,81,13131,202,19018,California
Amador,2021-05-19,76,31471,26,7356,47,23306,3,809,34,5885,41,13172,39,19057,California
Amador,2021-05-20,88,31559,47,7403,37,23343,4,813,30,5862,57,13229,34,19091,California
Amador,2021-05-21,274,31833,29,7432,243,23586,2,815,37,5664,237,13466,39,19130,California
Amador,2021-05-22,46,31879,14,7446,27,23613,5,820,12,5648,34,13500,18,19148,California
Amador,2021-05-23,29,31908,5,7451,21,23634,3,823,5,5632,24,13524,8,19156,California
Amador,2021-05-24,92,32000,34,7485,46,23680,12,835,42,5636,50,13574,54,19210,California
Amador,2021-05-25,142,32142,90,7575,27,23707,25,860,83,5687,57,13631,108,19318,California
Amador,2021-05-26,204,32346,161,7736,36,23743,7,867,38,5566,165,13796,44,19362,California
Amador,2021-05-27,83,32429,39,7775,35,23778,9,876,30,5553,52,13848,39,19401,California
Amador,2021-05-28,69,32498,27,7802,38,23816,4,880,29,5547,39,13887,33,19434,California
Amador,2021-05-29,26,32524,2,7804,21,23837,3,883,8,5540,18,13905,11,19445,California
Amador,2021-05-30,19,32543,5,7809,8,23845,6,889,5,5537,14,13919,11,19456,California
Amador,2021-05-31,10,32553,0,7809,9,23854,1,890,2,5532,8,13927,3,19459,California
Amador,2021-06-01,94,32647,66,7875,23,23877,5,895,44,5532,49,13976,49,19508,California
Amador,2021-06-02,46,32693,16,7891,22,23899,8,903,16,5527,30,14006,25,19533,California
Amador,2021-06-03,58,32751,25,7916,28,23927,5,908,19,5513,38,14044,24,19557,California
Amador,2021-06-04,100,32851,20,7936,59,23986,21,929,20,5474,80,14124,41,19598,California
Amador,2021-06-05,41,32892,17,7953,19,24005,5,934,4,5446,37,14161,9,19607,California
Amador,2021-06-06,20,32912,9,7962,10,24015,1,935,9,5446,11,14172,11,19618,California
Amador,2021-06-07,46,32958,18,7980,23,24038,5,940,18,5441,28,14200,23,19641,California
Amador,2021-06-08,174,33132,139,8119,25,24063,10,950,53,5385,120,14320,64,19705,California
Amador,2021-06-09,48,33180,19,8138,20,24083,9,959,13,5372,35,14355,22,19727,California
Amador,2021-06-10,56,33236,23,8161,22,24105,11,970,21,5369,35,14390,32,19759,California
Amador,2021-06-11,58,33294,17,8178,36,24141,5,975,12,5340,46,14436,17,19776,California
Amador,2021-06-12,24,33318,11,8189,11,24152,2,977,9,5337,14,14450,11,19787,California
Amador,2021-06-13,9,33327,2,8191,6,24158,1,978,2,5333,7,14457,3,19790,California
Amador,2021-06-14,46,33373,23,8214,21,24179,2,980,14,5317,32,14489,16,19806,California
Amador,2021-06-15,45,33418,14,8228,19,24198,12,992,19,5323,25,14514,31,19837,California
Amador,2021-06-16,71,33489,31,8259,31,24229,9,1001,33,5327,38,14552,42,19879,California
Amador,2021-06-17,49,33538,25,8284,20,24249,4,1005,29,5341,19,14571,33,19912,California
Amador,2021-06-18,157,33695,120,8404,30,24279,7,1012,62,5316,95,14666,70,19982,California
Amador,2021-06-19,30,33725,8,8412,14,24293,8,1020,11,5317,19,14685,20,20002,California
Amador,2021-06-20,8,33733,6,8418,1,24294,1,1021,3,5316,5,14690,4,20006,California
Amador,2021-06-21,47,33780,15,8433,23,24317,9,1030,16,5310,31,14721,25,20031,California
Amador,2021-06-22,48,33828,27,8460,19,24336,2,1032,29,5322,19,14740,31,20062,California
Amador,2021-06-23,42,33870,22,8482,12,24348,8,1040,23,5334,19,14759,31,20093,California
Amador,2021-06-24,51,33921,27,8509,18,24366,6,1046,26,5343,23,14782,32,20125,California
Amador,2021-06-25,52,33973,31,8540,10,24376,11,1057,28,5360,23,14805,40,20165,California
Amador,2021-06-26,10,33983,4,8544,4,24380,2,1059,6,5364,4,14809,8,20173,California
Amador,2021-06-27,22,34005,14,8558,4,24384,4,1063,11,5368,11,14820,15,20188,California
Amador,2021-06-28,51,34056,27,8585,13,24397,11,1074,23,5374,28,14848,34,20222,California
Amador,2021-06-29,50,34106,23,8608,18,24415,9,1083,26,5385,24,14872,35,20257,California
Amador,2021-06-30,47,34153,17,8625,14,24429,16,1099,22,5397,25,14897,37,20294,California
Amador,2021-07-01,32,34185,16,8641,13,24442,3,1102,15,5398,17,14914,18,20312,California
Amador,2021-07-02,35,34220,16,8657,9,24451,10,1112,19,5411,16,14930,29,20341,California
Amador,2021-07-03,16,34236,1,8658,11,24462,4,1116,9,5417,7,14937,13,20354,California
Amador,2021-07-04,5,34241,0,8658,5,24467,0,1116,5,5422,0,14937,5,20359,California
Amador,2021-07-05,28,34269,5,8663,19,24486,4,1120,15,5428,13,14950,19,20378,California
Amador,2021-07-06,30,34299,13,8676,13,24499,4,1124,13,5428,17,14967,17,20395,California
Amador,2021-07-07,35,34334,13,8689,17,24516,5,1129,17,5432,18,14985,22,20417,California
Amador,2021-07-08,27,34361,11,8700,15,24531,1,1130,10,5427,17,15002,12,20429,California
Amador,2021-07-09,64,34425,45,8745,18,24549,1,1131,23,5412,41,15043,26,20455,California
Amador,2021-07-10,15,34440,6,8751,7,24556,2,1133,8,5415,7,15050,10,20465,California
Amador,2021-07-11,4,34444,2,8753,2,24558,0,1133,0,5412,4,15054,1,20466,California
Amador,2021-07-12,35,34479,17,8770,13,24571,5,1138,24,5430,11,15065,29,20495,California
Amador,2021-07-13,35,34514,16,8786,13,24584,6,1144,16,5433,19,15084,22,20517,California
Amador,2021-07-14,35,34549,18,8804,16,24600,1,1145,14,5427,21,15105,15,20532,California
Amador,2021-07-15,40,34589,23,8827,15,24615,2,1147,26,5441,14,15119,28,20560,California
Amador,2021-07-16,55,34644,29,8856,21,24636,5,1152,23,5438,32,15151,29,20589,California
Amador,2021-07-17,20,34664,7,8863,8,24644,5,1157,10,5444,10,15161,16,20605,California
Amador,2021-07-18,11,34675,8,8871,2,24646,1,1158,4,5443,7,15168,6,20611,California
Amador,2021-07-19,50,34725,27,8898,18,24664,5,1163,30,5460,20,15188,37,20648,California
Amador,2021-07-20,66,34791,35,8933,17,24681,14,1177,29,5468,37,15225,45,20693,California
Amador,2021-07-21,43,34834,16,8949,21,24702,6,1183,27,5486,15,15240,33,20726,California
Amador,2021-07-22,46,34880,19,8968,19,24721,8,1191,25,5499,21,15261,34,20760,California
Amador,2021-07-23,45,34925,24,8992,16,24737,5,1196,25,5509,20,15281,30,20790,California
Amador,2021-07-24,10,34935,0,8992,8,24745,2,1198,4,5509,6,15287,6,20796,California
Amador,2021-07-25,15,34950,3,8995,7,24752,5,1203,6,5511,9,15296,11,20807,California
Amador,2021-07-26,42,34992,17,9012,24,24776,1,1204,35,5541,7,15303,37,20844,California
Amador,2021-07-27,38,35030,17,9029,15,24791,6,1210,20,5549,18,15321,26,20870,California
Amador,2021-07-28,43,35073,21,9050,18,24809,4,1214,28,5566,15,15336,32,20902,California
Amador,2021-07-29,38,35111,19,9069,15,24824,4,1218,26,5584,12,15348,30,20932,California
Amador,2021-07-30,51,35162,28,9097,22,24846,1,1219,36,5610,15,15363,41,20973,California
Amador,2021-07-31,20,35182,11,9108,7,24853,2,1221,13,5618,7,15370,15,20988,California
Butte,2020-12-16,3,3,3,3,0,0,0,0,3,3,0,0,3,3,California
Butte,2020-12-17,21,24,21,24,0,0,0,0,21,24,0,0,21,24,California
Butte,2020-12-18,53,77,53,77,0,0,0,0,53,77,0,0,53,77,California
Butte,2020-12-19,7,84,7,84,0,0,0,0,7,84,0,0,7,84,California
Butte,2020-12-20,9,93,9,93,0,0,0,0,9,93,0,0,9,93,California
Butte,2020-12-21,630,723,630,723,0,0,0,0,630,723,0,0,630,723,California
Butte,2020-12-22,619,1342,617,1340,2,2,0,0,619,1342,0,0,619,1342,California
Butte,2020-12-23,875,2217,859,2199,16,18,0,0,875,2217,0,0,875,2217,California
Butte,2020-12-24,158,2375,154,2353,4,22,0,0,158,2375,0,0,158,2375,California
Butte,2020-12-26,89,2464,87,2440,2,24,0,0,89,2464,0,0,89,2464,California
Butte,2020-12-27,35,2499,34,2474,1,25,0,0,35,2499,0,0,35,2499,California
Butte,2020-12-28,278,2777,272,2746,6,31,0,0,278,2777,0,0,278,2777,California
Butte,2020-12-29,204,2981,179,2925,25,56,0,0,204,2981,0,0,204,2981,California
Butte,2020-12-30,510,3491,290,3215,220,276,0,0,510,3491,0,0,510,3491,California
Butte,2020-12-31,213,3704,18,3233,195,471,0,0,213,3704,0,0,213,3704,California
Butte,2021-01-01,18,3722,8,3241,10,481,0,0,18,3722,0,0,18,3722,California
Butte,2021-01-02,40,3762,37,3278,3,484,0,0,40,3762,0,0,40,3762,California
Butte,2021-01-03,4,3766,1,3279,3,487,0,0,4,3766,0,0,4,3766,California
Butte,2021-01-04,211,3977,177,3456,34,521,0,0,211,3977,0,0,211,3977,California
Butte,2021-01-05,194,4171,150,3606,44,565,0,0,193,4169,1,1,193,4170,California
Butte,2021-01-06,629,4800,396,4002,233,798,0,0,624,4789,5,6,625,4795,California
Butte,2021-01-07,762,5562,367,4369,395,1193,0,0,742,5511,20,26,742,5537,California
Butte,2021-01-08,672,6234,530,4899,142,1335,0,0,623,6085,49,75,623,6160,California
Butte,2021-01-09,13,6247,8,4907,5,1340,0,0,7,6086,6,81,7,6167,California
Butte,2021-01-10,18,6265,4,4911,14,1354,0,0,14,6096,4,85,14,6181,California
Butte,2021-01-11,985,7250,950,5861,35,1389,0,0,355,5824,630,715,358,6539,California
Butte,2021-01-12,700,7950,654,6515,46,1435,0,0,277,5679,423,1138,278,6817,California
Butte,2021-01-13,1561,9511,1071,7586,490,1925,0,0,722,5565,838,1976,724,7541,California
Butte,2021-01-14,1641,11152,895,8481,746,2671,0,0,1443,6812,196,2172,1443,8984,California
Butte,2021-01-15,1062,12214,818,9299,244,2915,0,0,952,7654,110,2282,952,9936,California
Butte,2021-01-16,590,12804,302,9601,288,3203,0,0,545,8154,45,2327,545,10481,California
Butte,2021-01-17,238,13042,63,9664,175,3378,0,0,200,8316,38,2365,200,10681,California
Butte,2021-01-18,348,13390,305,9969,43,3421,0,0,281,8531,66,2431,281,10962,California
Butte,2021-01-19,494,13884,430,10399,64,3485,0,0,226,8489,268,2699,226,11188,California
Butte,2021-01-20,1395,15279,709,11108,686,4171,0,0,1091,9276,304,3003,1091,12279,California
Butte,2021-01-21,1496,16775,884,11992,612,4783,0,0,1387,10555,108,3111,1387,13666,California
Butte,2021-01-22,1144,17919,484,12476,660,5443,0,0,1089,11589,55,3166,1089,14755,California
Butte,2021-01-23,126,18045,85,12561,41,5484,0,0,101,11665,25,3191,101,14856,California
Butte,2021-01-24,7,18052,6,12567,1,5485,0,0,7,11672,0,3191,7,14863,California
Butte,2021-01-25,659,18711,339,12906,320,5805,0,0,494,12001,165,3356,494,15357,California
Butte,2021-01-26,1496,20207,377,13283,1119,6924,0,0,1359,13223,137,3493,1359,16716,California
Butte,2021-01-27,2111,22318,704,13987,1407,8331,0,0,1377,13867,733,4226,1377,18093,California
Butte,2021-01-28,2278,24596,258,14245,2020,10351,0,0,1953,15496,324,4550,1953,20046,California
Butte,2021-01-29,1694,26290,491,14736,1203,11554,0,0,1313,16430,379,4929,1313,21359,California
Butte,2021-01-30,29,26319,8,14744,21,11575,0,0,27,16455,2,4931,27,21386,California
Butte,2021-01-31,16,26335,14,14758,2,11577,0,0,15,16469,1,4932,15,21401,California
Butte,2021-02-01,1769,28104,407,15165,1362,12939,0,0,1374,17451,392,5324,1374,22775,California
Butte,2021-02-02,1955,30059,365,15530,1590,14529,0,0,1653,18801,303,5627,1653,24428,California
Butte,2021-02-03,2758,32817,781,16311,1977,16506,0,0,1855,19755,901,6528,1855,26283,California
Butte,2021-02-04,2982,35799,323,16634,2659,19165,0,0,2415,21605,565,7093,2415,28698,California
Butte,2021-02-05,1278,37077,671,17305,607,19772,0,0,549,21426,729,7822,550,29248,California
Butte,2021-02-06,147,37224,104,17409,43,19815,0,0,62,21403,85,7907,62,29310,California
Butte,2021-02-07,38,37262,34,17443,4,19819,0,0,15,21396,22,7929,15,29325,California
Butte,2021-02-08,702,37964,549,17992,153,19972,0,0,239,21174,461,8390,239,29564,California
Butte,2021-02-09,972,38936,463,18455,509,20481,0,0,739,21681,232,8622,739,30303,California
Butte,2021-02-10,1709,40645,1191,19646,518,20999,0,0,654,21284,1052,9674,655,30958,California
Butte,2021-02-11,2224,42869,1363,21009,861,21860,0,0,1010,21081,1214,10888,1011,31969,California
Butte,2021-02-12,1007,43876,437,21446,570,22430,0,0,326,20728,679,11567,326,32295,California
Butte,2021-02-13,253,44129,42,21488,211,22641,0,0,151,20778,101,11668,151,32446,California
Butte,2021-02-14,165,44294,10,21498,155,22796,0,0,159,20932,6,11674,160,32606,California
Butte,2021-02-15,262,44556,48,21546,214,23010,0,0,194,21058,68,11742,194,32800,California
Butte,2021-02-16,760,45316,436,21982,324,23334,0,0,299,20896,461,12203,299,33099,California
Butte,2021-02-17,1539,46855,857,22839,682,24016,0,0,852,21064,684,12887,852,33951,California
Butte,2021-02-18,1589,48444,775,23614,814,24830,0,0,772,21019,817,13704,772,34723,California
Butte,2021-02-19,1181,49625,394,24008,787,25617,0,0,402,20649,772,14476,402,35125,California
Butte,2021-02-20,487,50112,36,24044,451,26068,0,0,127,20417,359,14835,127,35252,California
Butte,2021-02-21,19,50131,16,24060,3,26071,0,0,14,20426,5,14840,14,35266,California
Butte,2021-02-22,1570,51701,315,24375,1255,27326,0,0,393,19646,1173,16013,393,35659,California
Butte,2021-02-23,1699,53400,310,24685,1389,28715,0,0,472,18900,1218,17231,472,36131,California
Butte,2021-02-24,2225,55625,636,25321,1589,30304,0,0,769,18221,1448,18679,769,36900,California
Butte,2021-02-25,2188,57813,652,25973,1536,31840,0,0,723,17491,1454,20133,724,37624,California
Butte,2021-02-26,975,58788,332,26305,643,32483,0,0,427,17375,543,20676,427,38051,California
Butte,2021-02-27,244,59032,48,26353,196,32679,0,0,193,17519,49,20725,193,38244,California
Butte,2021-02-28,155,59187,16,26369,139,32818,0,0,145,17656,8,20733,145,38389,California
Butte,2021-03-01,1696,60883,202,26571,1490,34308,4,4,362,16697,1325,22058,366,38755,California
Butte,2021-03-02,1812,62695,208,26779,1604,35912,0,4,315,15521,1492,23550,316,39071,California
Butte,2021-03-03,2896,65591,902,27681,1994,37906,0,4,513,13658,2376,25926,513,39584,California
Butte,2021-03-04,3262,68853,726,28407,2536,40442,0,4,642,11685,2615,28541,642,40226,California
Butte,2021-03-05,1385,70238,635,29042,749,41191,1,5,748,11801,633,29174,749,40975,California
Butte,2021-03-06,252,70490,24,29066,204,41395,24,29,189,11954,60,29234,213,41188,California
Butte,2021-03-07,71,70561,5,29071,43,41438,23,52,40,11986,31,29265,63,41251,California
Butte,2021-03-08,1276,71837,130,29201,1066,42504,80,132,1104,13001,169,29434,1184,42435,California
Butte,2021-03-09,1938,73775,284,29485,1550,44054,104,236,1418,14011,512,29946,1522,43957,California
Butte,2021-03-10,2339,76114,980,30465,1258,45312,101,337,1589,14957,744,30690,1690,45647,California
Butte,2021-03-11,2817,78931,1321,31786,1369,46681,127,464,1972,16224,833,31523,2100,47747,California
Butte,2021-03-12,1163,80094,331,32117,467,47148,365,829,353,16138,803,32326,717,48464,California
Butte,2021-03-13,270,80364,68,32185,140,47288,62,891,58,16046,211,32537,119,48583,California
Butte,2021-03-14,168,80532,18,32203,108,47396,42,933,23,15968,143,32680,65,48648,California
Butte,2021-03-15,1749,82281,361,32564,1091,48487,297,1230,1143,16810,597,33277,1439,50087,California
Butte,2021-03-16,1683,83964,428,32992,1177,49664,78,1308,1094,17397,584,33861,1171,51258,California
Butte,2021-03-17,1959,85923,1354,34346,524,50188,81,1389,1103,17732,848,34709,1183,52441,California
Butte,2021-03-18,1823,87746,1475,35821,221,50409,127,1516,1010,18061,807,35516,1136,53577,California
Butte,2021-03-19,696,88442,309,36130,303,50712,84,1600,337,18132,349,35865,420,53997,California
Butte,2021-03-20,205,88647,30,36160,159,50871,16,1616,98,18139,107,35972,114,54111,California
Butte,2021-03-21,73,88720,40,36200,4,50875,29,1645,23,18144,47,36019,52,54163,California
Butte,2021-03-22,1520,90240,383,36583,1042,51917,95,1740,1245,19209,274,36293,1339,55502,California
Butte,2021-03-23,1866,92106,522,37105,1231,53148,113,1853,1509,20478,352,36645,1621,57123,California
Butte,2021-03-24,2280,94386,1276,38381,878,54026,126,1979,1697,21723,577,37222,1822,58945,California
Butte,2021-03-25,1500,95886,1210,39591,198,54224,92,2071,1015,22350,479,37701,1106,60051,California
Butte,2021-03-26,1218,97104,440,40031,528,54752,250,2321,554,22499,655,38356,804,60855,California
Butte,2021-03-27,314,97418,86,40117,202,54954,26,2347,137,22487,173,38529,161,61016,California
Butte,2021-03-28,235,97653,46,40163,182,55136,7,2354,100,22461,132,38661,106,61122,California
Butte,2021-03-29,1777,99430,383,40546,1324,56460,70,2424,1339,23440,430,39091,1409,62531,California
Butte,2021-03-30,1042,100472,475,41021,476,56936,91,2515,485,23466,549,39640,575,63106,California
Butte,2021-03-31,1792,102264,1306,42327,417,57353,69,2584,1071,23897,709,40349,1140,64246,California
Butte,2021-04-01,3368,105632,2728,45055,510,57863,130,2714,2267,25211,1083,41432,2397,66643,California
Butte,2021-04-02,1013,106645,421,45476,471,58334,121,2835,568,25463,436,41868,688,67331,California
Butte,2021-04-03,343,106988,46,45522,224,58558,73,2908,165,25522,178,42046,237,67568,California
Butte,2021-04-04,208,107196,34,45556,149,58707,25,2933,122,25585,83,42129,146,67714,California
Butte,2021-04-05,1974,109170,422,45978,1381,60088,171,3104,590,24969,1375,43504,759,68473,California
Butte,2021-04-06,2211,111381,618,46596,1173,61261,420,3524,799,24783,1403,44907,1217,69690,California
Butte,2021-04-07,3046,114427,1320,47916,1331,62592,395,3919,720,23575,2321,47228,1113,70803,California
Butte,2021-04-08,2774,117201,1206,49122,1297,63889,271,4190,458,21993,2310,49538,728,71531,California
Butte,2021-04-09,1376,118577,352,49474,542,64431,482,4672,328,21755,1044,50582,806,72337,California
Butte,2021-04-10,229,118806,50,49524,76,64507,103,4775,101,21831,127,50709,203,72540,California
Butte,2021-04-11,107,118913,44,49568,53,64560,10,4785,83,21901,23,50732,93,72633,California
Butte,2021-04-12,1413,120326,313,49881,968,65528,132,4917,233,21086,1180,51912,365,72998,California
Butte,2021-04-13,1658,121984,573,50454,1079,66607,6,4923,344,20131,1305,53217,350,73348,California
Butte,2021-04-14,2864,124848,2364,52818,500,67107,0,4923,1315,19905,1542,54759,1316,74664,California
Butte,2021-04-15,636,125484,387,53205,249,67356,0,4923,471,20218,158,54917,471,75135,California
Butte,2021-04-16,819,126303,420,53625,399,67755,0,4923,480,20364,334,55251,480,75615,California
Butte,2021-04-17,347,126650,62,53687,285,68040,0,4923,240,20499,105,55356,240,75855,California
Butte,2021-04-18,56,126706,21,53708,35,68075,0,4923,41,20525,15,55371,41,75896,California
Butte,2021-04-19,1582,128288,391,54099,1191,69266,0,4923,423,19794,1155,56526,424,76320,California
Butte,2021-04-20,2043,130331,773,54872,1270,70536,0,4923,757,19274,1277,57803,757,77077,California
Butte,2021-04-21,2123,132454,1238,56110,885,71421,0,4923,487,18134,1627,59430,487,77564,California
Butte,2021-04-22,2283,134737,1996,58106,287,71708,0,4923,631,17119,1646,61076,631,78195,California
Butte,2021-04-23,974,135711,476,58582,498,72206,0,4923,488,17122,485,61561,488,78683,California
Butte,2021-04-24,350,136061,141,58723,209,72415,0,4923,190,17152,160,61721,190,78873,California
Butte,2021-04-25,180,136241,72,58795,108,72523,0,4923,60,17093,119,61840,60,78933,California
Butte,2021-04-26,1584,137825,473,59268,1105,73628,6,4929,401,16323,1177,63017,407,79340,California
Butte,2021-04-27,1039,138864,694,59962,318,73946,27,4956,589,16493,446,63463,616,79956,California
Butte,2021-04-28,1449,140313,986,60948,438,74384,25,4981,519,16112,925,64388,544,80500,California
Butte,2021-04-29,935,141248,582,61530,328,74712,25,5006,316,15844,609,64997,341,80841,California
Butte,2021-04-30,939,142187,427,61957,492,75204,20,5026,471,15875,458,65455,489,81330,California
Butte,2021-05-01,262,142449,68,62025,170,75374,24,5050,78,15802,171,65626,98,81428,California
Butte,2021-05-02,160,142609,67,62092,80,75454,13,5063,46,15748,113,65739,59,81487,California
Butte,2021-05-03,640,143249,263,62355,346,75800,31,5094,179,15508,450,66189,210,81697,California
Butte,2021-05-04,858,144107,349,62704,477,76277,32,5126,226,15141,623,66812,256,81953,California
Butte,2021-05-05,1393,145500,1136,63840,219,76496,38,5164,294,14382,1091,67903,332,82285,California
Butte,2021-05-06,997,146497,730,64570,227,76723,40,5204,372,14173,620,68523,411,82696,California
Butte,2021-05-07,591,147088,314,64884,241,76964,36,5240,305,14230,282,68805,339,83035,California
Butte,2021-05-08,189,147277,52,64936,126,77090,11,5251,93,14239,95,68900,104,83139,California
Butte,2021-05-09,102,147379,26,64962,73,77163,3,5254,54,14248,48,68948,57,83196,California
Butte,2021-05-10,543,147922,318,65280,179,77342,46,5300,218,14191,321,69269,264,83460,California
Butte,2021-05-11,928,148850,672,65952,195,77537,61,5361,295,13918,628,69897,355,83815,California
Butte,2021-05-12,787,149637,485,66437,254,77791,48,5409,333,13849,450,70347,381,84196,California
Butte,2021-05-13,955,150592,633,67070,256,78047,66,5475,348,13665,596,70943,412,84608,California
Butte,2021-05-14,868,151460,542,67612,293,78340,33,5508,378,13589,486,71429,410,85018,California
Butte,2021-05-15,511,151971,246,67858,231,78571,34,5542,239,13592,270,71699,273,85291,California
Butte,2021-05-16,168,152139,82,67940,68,78639,18,5560,99,13641,68,71767,117,85408,California
Butte,2021-05-17,767,152906,496,68436,223,78862,48,5608,332,13590,430,72197,379,85787,California
Butte,2021-05-18,1070,153976,735,69171,286,79148,49,5657,474,13523,590,72787,523,86310,California
Butte,2021-05-19,835,154811,544,69715,246,79394,45,5702,329,13396,500,73287,373,86683,California
Butte,2021-05-20,988,155799,664,70379,215,79609,109,5811,386,13292,598,73885,494,87177,California
Butte,2021-05-21,887,156686,541,70920,319,79928,27,5838,294,13022,590,74475,320,87497,California
Butte,2021-05-22,299,156985,139,71059,145,80073,15,5853,144,13029,152,74627,159,87656,California
Butte,2021-05-23,132,157117,83,71142,48,80121,1,5854,79,13056,53,74680,80,87736,California
Butte,2021-05-24,351,157468,165,71307,137,80258,49,5903,176,13107,174,74854,225,87961,California
Butte,2021-05-25,703,158171,451,71758,214,80472,38,5941,341,13133,351,75205,377,88338,California
Butte,2021-05-26,563,158734,182,71940,358,80830,23,5964,243,13086,312,75517,265,88603,California
Butte,2021-05-27,868,159602,624,72564,226,81056,18,5982,423,13089,439,75956,442,89045,California
Butte,2021-05-28,525,160127,147,72711,299,81355,79,6061,213,13072,309,76265,292,89337,California
Butte,2021-05-29,226,160353,117,72828,97,81452,12,6073,145,13148,81,76346,157,89494,California
Butte,2021-05-30,107,160460,57,72885,50,81502,0,6073,59,13159,48,76394,59,89553,California
Butte,2021-05-31,45,160505,24,72909,19,81521,2,6075,25,13167,19,76413,27,89580,California
Butte,2021-06-01,687,161192,430,73339,219,81740,38,6113,256,13037,422,76835,292,89872,California
Butte,2021-06-02,818,162010,567,73906,207,81947,44,6157,352,12971,461,77296,395,90267,California
Butte,2021-06-03,630,162640,424,74330,189,82136,17,6174,207,12775,420,77716,224,90491,California
Butte,2021-06-04,484,163124,275,74605,180,82316,29,6203,142,12611,335,78051,171,90662,California
Butte,2021-06-05,321,163445,207,74812,95,82411,19,6222,96,12503,223,78274,115,90777,California
Butte,2021-06-06,138,163583,102,74914,34,82445,2,6224,35,12438,102,78376,37,90814,California
Butte,2021-06-07,405,163988,258,75172,116,82561,31,6255,169,12402,235,78611,199,91013,California
Butte,2021-06-08,652,164640,469,75641,164,82725,19,6274,179,12140,461,79072,199,91212,California
Butte,2021-06-09,439,165079,301,75942,120,82845,18,6292,148,12022,284,79356,166,91378,California
Butte,2021-06-10,633,165712,452,76394,149,82994,32,6324,233,11887,398,79754,263,91641,California
Butte,2021-06-11,443,166155,265,76659,157,83151,21,6345,149,11764,293,80047,170,91811,California
Butte,2021-06-12,251,166406,153,76812,88,83239,10,6355,75,11674,175,80222,85,91896,California
Butte,2021-06-13,98,166504,64,76876,31,83270,3,6358,20,11619,78,80300,23,91919,California
Butte,2021-06-14,395,166899,238,77114,137,83407,20,6378,140,11526,254,80554,161,92080,California
Butte,2021-06-15,551,167450,387,77501,138,83545,26,6404,164,11335,381,80935,190,92270,California
Butte,2021-06-16,418,167868,256,77757,118,83663,44,6448,170,11303,246,81181,214,92484,California
Butte,2021-06-17,582,168450,433,78190,122,83785,27,6475,178,11106,403,81584,206,92690,California
Butte,2021-06-18,410,168860,205,78395,152,83937,53,6528,160,11068,248,81832,210,92900,California
Butte,2021-06-19,209,169069,155,78550,49,83986,5,6533,93,11050,116,81948,98,92998,California
Butte,2021-06-20,94,169163,69,78619,25,84011,0,6533,24,11005,70,82018,25,93023,California
Butte,2021-06-21,275,169438,163,78782,91,84102,21,6554,130,11014,142,82160,151,93174,California
Butte,2021-06-22,416,169854,274,79056,118,84220,24,6578,148,10921,265,82425,172,93346,California
Butte,2021-06-23,455,170309,338,79394,93,84313,24,6602,169,10828,285,82710,192,93538,California
Butte,2021-06-24,427,170736,284,79678,109,84422,34,6636,152,10740,274,82984,186,93724,California
Butte,2021-06-25,420,171156,205,79883,192,84614,23,6659,159,10662,260,83244,182,93906,California
Butte,2021-06-26,136,171292,99,79982,34,84648,3,6662,58,10645,78,83322,61,93967,California
Butte,2021-06-27,67,171359,41,80023,25,84673,1,6663,19,10618,48,83370,21,93988,California
Butte,2021-06-28,299,171658,225,80248,54,84727,20,6683,123,10587,174,83544,143,94131,California
Butte,2021-06-29,325,171983,217,80465,95,84822,13,6696,142,10561,180,83724,154,94285,California
Butte,2021-06-30,327,172310,214,80679,97,84919,16,6712,160,10571,166,83890,176,94461,California
Butte,2021-07-01,358,172668,230,80909,108,85027,20,6732,144,10522,213,84103,164,94625,California
Butte,2021-07-02,297,172965,203,81112,68,85095,26,6758,138,10530,156,84259,164,94789,California
Butte,2021-07-03,123,173088,83,81195,38,85133,2,6760,52,10514,70,84329,54,94843,California
Butte,2021-07-04,3,173091,2,81197,1,85134,0,6760,0,10512,2,84331,0,94843,California
Butte,2021-07-05,148,173239,97,81294,41,85175,10,6770,63,10504,81,84412,73,94916,California
Butte,2021-07-06,338,173577,250,81544,73,85248,15,6785,116,10417,219,84631,132,95048,California
Butte,2021-07-07,321,173898,237,81781,76,85324,8,6793,122,10351,196,84827,130,95178,California
Butte,2021-07-08,300,174198,196,81977,95,85419,9,6802,116,10295,181,85008,125,95303,California
Butte,2021-07-09,258,174456,158,82135,79,85498,21,6823,97,10253,160,85168,118,95421,California
Butte,2021-07-10,146,174602,102,82237,42,85540,2,6825,50,10208,96,85264,51,95472,California
Butte,2021-07-11,52,174654,37,82274,9,85549,6,6831,28,10219,23,85287,34,95506,California
Butte,2021-07-12,199,174853,124,82398,63,85612,12,6843,94,10221,104,85391,106,95612,California
Butte,2021-07-13,315,175168,233,82631,73,85685,9,6852,145,10208,167,85558,154,95766,California
Butte,2021-07-14,356,175524,269,82900,72,85757,15,6867,154,10177,200,85758,169,95935,California
Butte,2021-07-15,398,175922,281,83181,63,85820,54,6921,205,10244,192,85950,259,96194,California
Butte,2021-07-16,317,176239,199,83380,89,85909,29,6950,130,10216,187,86137,159,96353,California
Butte,2021-07-17,132,176371,89,83469,42,85951,1,6951,73,10232,58,86195,74,96427,California
Butte,2021-07-18,58,176429,35,83504,18,85969,5,6956,30,10239,28,86223,35,96462,California
Butte,2021-07-19,273,176702,201,83705,59,86028,13,6969,109,10197,164,86387,122,96584,California
Butte,2021-07-20,440,177142,328,84033,90,86118,22,6991,191,10161,249,86636,213,96797,California
Butte,2021-07-21,398,177540,299,84332,81,86199,18,7009,228,10240,166,86802,245,97042,California
Butte,2021-07-22,294,177834,186,84518,90,86289,18,7027,168,10303,123,86925,186,97228,California
Butte,2021-07-23,356,178190,214,84732,115,86404,27,7054,200,10377,153,87078,227,97455,California
Butte,2021-07-24,138,178328,106,84838,29,86433,3,7057,78,10399,59,87137,81,97536,California
Butte,2021-07-25,76,178404,45,84883,24,86457,7,7064,53,10440,19,87156,60,97596,California
Butte,2021-07-26,249,178653,155,85038,87,86544,7,7071,163,10526,84,87240,170,97766,California
Butte,2021-07-27,356,179009,272,85310,75,86619,9,7080,213,10606,142,87382,222,97988,California
Butte,2021-07-28,432,179441,316,85626,97,86716,19,7099,256,10707,174,87556,275,98263,California
Butte,2021-07-29,318,179759,205,85831,78,86794,35,7134,197,10820,120,87676,233,98496,California
Butte,2021-07-30,317,180076,196,86027,93,86887,28,7162,201,10935,114,87790,229,98725,California
Butte,2021-07-31,88,180164,53,86080,32,86919,3,7165,53,10956,35,87825,56,98781,California
Calaveras,2020-12-16,10,10,10,10,0,0,0,0,10,10,0,0,10,10,California
Calaveras,2020-12-17,6,16,6,16,0,0,0,0,6,16,0,0,6,16,California
Calaveras,2020-12-18,40,56,40,56,0,0,0,0,40,56,0,0,40,56,California
Calaveras,2020-12-19,4,60,4,60,0,0,0,0,4,60,0,0,4,60,California
Calaveras,2020-12-20,4,64,4,64,0,0,0,0,4,64,0,0,4,64,California
Calaveras,2020-12-21,55,119,48,112,7,7,0,0,55,119,0,0,55,119,California
Calaveras,2020-12-22,85,204,81,193,4,11,0,0,86,205,0,0,86,205,California
Calaveras,2020-12-23,76,280,74,267,2,13,0,0,76,281,0,0,76,281,California
Calaveras,2020-12-24,2,282,2,269,0,13,0,0,2,283,0,0,2,283,California
Calaveras,2020-12-26,4,286,3,272,1,14,0,0,4,287,0,0,4,287,California
Calaveras,2020-12-27,1,287,1,273,0,14,0,0,1,288,0,0,1,288,California
Calaveras,2020-12-28,23,310,18,291,5,19,0,0,22,309,1,1,22,310,California
Calaveras,2020-12-29,159,469,137,428,22,41,0,0,159,468,0,1,159,469,California
Calaveras,2020-12-30,94,563,81,509,13,54,0,0,94,562,0,1,94,563,California
Calaveras,2020-12-31,37,600,26,535,11,65,0,0,37,599,0,1,37,600,California
Calaveras,2021-01-02,12,612,12,547,0,65,0,0,12,611,0,1,12,612,California
Calaveras,2021-01-03,10,622,4,551,6,71,0,0,10,621,0,1,10,622,California
Calaveras,2021-01-04,33,655,5,556,28,99,0,0,33,654,0,1,33,655,California
Calaveras,2021-01-05,43,698,10,566,33,132,0,0,32,680,11,12,37,692,California
Calaveras,2021-01-06,107,805,30,596,77,209,0,0,97,767,10,22,97,789,California
Calaveras,2021-01-07,111,916,30,626,81,290,0,0,95,849,14,36,96,885,California
Calaveras,2021-01-08,75,991,45,671,30,320,0,0,46,868,29,65,48,933,California
Calaveras,2021-01-09,5,996,5,676,0,320,0,0,2,867,3,68,2,935,California
Calaveras,2021-01-10,2,998,0,676,2,322,0,0,2,869,0,68,2,937,California
Calaveras,2021-01-11,69,1067,63,739,6,328,0,0,29,861,39,107,31,968,California
Calaveras,2021-01-12,89,1156,56,795,33,361,0,0,52,877,37,144,53,1021,California
Calaveras,2021-01-13,108,1264,45,840,63,424,0,0,74,918,34,178,75,1096,California
Calaveras,2021-01-14,143,1407,45,885,98,522,0,0,109,995,33,211,110,1206,California
Calaveras,2021-01-15,93,1500,28,913,65,587,0,0,73,1048,20,231,73,1279,California
Calaveras,2021-01-16,14,1514,2,915,12,599,0,0,13,1060,1,232,13,1292,California
Calaveras,2021-01-17,10,1524,2,917,8,607,0,0,9,1068,1,233,9,1301,California
Calaveras,2021-01-18,137,1661,20,937,117,724,0,0,122,1179,15,248,126,1427,California
Calaveras,2021-01-19,211,1872,179,1116,32,756,0,0,73,1117,137,385,75,1502,California
Calaveras,2021-01-20,384,2256,83,1199,301,1057,0,0,289,1330,94,479,307,1809,California
Calaveras,2021-01-21,469,2725,41,1240,428,1485,0,0,425,1731,44,523,445,2254,California
Calaveras,2021-01-22,411,3136,26,1266,385,1870,0,0,392,2118,19,542,406,2660,California
Calaveras,2021-01-23,21,3157,11,1277,10,1880,0,0,19,2135,2,544,19,2679,California
Calaveras,2021-01-24,14,3171,8,1285,6,1886,0,0,12,2145,2,546,12,2691,California
Calaveras,2021-01-25,91,3262,8,1293,83,1969,0,0,85,2224,6,552,85,2776,California
Calaveras,2021-01-26,50,3312,15,1308,35,2004,0,0,41,2256,9,561,41,2817,California
Calaveras,2021-01-27,141,3453,48,1356,93,2097,0,0,111,2338,29,590,111,2928,California
Calaveras,2021-01-28,166,3619,26,1382,140,2237,0,0,135,2451,31,621,144,3072,California
Calaveras,2021-01-29,405,4024,16,1398,389,2626,0,0,367,2797,38,659,384,3456,California
Calaveras,2021-01-30,27,4051,10,1408,17,2643,0,0,25,2822,0,659,25,3481,California
Calaveras,2021-01-31,7,4058,4,1412,3,2646,0,0,6,2827,1,660,6,3487,California
Calaveras,2021-02-01,33,4091,13,1425,20,2666,0,0,23,2840,10,670,23,3510,California
Calaveras,2021-02-02,114,4205,25,1450,89,2755,0,0,74,2880,35,705,75,3585,California
Calaveras,2021-02-03,446,4651,45,1495,401,3156,0,0,361,3159,84,789,363,3948,California
Calaveras,2021-02-04,391,5042,26,1521,365,3521,0,0,305,3381,86,875,308,4256,California
Calaveras,2021-02-05,80,5122,22,1543,58,3579,0,0,42,3386,38,913,43,4299,California
Calaveras,2021-02-06,22,5144,13,1556,9,3588,0,0,22,3408,0,913,22,4321,California
Calaveras,2021-02-07,6,5150,1,1557,5,3593,0,0,2,3408,2,915,2,4323,California
Calaveras,2021-02-08,41,5191,18,1575,23,3616,0,0,33,3435,6,921,33,4356,California
Calaveras,2021-02-09,197,5388,77,1652,120,3736,0,0,135,3511,60,981,136,4492,California
Calaveras,2021-02-10,524,5912,35,1687,489,4225,0,0,443,3886,81,1062,456,4948,California
Calaveras,2021-02-11,603,6515,93,1780,510,4735,0,0,479,4261,121,1183,496,5444,California
Calaveras,2021-02-12,577,7092,326,2106,251,4986,0,0,488,4674,87,1270,500,5944,California
Calaveras,2021-02-13,207,7299,47,2153,160,5146,0,0,190,4848,16,1286,190,6134,California
Calaveras,2021-02-14,223,7522,70,2223,153,5299,0,0,206,5040,14,1300,206,6340,California
Calaveras,2021-02-15,390,7912,25,2248,365,5664,0,0,267,5189,118,1418,267,6607,California
Calaveras,2021-02-16,278,8190,150,2398,128,5792,0,0,233,5384,45,1463,240,6847,California
Calaveras,2021-02-17,518,8708,38,2436,480,6272,0,0,205,5301,293,1756,210,7057,California
Calaveras,2021-02-18,508,9216,95,2531,413,6685,0,0,98,5017,383,2139,99,7156,California
Calaveras,2021-02-19,443,9659,42,2573,401,7086,0,0,99,4788,328,2467,99,7255,California
Calaveras,2021-02-20,56,9715,14,2587,42,7128,0,0,46,4824,10,2477,46,7301,California
Calaveras,2021-02-21,27,9742,16,2603,11,7139,0,0,21,4840,5,2482,21,7322,California
Calaveras,2021-02-22,64,9806,38,2641,26,7165,0,0,32,4841,31,2513,32,7354,California
Calaveras,2021-02-23,136,9942,48,2689,88,7253,0,0,93,4892,43,2556,94,7448,California
Calaveras,2021-02-24,102,10044,47,2736,55,7308,0,0,68,4928,32,2588,68,7516,California
Calaveras,2021-02-25,556,10600,105,2841,451,7759,0,0,353,5098,191,2779,361,7877,California
Calaveras,2021-02-26,795,11395,48,2889,747,8506,0,0,380,5093,388,3167,383,8260,California
Calaveras,2021-02-27,212,11607,28,2917,184,8690,0,0,186,5253,26,3193,186,8446,California
Calaveras,2021-02-28,98,11705,15,2932,83,8773,0,0,93,5341,5,3198,93,8539,California
Calaveras,2021-03-01,258,11963,49,2981,209,8982,0,0,157,5404,96,3294,159,8698,California
Calaveras,2021-03-02,267,12230,109,3090,158,9140,0,0,210,5562,54,3348,212,8910,California
Calaveras,2021-03-03,575,12805,112,3202,463,9603,0,0,217,5428,352,3700,218,9128,California
Calaveras,2021-03-04,762,13567,76,3278,685,10288,1,1,352,5383,400,4100,355,9483,California
Calaveras,2021-03-05,466,14033,273,3551,189,10477,4,5,146,5230,303,4403,150,9633,California
Calaveras,2021-03-06,158,14191,44,3595,108,10585,6,11,116,5311,42,4445,123,9756,California
Calaveras,2021-03-07,82,14273,32,3627,42,10627,8,19,38,5313,44,4489,46,9802,California
Calaveras,2021-03-08,172,14445,34,3661,130,10757,8,27,132,5415,38,4527,140,9942,California
Calaveras,2021-03-09,384,14829,145,3806,233,10990,6,33,35,5117,339,4866,41,9983,California
Calaveras,2021-03-10,436,15265,36,3842,397,11387,3,36,61,4821,360,5226,64,10047,California
Calaveras,2021-03-11,884,16149,440,4282,431,11818,13,49,436,4844,428,5654,451,10498,California
Calaveras,2021-03-12,431,16580,222,4504,200,12018,9,58,325,5085,103,5757,344,10842,California
Calaveras,2021-03-13,192,16772,18,4522,166,12184,8,66,140,5187,50,5807,152,10994,California
Calaveras,2021-03-14,159,16931,11,4533,147,12331,1,67,16,5067,143,5950,23,11017,California
Calaveras,2021-03-15,335,17266,48,4581,261,12592,26,93,56,4875,278,6228,86,11103,California
Calaveras,2021-03-16,706,17972,564,5145,122,12714,20,113,555,5301,149,6377,575,11678,California
Calaveras,2021-03-17,287,18259,49,5194,224,12938,14,127,49,5134,231,6608,64,11742,California
Calaveras,2021-03-18,676,18935,576,5770,84,13022,16,143,549,5576,126,6734,568,12310,California
Calaveras,2021-03-19,238,19173,52,5822,111,13133,75,218,59,5533,175,6909,132,12442,California
Calaveras,2021-03-20,80,19253,23,5845,56,13189,1,219,23,5501,57,6966,25,12467,California
Calaveras,2021-03-21,46,19299,29,5874,6,13195,11,230,8,5484,37,7003,20,12487,California
Calaveras,2021-03-22,84,19383,39,5913,24,13219,21,251,27,5476,56,7059,48,12535,California
Calaveras,2021-03-23,301,19684,209,6122,82,13301,10,261,120,5436,169,7228,129,12664,California
Calaveras,2021-03-24,139,19823,52,6174,77,13378,10,271,45,5400,91,7319,55,12719,California
Calaveras,2021-03-25,756,20579,109,6283,643,14021,4,275,453,5565,292,7611,457,13176,California
Calaveras,2021-03-26,441,21020,29,6312,405,14426,7,282,90,5320,343,7954,98,13274,California
Calaveras,2021-03-27,212,21232,21,6333,187,14613,4,286,36,5189,173,8127,42,13316,California
Calaveras,2021-03-28,111,21343,11,6344,97,14710,3,289,7,5096,103,8230,10,13326,California
Calaveras,2021-03-29,185,21528,23,6367,159,14869,3,292,57,5035,122,8352,61,13387,California
Calaveras,2021-03-30,543,22071,26,6393,501,15370,16,308,363,5235,180,8532,380,13767,California
Calaveras,2021-03-31,327,22398,144,6537,173,15543,10,318,157,5236,167,8699,168,13935,California
Calaveras,2021-04-01,699,23097,449,6986,249,15792,1,319,182,4912,511,9210,187,14122,California
Calaveras,2021-04-02,398,23495,231,7217,159,15951,8,327,112,4757,277,9487,122,14244,California
Calaveras,2021-04-03,146,23641,35,7252,107,16058,4,331,41,4697,105,9592,45,14289,California
Calaveras,2021-04-04,83,23724,27,7279,56,16114,0,331,51,4716,32,9624,51,14340,California
Calaveras,2021-04-05,215,23939,82,7361,124,16238,9,340,99,4708,116,9740,108,14448,California
Calaveras,2021-04-06,667,24606,584,7945,68,16306,15,355,114,4288,549,10289,129,14577,California
Calaveras,2021-04-07,760,25366,662,8607,60,16366,38,393,620,4808,139,10428,659,15236,California
Calaveras,2021-04-08,954,26320,862,9469,70,16436,22,415,435,4751,515,10943,458,15694,California
Calaveras,2021-04-09,158,26478,60,9529,49,16485,49,464,55,4755,99,11042,103,15797,California
Calaveras,2021-04-10,200,26678,44,9573,137,16622,19,483,150,4876,49,11091,170,15967,California
Calaveras,2021-04-11,68,26746,45,9618,21,16643,2,485,50,4909,18,11109,51,16018,California
Calaveras,2021-04-12,104,26850,45,9663,41,16684,18,503,55,4934,49,11158,74,16092,California
Calaveras,2021-04-13,428,27278,372,10035,56,16740,0,503,367,5243,60,11218,369,16461,California
Calaveras,2021-04-14,187,27465,30,10065,157,16897,0,503,136,5330,50,11268,137,16598,California
Calaveras,2021-04-15,335,27800,284,10349,51,16948,0,503,244,5489,85,11353,244,16842,California
Calaveras,2021-04-16,107,27907,30,10379,77,17025,0,503,49,5487,51,11404,49,16891,California
Calaveras,2021-04-17,334,28241,128,10507,206,17231,0,503,291,5735,43,11447,291,17182,California
Calaveras,2021-04-18,18,28259,6,10513,12,17243,0,503,12,5741,6,11453,12,17194,California
Calaveras,2021-04-19,77,28336,26,10539,51,17294,0,503,44,5754,32,11485,45,17239,California
Calaveras,2021-04-20,269,28605,92,10631,177,17471,0,503,195,5881,68,11553,195,17434,California
Calaveras,2021-04-21,218,28823,146,10777,72,17543,0,503,83,5833,132,11685,84,17518,California
Calaveras,2021-04-22,549,29372,97,10874,452,17995,0,503,144,5578,401,12086,146,17664,California
Calaveras,2021-04-23,160,29532,79,10953,81,18076,0,503,64,5549,93,12179,64,17728,California
Calaveras,2021-04-24,172,29704,37,10990,135,18211,0,503,128,5635,43,12222,129,17857,California
Calaveras,2021-04-25,43,29747,27,11017,16,18227,0,503,23,5640,20,12242,25,17882,California
Calaveras,2021-04-26,118,29865,74,11091,44,18271,0,503,34,5592,83,12325,35,17917,California
Calaveras,2021-04-27,445,30310,73,11164,359,18630,13,516,55,5276,384,12709,68,17985,California
Calaveras,2021-04-28,653,30963,584,11748,38,18668,31,547,57,4780,591,13300,95,18080,California
Calaveras,2021-04-29,521,31484,445,12193,57,18725,19,566,70,4426,447,13747,93,18173,California
Calaveras,2021-04-30,160,31644,64,12257,90,18815,6,572,73,4426,84,13831,84,18257,California
Calaveras,2021-05-01,205,31849,113,12370,89,18904,3,575,136,4502,66,13897,142,18399,California
Calaveras,2021-05-02,52,31901,35,12405,16,18920,1,576,18,4490,32,13929,20,18419,California
Calaveras,2021-05-03,95,31996,70,12475,20,18940,5,581,30,4466,64,13993,40,18459,California
Calaveras,2021-05-04,421,32417,329,12804,55,18995,37,618,45,4175,374,14367,83,18542,California
Calaveras,2021-05-05,112,32529,57,12861,22,19017,33,651,49,4195,61,14428,81,18623,California
Calaveras,2021-05-06,258,32787,194,13055,40,19057,24,675,49,4062,207,14635,74,18697,California
Calaveras,2021-05-07,87,32874,23,13078,58,19115,6,681,57,4095,30,14665,63,18760,California
Calaveras,2021-05-08,293,33167,143,13221,147,19262,3,684,91,3991,198,14863,94,18854,California
Calaveras,2021-05-09,28,33195,12,13233,13,19275,3,687,13,3992,15,14878,16,18870,California
Calaveras,2021-05-10,65,33260,30,13263,34,19309,1,688,28,3987,35,14913,30,18900,California
Calaveras,2021-05-11,136,33396,90,13353,33,19342,13,701,96,4058,39,14952,110,19010,California
Calaveras,2021-05-12,171,33567,49,13402,122,19464,0,701,53,3995,117,15069,54,19064,California
Calaveras,2021-05-13,121,33688,65,13467,41,19505,15,716,65,4022,54,15123,81,19145,California
Calaveras,2021-05-14,149,33837,93,13560,53,19558,3,719,99,4075,49,15172,102,19247,California
Calaveras,2021-05-15,267,34104,96,13656,168,19726,3,722,106,4029,155,15327,109,19356,California
Calaveras,2021-05-16,30,34134,12,13668,18,19744,0,722,14,4028,16,15343,15,19371,California
Calaveras,2021-05-17,90,34224,42,13710,41,19785,7,729,47,4041,42,15385,55,19426,California
Calaveras,2021-05-18,229,34453,65,13775,142,19927,22,751,75,3985,153,15538,97,19523,California
Calaveras,2021-05-19,153,34606,66,13841,83,20010,4,755,72,3982,80,15618,77,19600,California
Calaveras,2021-05-20,203,34809,80,13921,97,20107,26,781,67,3941,133,15751,92,19692,California
Calaveras,2021-05-21,101,34910,57,13978,40,20147,4,785,60,3964,40,15791,63,19755,California
Calaveras,2021-05-22,302,35212,160,14138,142,20289,0,785,149,3961,152,15943,149,19904,California
Calaveras,2021-05-23,29,35241,14,14152,15,20304,0,785,12,3956,17,15960,12,19916,California
Calaveras,2021-05-24,76,35317,40,14192,20,20324,16,801,32,3961,44,16004,49,19965,California
Calaveras,2021-05-25,124,35441,49,14241,59,20383,16,817,57,3967,67,16071,73,20038,California
Calaveras,2021-05-26,122,35563,88,14329,30,20413,4,821,84,4017,37,16108,87,20125,California
Calaveras,2021-05-27,86,35649,44,14373,38,20451,4,825,30,3999,53,16161,35,20160,California
Calaveras,2021-05-28,83,35732,43,14416,36,20487,4,829,38,3996,45,16206,42,20202,California
Calaveras,2021-05-29,70,35802,24,14440,41,20528,5,834,33,3998,37,16243,39,20241,California
Calaveras,2021-05-30,36,35838,14,14454,17,20545,5,839,11,3989,25,16268,16,20257,California
Calaveras,2021-05-31,5,35843,0,14454,3,20548,2,841,0,3986,5,16273,2,20259,California
Calaveras,2021-06-01,148,35991,99,14553,43,20591,6,847,45,3934,103,16376,51,20310,California
Calaveras,2021-06-02,85,36076,55,14608,26,20617,4,851,37,3927,48,16424,41,20351,California
Calaveras,2021-06-03,93,36169,55,14663,31,20648,7,858,42,3929,49,16473,51,20402,California
Calaveras,2021-06-04,140,36309,93,14756,35,20683,12,870,36,3874,103,16576,48,20450,California
Calaveras,2021-06-05,86,36395,29,14785,55,20738,2,872,34,3859,51,16627,36,20486,California
Calaveras,2021-06-06,38,36433,27,14812,9,20747,2,874,20,3863,18,16645,22,20508,California
Calaveras,2021-06-07,62,36495,45,14857,9,20756,8,882,25,3860,36,16681,33,20541,California
Calaveras,2021-06-08,126,36621,81,14938,39,20795,6,888,58,3856,68,16749,64,20605,California
Calaveras,2021-06-09,95,36716,51,14989,38,20833,6,894,30,3829,65,16814,38,20643,California
Calaveras,2021-06-10,118,36834,58,15047,51,20884,9,903,41,3804,75,16889,50,20693,California
Calaveras,2021-06-11,105,36939,61,15108,39,20923,5,908,34,3772,71,16960,39,20732,California
Calaveras,2021-06-12,62,37001,36,15144,24,20947,2,910,19,3751,43,17003,22,20754,California
Calaveras,2021-06-13,31,37032,18,15162,9,20956,4,914,8,3740,23,17026,12,20766,California
Calaveras,2021-06-14,60,37092,40,15202,16,20972,4,918,23,3732,37,17063,29,20795,California
Calaveras,2021-06-15,93,37185,57,15259,27,20999,9,927,24,3698,68,17131,34,20829,California
Calaveras,2021-06-16,180,37365,139,15398,27,21026,14,941,39,3611,140,17271,53,20882,California
Calaveras,2021-06-17,60,37425,33,15431,23,21049,4,945,25,3608,32,17303,29,20911,California
Calaveras,2021-06-18,61,37486,41,15472,16,21065,4,949,25,3601,36,17339,29,20940,California
Calaveras,2021-06-19,66,37552,23,15495,26,21091,17,966,23,3598,43,17382,40,20980,California
Calaveras,2021-06-20,5,37557,2,15497,2,21093,1,967,1,3596,4,17386,2,20982,California
Calaveras,2021-06-21,39,37596,15,15512,18,21111,6,973,24,3612,15,17401,31,21013,California
Calaveras,2021-06-22,63,37659,32,15544,29,21140,2,975,28,3610,33,17434,31,21044,California
Calaveras,2021-06-23,65,37724,39,15583,19,21159,7,982,31,3614,34,17468,38,21082,California
Calaveras,2021-06-24,69,37793,37,15620,30,21189,2,984,35,3617,34,17502,37,21119,California
Calaveras,2021-06-25,54,37847,34,15654,12,21201,8,992,24,3619,30,17532,32,21151,California
Calaveras,2021-06-26,34,37881,17,15671,15,21216,2,994,20,3628,14,17546,23,21174,California
Calaveras,2021-06-27,18,37899,16,15687,1,21217,1,995,8,3627,10,17556,9,21183,California
Calaveras,2021-06-28,45,37944,28,15715,12,21229,5,1000,18,3625,26,17582,24,21207,California
Calaveras,2021-06-29,61,38005,48,15763,10,21239,3,1003,28,3625,31,17613,31,21238,California
Calaveras,2021-06-30,44,38049,27,15790,8,21247,9,1012,22,3634,22,17635,31,21269,California
Calaveras,2021-07-01,40,38089,24,15814,11,21258,5,1017,20,3640,19,17654,25,21294,California
Calaveras,2021-07-02,42,38131,32,15846,8,21266,2,1019,25,3650,17,17671,27,21321,California
Calaveras,2021-07-03,21,38152,15,15861,5,21271,1,1020,12,3654,9,17680,13,21334,California
Calaveras,2021-07-04,3,38155,1,15862,2,21273,0,1020,3,3657,0,17680,3,21337,California
Calaveras,2021-07-05,25,38180,15,15877,7,21280,3,1023,5,3646,20,17700,9,21346,California
Calaveras,2021-07-06,66,38246,27,15904,23,21303,16,1039,33,3663,33,17733,50,21396,California
Calaveras,2021-07-07,43,38289,25,15929,14,21317,4,1043,21,3667,21,17754,25,21421,California
Calaveras,2021-07-08,54,38343,19,15948,30,21347,5,1048,26,3671,27,17781,31,21452,California
Calaveras,2021-07-09,34,38377,18,15966,12,21359,4,1052,18,3677,16,17797,22,21474,California
Calaveras,2021-07-10,41,38418,27,15993,12,21371,2,1054,24,3687,17,17814,27,21501,California
Calaveras,2021-07-11,20,38438,12,16005,7,21378,1,1055,15,3698,5,17819,16,21517,California
Calaveras,2021-07-12,38,38476,19,16024,19,21397,0,1055,21,3702,17,17836,21,21538,California
Calaveras,2021-07-13,37,38513,18,16042,18,21415,1,1056,19,3705,17,17853,20,21558,California
Calaveras,2021-07-14,38,38551,27,16069,11,21426,0,1056,20,3708,17,17870,20,21578,California
Calaveras,2021-07-15,42,38593,29,16098,12,21438,1,1057,27,3722,14,17884,28,21606,California
Calaveras,2021-07-16,41,38634,32,16130,9,21447,0,1057,25,3732,15,17899,25,21631,California
Calaveras,2021-07-17,33,38667,14,16144,13,21460,6,1063,15,3736,17,17916,21,21652,California
Calaveras,2021-07-18,32,38699,22,16166,7,21467,3,1066,23,3753,9,17925,26,21678,California
Calaveras,2021-07-19,38,38737,18,16184,16,21483,4,1070,20,3759,18,17943,24,21702,California
Calaveras,2021-07-20,44,38781,30,16214,11,21494,3,1073,27,3772,17,17960,30,21732,California
Calaveras,2021-07-21,55,38836,31,16245,20,21514,4,1077,33,3787,22,17982,37,21769,California
Calaveras,2021-07-22,57,38893,22,16267,24,21538,11,1088,25,3794,30,18012,37,21806,California
Calaveras,2021-07-23,74,38967,51,16318,19,21557,4,1092,44,3814,30,18042,50,21856,California
Calaveras,2021-07-24,40,39007,19,16337,21,21578,0,1092,23,3821,16,18058,23,21879,California
Calaveras,2021-07-25,27,39034,18,16355,5,21583,4,1096,19,3836,8,18066,23,21902,California
Calaveras,2021-07-26,56,39090,30,16385,26,21609,0,1096,39,3858,17,18083,39,21941,California
Calaveras,2021-07-27,64,39154,37,16422,26,21635,1,1097,42,3879,22,18105,43,21984,California
Calaveras,2021-07-28,44,39198,17,16439,22,21657,5,1102,32,3904,12,18117,37,22021,California
Calaveras,2021-07-29,53,39251,26,16465,22,21679,5,1107,34,3924,19,18136,39,22060,California
Calaveras,2021-07-30,75,39326,48,16513,21,21700,6,1113,47,3952,27,18163,55,22115,California
Calaveras,2021-07-31,21,39347,12,16525,8,21708,1,1114,8,3948,13,18176,9,22124,California
Colusa,2020-12-18,1,1,1,1,0,0,0,0,1,1,0,0,1,1,California
Colusa,2020-12-21,2,3,2,3,0,0,0,0,2,3,0,0,2,3,California
Colusa,2020-12-22,10,13,10,13,0,0,0,0,10,13,0,0,10,13,California
Colusa,2020-12-23,10,23,10,23,0,0,0,0,10,23,0,0,10,23,California
Colusa,2020-12-24,2,25,1,24,1,1,0,0,2,25,0,0,2,25,California
Colusa,2020-12-27,1,26,1,25,0,1,0,0,1,26,0,0,1,26,California
Colusa,2020-12-28,7,33,3,28,4,5,0,0,7,33,0,0,7,33,California
Colusa,2020-12-29,9,42,7,35,2,7,0,0,9,42,0,0,9,42,California
Colusa,2020-12-30,51,93,14,49,37,44,0,0,51,93,0,0,51,93,California
Colusa,2020-12-31,18,111,1,50,17,61,0,0,18,111,0,0,18,111,California
Colusa,2021-01-04,3,114,0,50,3,64,0,0,3,114,0,0,3,114,California
Colusa,2021-01-05,68,182,1,51,67,131,0,0,68,182,0,0,68,182,California
Colusa,2021-01-06,15,197,9,60,6,137,0,0,15,197,0,0,15,197,California
Colusa,2021-01-07,40,237,5,65,35,172,0,0,39,235,1,1,39,236,California
Colusa,2021-01-08,9,246,7,72,2,174,0,0,8,242,1,2,8,244,California
Colusa,2021-01-09,2,248,1,73,1,175,0,0,2,244,0,2,2,246,California
Colusa,2021-01-10,1,249,0,73,1,176,0,0,1,245,0,2,1,247,California
Colusa,2021-01-11,12,261,6,79,6,182,0,0,7,247,5,7,7,254,California
Colusa,2021-01-12,11,272,9,88,2,184,0,0,6,248,5,12,6,260,California
Colusa,2021-01-13,20,292,13,101,7,191,0,0,12,252,8,20,12,272,California
Colusa,2021-01-14,35,327,29,130,6,197,0,0,33,283,2,22,33,305,California
Colusa,2021-01-15,44,371,5,135,39,236,0,0,42,323,2,24,42,347,California
Colusa,2021-01-16,12,383,1,136,11,247,0,0,11,333,1,25,11,358,California
Colusa,2021-01-17,2,385,1,137,1,248,0,0,2,335,0,25,2,360,California
Colusa,2021-01-18,4,389,0,137,4,252,0,0,4,339,0,25,4,364,California
Colusa,2021-01-19,9,398,8,145,1,253,0,0,5,340,4,29,5,369,California
Colusa,2021-01-20,112,510,100,245,12,265,0,0,98,424,14,43,98,467,California
Colusa,2021-01-21,68,578,53,298,15,280,0,0,67,490,1,44,67,534,California
Colusa,2021-01-22,35,613,17,315,18,298,0,0,30,515,5,49,30,564,California
Colusa,2021-01-23,34,647,6,321,28,326,0,0,34,549,0,49,34,598,California
Colusa,2021-01-25,7,654,0,321,7,333,0,0,7,556,0,49,7,605,California
Colusa,2021-01-26,8,662,5,326,3,336,0,0,5,558,3,52,5,610,California
Colusa,2021-01-27,110,772,31,357,79,415,0,0,108,664,2,54,108,718,California
Colusa,2021-01-28,105,877,48,405,57,472,0,0,74,707,31,85,74,792,California
Colusa,2021-01-29,45,922,12,417,33,505,0,0,39,740,6,91,39,831,California
Colusa,2021-01-30,27,949,4,421,23,528,0,0,27,767,0,91,27,858,California
Colusa,2021-01-31,7,956,7,428,0,528,0,0,7,774,0,91,7,865,California
Colusa,2021-02-01,27,983,10,438,17,545,0,0,22,791,5,96,22,887,California
Colusa,2021-02-02,44,1027,9,447,35,580,0,0,37,821,7,103,37,924,California
Colusa,2021-02-03,75,1102,11,458,64,644,0,0,63,872,12,115,63,987,California
Colusa,2021-02-04,150,1252,82,540,68,712,0,0,116,954,34,149,116,1103,California
Colusa,2021-02-05,29,1281,9,549,20,732,0,0,26,977,3,152,26,1129,California
Colusa,2021-02-06,279,1560,9,558,270,1002,0,0,268,1234,11,163,268,1397,California
Colusa,2021-02-07,2,1562,1,559,1,1003,0,0,0,1232,2,165,0,1397,California
Colusa,2021-02-08,42,1604,5,564,37,1040,0,0,39,1268,3,168,39,1436,California
Colusa,2021-02-09,229,1833,14,578,215,1255,0,0,175,1389,54,222,175,1611,California
Colusa,2021-02-10,115,1948,42,620,73,1328,0,0,72,1418,43,265,72,1683,California
Colusa,2021-02-11,106,2054,43,663,63,1391,0,0,80,1472,26,291,80,1763,California
Colusa,2021-02-12,118,2172,9,672,109,1500,0,0,77,1507,42,333,77,1840,California
Colusa,2021-02-13,60,2232,8,680,52,1552,0,0,52,1551,8,341,52,1892,California
Colusa,2021-02-14,20,2252,8,688,12,1564,0,0,14,1559,6,347,14,1906,California
Colusa,2021-02-15,47,2299,10,698,37,1601,0,0,40,1592,7,354,40,1946,California
Colusa,2021-02-16,70,2369,4,702,66,1667,0,0,69,1660,1,355,69,2015,California
Colusa,2021-02-17,205,2574,142,844,63,1730,0,0,61,1577,144,499,61,2076,California
Colusa,2021-02-18,142,2716,40,884,102,1832,0,0,118,1671,24,523,118,2194,California
Colusa,2021-02-19,153,2869,19,903,134,1966,0,0,132,1782,21,544,132,2326,California
Colusa,2021-02-20,30,2899,5,908,25,1991,0,0,12,1776,18,562,12,2338,California
Colusa,2021-02-21,4,2903,2,910,2,1993,0,0,2,1776,2,564,2,2340,California
Colusa,2021-02-22,45,2948,27,937,18,2011,0,0,30,1791,15,579,30,2370,California
Colusa,2021-02-23,21,2969,6,943,15,2026,0,0,17,1804,4,583,17,2387,California
Colusa,2021-02-24,312,3281,57,1000,255,2281,0,0,159,1810,153,736,159,2546,California
Colusa,2021-02-25,122,3403,67,1067,55,2336,0,0,82,1852,40,776,82,2628,California
Colusa,2021-02-26,98,3501,14,1081,84,2420,0,0,58,1870,40,816,58,2686,California
Colusa,2021-02-27,58,3559,5,1086,53,2473,0,0,42,1896,16,832,42,2728,California
Colusa,2021-02-28,29,3588,16,1102,13,2486,0,0,20,1907,9,841,20,2748,California
Colusa,2021-03-01,48,3636,16,1118,32,2518,0,0,29,1917,19,860,29,2777,California
Colusa,2021-03-02,54,3690,12,1130,42,2560,0,0,26,1915,28,888,26,2803,California
Colusa,2021-03-03,263,3953,47,1177,216,2776,0,0,193,2038,70,958,193,2996,California
Colusa,2021-03-04,149,4102,60,1237,89,2865,0,0,78,2045,71,1029,78,3074,California
Colusa,2021-03-05,107,4209,25,1262,73,2938,9,9,54,2055,53,1082,63,3137,California
Colusa,2021-03-06,270,4479,9,1271,261,3199,0,9,39,1863,231,1313,39,3176,California
Colusa,2021-03-07,9,4488,5,1276,4,3203,0,9,7,1868,2,1315,7,3183,California
Colusa,2021-03-08,110,4598,22,1298,53,3256,35,44,48,1890,61,1376,83,3266,California
Colusa,2021-03-09,287,4885,74,1372,190,3446,23,67,95,1816,192,1568,118,3384,California
Colusa,2021-03-10,309,5194,38,1410,235,3681,36,103,211,1965,98,1666,247,3631,California
Colusa,2021-03-11,432,5626,61,1471,350,4031,21,124,335,2222,97,1763,354,3985,California
Colusa,2021-03-12,109,5735,18,1489,79,4110,12,136,20,2165,89,1852,32,4017,California
Colusa,2021-03-13,65,5800,13,1502,43,4153,9,145,19,2147,46,1898,28,4045,California
Colusa,2021-03-14,23,5823,0,1502,21,4174,2,147,7,2141,15,1913,9,4054,California
Colusa,2021-03-15,82,5905,28,1530,46,4220,8,155,24,2115,58,1971,32,4086,California
Colusa,2021-03-16,299,6204,16,1546,237,4457,46,201,189,2240,110,2081,235,4321,California
Colusa,2021-03-17,196,6400,50,1596,146,4603,0,201,108,2260,88,2169,108,4429,California
Colusa,2021-03-18,326,6726,39,1635,217,4820,70,271,191,2387,135,2304,262,4691,California
Colusa,2021-03-19,78,6804,19,1654,57,4877,2,273,51,2413,27,2331,53,4744,California
Colusa,2021-03-20,53,6857,9,1663,43,4920,1,274,39,2439,14,2345,40,4784,California
Colusa,2021-03-21,6,6863,4,1667,2,4922,0,274,1,2435,5,2350,1,4785,California
Colusa,2021-03-22,63,6926,10,1677,44,4966,9,283,41,2463,22,2372,50,4835,California
Colusa,2021-03-23,81,7007,16,1693,63,5029,2,285,54,2492,27,2399,56,4891,California
Colusa,2021-03-24,339,7346,56,1749,277,5306,6,291,65,2288,274,2673,70,4961,California
Colusa,2021-03-25,118,7464,71,1820,42,5348,5,296,58,2291,60,2733,63,5024,California
Colusa,2021-03-26,298,7762,49,1869,245,5593,4,300,245,2487,53,2786,249,5273,California
Colusa,2021-03-27,63,7825,5,1874,58,5651,0,300,24,2472,39,2825,24,5297,California
Colusa,2021-03-28,16,7841,7,1881,9,5660,0,300,6,2468,10,2835,6,5303,California
Colusa,2021-03-29,73,7914,21,1902,46,5706,6,306,32,2465,41,2876,38,5341,California
Colusa,2021-03-30,148,8062,83,1985,63,5769,2,308,68,2455,80,2956,70,5411,California
Colusa,2021-03-31,232,8294,38,2023,194,5963,0,308,63,2350,168,3124,63,5474,California
Colusa,2021-04-01,446,8740,80,2103,311,6274,55,363,320,2599,125,3249,374,5848,California
Colusa,2021-04-02,82,8822,16,2119,52,6326,14,377,38,2607,44,3293,52,5900,California
Colusa,2021-04-03,61,8883,9,2128,29,6355,23,400,14,2596,47,3340,36,5936,California
Colusa,2021-04-04,18,8901,0,2128,8,6363,10,410,3,2594,15,3355,13,5949,California
Colusa,2021-04-05,101,9002,27,2155,57,6420,17,427,36,2581,65,3420,52,6001,California
Colusa,2021-04-06,131,9133,34,2189,46,6466,51,478,36,2573,95,3515,87,6088,California
Colusa,2021-04-07,357,9490,42,2231,292,6758,23,501,124,2489,232,3747,148,6236,California
Colusa,2021-04-08,430,9920,36,2267,367,7125,27,528,121,2331,306,4053,148,6384,California
Colusa,2021-04-09,78,9998,22,2289,32,7157,24,552,28,2333,50,4103,52,6436,California
Colusa,2021-04-10,46,10044,9,2298,16,7173,21,573,10,2328,36,4139,31,6467,California
Colusa,2021-04-11,17,10061,3,2301,12,7185,2,575,8,2329,9,4148,10,6477,California
Colusa,2021-04-12,31,10092,3,2304,28,7213,0,575,14,2326,17,4165,14,6491,California
Colusa,2021-04-13,282,10374,22,2326,260,7473,0,575,95,2235,186,4351,95,6586,California
Colusa,2021-04-14,94,10468,19,2345,75,7548,0,575,31,2203,63,4414,31,6617,California
Colusa,2021-04-15,329,10797,49,2394,280,7828,0,575,124,2123,205,4619,125,6742,California
Colusa,2021-04-16,81,10878,13,2407,68,7896,0,575,36,2115,44,4663,36,6778,California
Colusa,2021-04-17,54,10932,7,2414,47,7943,0,575,30,2121,24,4687,30,6808,California
Colusa,2021-04-18,9,10941,2,2416,7,7950,0,575,7,2126,2,4689,7,6815,California
Colusa,2021-04-19,62,11003,22,2438,40,7990,0,575,16,2096,46,4735,16,6831,California
Colusa,2021-04-20,186,11189,36,2474,150,8140,0,575,131,2172,55,4790,131,6962,California
Colusa,2021-04-21,186,11375,75,2549,111,8251,0,575,112,2210,74,4864,112,7074,California
Colusa,2021-04-22,422,11797,27,2576,394,8645,1,576,221,2231,200,5064,221,7295,California
Colusa,2021-04-23,97,11894,24,2600,73,8718,0,576,37,2208,60,5124,37,7332,California
Colusa,2021-04-24,239,12133,17,2617,221,8939,1,577,210,2389,29,5153,210,7542,California
Colusa,2021-04-25,12,12145,6,2623,6,8945,0,577,8,2393,4,5157,8,7550,California
Colusa,2021-04-26,25,12170,5,2628,19,8964,1,578,6,2381,18,5175,6,7556,California
Colusa,2021-04-27,95,12265,25,2653,66,9030,4,582,44,2378,51,5226,48,7604,California
Colusa,2021-04-28,196,12461,34,2687,159,9189,3,585,142,2470,53,5279,145,7749,California
Colusa,2021-04-29,325,12786,30,2717,291,9480,4,589,48,2247,275,5554,52,7801,California
Colusa,2021-04-30,69,12855,24,2741,45,9525,0,589,47,2272,22,5576,47,7848,California
Colusa,2021-05-01,19,12874,8,2749,8,9533,3,592,9,2274,10,5586,12,7860,California
Colusa,2021-05-02,5,12879,1,2750,3,9536,1,593,2,2274,3,5589,3,7863,California
Colusa,2021-05-03,32,12911,8,2758,24,9560,0,593,15,2272,17,5606,15,7878,California
Colusa,2021-05-04,97,13008,54,2812,42,9602,1,594,68,2312,29,5635,69,7947,California
Colusa,2021-05-05,84,13092,21,2833,62,9664,1,595,35,2299,49,5684,36,7983,California
Colusa,2021-05-06,257,13349,17,2850,238,9902,2,597,111,2266,146,5830,113,8096,California
Colusa,2021-05-07,69,13418,4,2854,60,9962,5,602,31,2265,37,5867,36,8132,California
Colusa,2021-05-08,20,13438,6,2860,14,9976,0,602,9,2263,11,5878,9,8141,California
Colusa,2021-05-09,13,13451,5,2865,5,9981,3,605,6,2265,7,5885,9,8150,California
Colusa,2021-05-10,26,13477,6,2871,20,10001,0,605,9,2257,17,5902,9,8159,California
Colusa,2021-05-11,94,13571,33,2904,61,10062,0,605,48,2259,46,5948,48,8207,California
Colusa,2021-05-12,82,13653,36,2940,42,10104,4,609,21,2223,61,6009,25,8232,California
Colusa,2021-05-13,251,13904,23,2963,227,10331,1,610,79,2131,172,6181,80,8312,California
Colusa,2021-05-14,95,13999,18,2981,62,10393,15,625,33,2118,61,6242,48,8360,California
Colusa,2021-05-15,40,14039,10,2991,28,10421,2,627,20,2120,20,6262,22,8382,California
Colusa,2021-05-16,21,14060,5,2996,9,10430,7,634,8,2122,13,6275,15,8397,California
Colusa,2021-05-17,27,14087,6,3002,19,10449,2,636,15,2127,12,6287,17,8414,California
Colusa,2021-05-18,101,14188,27,3029,72,10521,2,638,46,2120,55,6342,48,8462,California
Colusa,2021-05-19,224,14412,44,3073,160,10681,20,658,66,2048,158,6500,86,8548,California
Colusa,2021-05-20,287,14699,36,3109,247,10928,4,662,68,1901,219,6719,72,8620,California
Colusa,2021-05-21,80,14779,26,3135,52,10980,2,664,35,1893,45,6764,37,8657,California
Colusa,2021-05-22,222,15001,24,3159,197,11177,1,665,34,1740,188,6952,35,8692,California
Colusa,2021-05-23,19,15020,8,3167,7,11184,4,669,5,1735,14,6966,9,8701,California
Colusa,2021-05-24,30,15050,3,3170,22,11206,5,674,16,1742,14,6980,21,8722,California
Colusa,2021-05-25,137,15187,77,3247,58,11264,2,676,54,1715,83,7063,56,8778,California
Colusa,2021-05-26,73,15260,25,3272,47,11311,1,677,32,1707,41,7104,33,8811,California
Colusa,2021-05-27,170,15430,17,3289,153,11464,0,677,54,1645,116,7220,54,8865,California
Colusa,2021-05-28,80,15510,25,3314,54,11518,1,678,41,1648,39,7259,42,8907,California
Colusa,2021-05-29,40,15550,18,3332,18,11536,4,682,29,1670,11,7270,33,8940,California
Colusa,2021-05-30,8,15558,1,3333,2,11538,5,687,1,1669,7,7277,6,8946,California
Colusa,2021-05-31,4,15562,0,3333,4,11542,0,687,1,1667,3,7280,1,8947,California
Colusa,2021-06-01,49,15611,15,3348,33,11575,1,688,25,1669,24,7304,26,8973,California
Colusa,2021-06-02,146,15757,20,3368,124,11699,2,690,51,1628,94,7398,53,9026,California
Colusa,2021-06-03,61,15818,19,3387,41,11740,1,691,26,1623,32,7430,27,9053,California
Colusa,2021-06-04,59,15877,19,3406,38,11778,2,693,22,1610,37,7467,24,9077,California
Colusa,2021-06-05,35,15912,16,3422,18,11796,1,694,17,1610,18,7485,18,9095,California
Colusa,2021-06-06,10,15922,5,3427,4,11800,1,695,6,1613,4,7489,7,9102,California
Colusa,2021-06-07,25,15947,7,3434,18,11818,0,695,10,1608,15,7504,10,9112,California
Colusa,2021-06-08,76,16023,21,3455,55,11873,0,695,29,1590,47,7551,29,9141,California
Colusa,2021-06-09,71,16094,41,3496,30,11903,0,695,28,1575,43,7594,28,9169,California
Colusa,2021-06-10,59,16153,24,3520,32,11935,3,698,15,1549,44,7638,18,9187,California
Colusa,2021-06-11,57,16210,30,3550,27,11962,0,698,25,1542,32,7670,25,9212,California
Colusa,2021-06-12,37,16247,23,3573,14,11976,0,698,9,1523,28,7698,9,9221,California
Colusa,2021-06-13,10,16257,3,3576,5,11981,2,700,2,1519,8,7706,4,9225,California
Colusa,2021-06-14,19,16276,9,3585,10,11991,0,700,7,1514,12,7718,7,9232,California
Colusa,2021-06-15,76,16352,37,3622,38,12029,1,701,16,1471,60,7778,17,9249,California
Colusa,2021-06-16,56,16408,16,3638,39,12068,1,702,15,1446,41,7819,16,9265,California
Colusa,2021-06-17,116,16524,10,3648,105,12173,1,703,17,1365,99,7918,18,9283,California
Colusa,2021-06-18,64,16588,32,3680,28,12201,4,707,26,1357,38,7956,30,9313,California
Colusa,2021-06-19,26,16614,21,3701,4,12205,1,708,6,1344,20,7976,7,9320,California
Colusa,2021-06-20,9,16623,6,3707,3,12208,0,708,7,1349,2,7978,7,9327,California
Colusa,2021-06-21,20,16643,3,3710,16,12224,1,709,7,1344,13,7991,8,9335,California
Colusa,2021-06-22,67,16710,28,3738,34,12258,5,714,28,1339,38,8029,33,9368,California
Colusa,2021-06-23,50,16760,27,3765,22,12280,1,715,21,1332,29,8058,22,9390,California
Colusa,2021-06-24,61,16821,28,3793,31,12311,2,717,23,1319,38,8096,25,9415,California
Colusa,2021-06-25,41,16862,16,3809,25,12336,0,717,25,1328,16,8112,25,9440,California
Colusa,2021-06-26,18,16880,13,3822,5,12341,0,717,5,1320,13,8125,5,9445,California
Colusa,2021-06-27,7,16887,4,3826,3,12344,0,717,5,1323,2,8127,5,9450,California
Colusa,2021-06-28,8,16895,1,3827,6,12350,1,718,5,1326,3,8130,6,9456,California
Colusa,2021-06-29,41,16936,17,3844,20,12370,4,722,17,1324,23,8153,21,9477,California
Colusa,2021-06-30,76,17012,37,3881,38,12408,1,723,27,1304,49,8202,29,9506,California
Colusa,2021-07-01,48,17060,23,3904,24,12432,1,724,20,1297,28,8230,21,9527,California
Colusa,2021-07-02,48,17108,26,3930,21,12453,1,725,24,1298,24,8254,25,9552,California
Colusa,2021-07-03,21,17129,8,3938,13,12466,0,725,11,1299,10,8264,11,9563,California
Colusa,2021-07-04,3,17132,2,3940,1,12467,0,725,1,1298,2,8266,1,9564,California
Colusa,2021-07-05,10,17142,6,3946,4,12471,0,725,4,1296,6,8272,4,9568,California
Colusa,2021-07-06,44,17186,18,3964,25,12496,1,726,21,1297,21,8293,22,9590,California
Colusa,2021-07-07,54,17240,30,3994,23,12519,1,727,33,1310,21,8314,34,9624,California
Colusa,2021-07-08,27,17267,12,4006,14,12533,1,728,18,1320,9,8323,19,9643,California
Colusa,2021-07-09,28,17295,20,4026,6,12539,2,730,9,1311,19,8342,10,9653,California
Colusa,2021-07-10,13,17308,6,4032,7,12546,0,730,8,1314,5,8347,8,9661,California
Colusa,2021-07-11,4,17312,4,4036,0,12546,0,730,1,1312,3,8350,1,9662,California
Colusa,2021-07-12,23,17335,10,4046,12,12558,1,731,6,1302,17,8367,7,9669,California
Colusa,2021-07-13,48,17383,27,4073,21,12579,0,731,26,1306,22,8389,26,9695,California
Colusa,2021-07-14,44,17427,21,4094,21,12600,2,733,19,1302,25,8414,21,9716,California
Colusa,2021-07-15,59,17486,33,4127,17,12617,9,742,23,1300,34,8448,32,9748,California
Colusa,2021-07-16,53,17539,36,4163,17,12634,0,742,31,1309,22,8470,31,9779,California
Colusa,2021-07-17,19,17558,13,4176,6,12640,0,742,9,1309,9,8479,9,9788,California
Colusa,2021-07-18,6,17564,3,4179,3,12643,0,742,2,1307,4,8483,2,9790,California
Colusa,2021-07-19,6,17570,0,4179,6,12649,0,742,2,1305,4,8487,2,9792,California
Colusa,2021-07-20,39,17609,16,4195,22,12671,1,743,23,1313,16,8503,24,9816,California
Colusa,2021-07-21,55,17664,36,4231,18,12689,1,744,30,1319,25,8528,31,9847,California
Colusa,2021-07-22,34,17698,20,4251,10,12699,4,748,15,1320,18,8546,19,9866,California
Colusa,2021-07-23,64,17762,44,4295,20,12719,0,748,36,1328,28,8574,36,9902,California
Colusa,2021-07-24,20,17782,14,4309,6,12725,0,748,18,1344,2,8576,18,9920,California
Colusa,2021-07-25,16,17798,11,4320,5,12730,0,748,14,1356,2,8578,14,9934,California
Colusa,2021-07-26,23,17821,13,4333,10,12740,0,748,17,1367,6,8584,17,9951,California
Colusa,2021-07-27,52,17873,32,4365,20,12760,0,748,29,1373,23,8607,29,9980,California
Colusa,2021-07-28,64,17937,40,4405,23,12783,1,749,28,1366,36,8643,29,10009,California
Colusa,2021-07-29,28,17965,19,4424,7,12790,2,751,18,1376,10,8653,20,10029,California
Colusa,2021-07-30,49,18014,34,4458,14,12804,1,752,32,1393,16,8669,33,10062,California
Colusa,2021-07-31,5,18019,3,4461,2,12806,0,752,5,1398,0,8669,5,10067,California
Contra Costa,2020-12-15,19,19,19,19,0,0,0,0,19,19,0,0,19,19,California
Contra Costa,2020-12-16,534,553,534,553,0,0,0,0,534,553,0,0,534,553,California
Contra Costa,2020-12-17,1064,1617,1064,1617,0,0,0,0,1064,1617,0,0,1064,1617,California
Contra Costa,2020-12-18,1801,3418,1799,3416,2,2,0,0,1801,3418,0,0,1801,3418,California
Contra Costa,2020-12-19,1138,4556,1137,4553,1,3,0,0,1138,4556,0,0,1138,4556,California
Contra Costa,2020-12-20,612,5168,611,5164,1,4,0,0,612,5168,0,0,612,5168,California
Contra Costa,2020-12-21,1700,6868,1697,6861,3,7,0,0,1700,6868,0,0,1700,6868,California
Contra Costa,2020-12-22,1708,8576,1596,8457,112,119,0,0,1708,8576,0,0,1708,8576,California
Contra Costa,2020-12-23,1659,10235,1405,9862,254,373,0,0,1659,10235,0,0,1659,10235,California
Contra Costa,2020-12-24,674,10909,347,10209,327,700,0,0,674,10909,0,0,674,10909,California
Contra Costa,2020-12-25,44,10953,19,10228,25,725,0,0,44,10953,0,0,44,10953,California
Contra Costa,2020-12-26,673,11626,140,10368,533,1258,0,0,673,11626,0,0,673,11626,California
Contra Costa,2020-12-27,246,11872,89,10457,157,1415,0,0,246,11872,0,0,246,11872,California
Contra Costa,2020-12-28,1883,13755,882,11339,1001,2416,0,0,1883,13755,0,0,1883,13755,California
Contra Costa,2020-12-29,1884,15639,838,12177,1046,3462,0,0,1884,15639,0,0,1884,15639,California
Contra Costa,2020-12-30,2470,18109,1233,13410,1237,4699,0,0,2468,18106,2,2,2469,18108,California
Contra Costa,2020-12-31,940,19049,311,13721,629,5328,0,0,939,19045,0,2,939,19047,California
Contra Costa,2021-01-01,69,19118,26,13747,43,5371,0,0,69,19114,0,2,69,19116,California
Contra Costa,2021-01-02,353,19471,182,13929,171,5542,0,0,352,19466,0,2,352,19468,California
Contra Costa,2021-01-03,192,19663,130,14059,62,5604,0,0,190,19656,0,2,190,19658,California
Contra Costa,2021-01-04,1925,21588,1255,15314,670,6274,0,0,1906,21545,17,19,1906,21564,California
Contra Costa,2021-01-05,2146,23734,1284,16598,862,7136,0,0,1856,23113,289,308,1857,23421,California
Contra Costa,2021-01-06,3357,27091,2297,18895,1060,8196,0,0,2516,24797,835,1143,2519,25940,California
Contra Costa,2021-01-07,3166,30257,2116,21011,1050,9246,0,0,1820,25275,1342,2485,1820,27760,California
Contra Costa,2021-01-08,3468,33725,2452,23463,1016,10262,0,0,1779,25373,1684,4169,1782,29542,California
Contra Costa,2021-01-09,1619,35344,1158,24621,461,10723,0,0,744,25245,874,5043,746,30288,California
Contra Costa,2021-01-10,389,35733,309,24930,80,10803,0,0,163,25182,226,5269,163,30451,California
Contra Costa,2021-01-11,3906,39639,3205,28135,701,11504,0,0,2238,25755,1668,6937,2241,32692,California
Contra Costa,2021-01-12,4002,43641,3000,31135,1002,12506,0,0,2626,27010,1375,8312,2630,35322,California
Contra Costa,2021-01-13,4859,48500,3022,34157,1837,14343,0,0,3876,29907,980,9292,3877,39199,California
Contra Costa,2021-01-14,4404,52904,1604,35761,2800,17143,0,0,3998,33499,406,9698,3998,43197,California
Contra Costa,2021-01-15,5444,58348,2500,38261,2944,20087,0,0,5111,38282,332,10030,5115,48312,California
Contra Costa,2021-01-16,1790,60138,587,38848,1203,21290,0,0,1703,39898,87,10117,1703,50015,California
Contra Costa,2021-01-17,1685,61823,990,39838,695,21985,0,0,1564,41344,121,10238,1567,51582,California
Contra Costa,2021-01-18,3307,65130,1323,41161,1984,23969,0,0,2662,43368,639,10877,2663,54245,California
Contra Costa,2021-01-19,7158,72288,3213,44374,3945,27914,0,0,6132,48485,1021,11898,6138,60383,California
Contra Costa,2021-01-20,6991,79279,4366,48740,2625,30539,0,0,5727,52957,1260,13158,5732,66115,California
Contra Costa,2021-01-21,7159,86438,3173,51913,3986,34525,0,0,6414,58640,739,13897,6422,72537,California
Contra Costa,2021-01-22,6534,92972,2774,54687,3760,38285,0,0,5641,63399,885,14782,5644,78181,California
Contra Costa,2021-01-23,2095,95067,364,55051,1731,40016,0,0,1820,64948,273,15055,1822,80003,California
Contra Costa,2021-01-24,1656,96723,227,55278,1429,41445,0,0,1502,66300,154,15209,1506,81509,California
Contra Costa,2021-01-25,6795,103518,3074,58352,3721,45166,0,0,5171,69856,1619,16828,5175,86684,California
Contra Costa,2021-01-26,8249,111767,4754,63106,3495,48661,0,0,6344,74309,1897,18725,6350,93034,California
Contra Costa,2021-01-27,8353,120120,5476,68582,2877,51538,0,0,6446,78864,1895,20620,6450,99484,California
Contra Costa,2021-01-28,7617,127737,4131,72713,3486,55024,0,0,5958,83172,1655,22275,5963,105447,California
Contra Costa,2021-01-29,7612,135349,3946,76659,3666,58690,0,0,6259,88086,1347,23622,6261,111708,California
Contra Costa,2021-01-30,2184,137533,659,77318,1525,60215,0,0,1772,89454,404,24026,1772,113480,California
Contra Costa,2021-01-31,684,138217,449,77767,235,60450,0,0,584,89941,97,24123,584,114064,California
Contra Costa,2021-02-01,5926,144143,4102,81869,1824,62274,0,0,3991,92010,1926,26049,3995,118059,California
Contra Costa,2021-02-02,7729,151872,5158,87027,2571,64845,0,0,5991,96269,1733,27782,5992,124051,California
Contra Costa,2021-02-03,8479,160351,5583,92610,2896,67741,0,0,5719,99240,2749,30531,5720,129771,California
Contra Costa,2021-02-04,7689,168040,3650,96260,4039,71780,0,0,5885,103329,1801,32332,5890,135661,California
Contra Costa,2021-02-05,8627,176667,4899,101159,3728,75508,0,0,5872,106455,2746,35078,5872,141533,California
Contra Costa,2021-02-06,3570,180237,2202,103361,1368,76876,0,0,2901,108689,668,35746,2902,144435,California
Contra Costa,2021-02-07,1008,181245,727,104088,281,77157,0,0,604,108890,403,36149,604,145039,California
Contra Costa,2021-02-08,5993,187238,3564,107652,2429,79586,0,0,4435,111776,1550,37699,4436,149475,California
Contra Costa,2021-02-09,8889,196127,4915,112567,3974,83560,0,0,5913,114724,2966,40665,5914,155389,California
Contra Costa,2021-02-10,8857,204984,4776,117343,4081,87641,0,0,5419,116725,3421,44086,5422,160811,California
Contra Costa,2021-02-11,9553,214537,4312,121655,5241,92882,0,0,5265,117715,4280,48366,5270,166081,California
Contra Costa,2021-02-12,10328,224865,4724,126379,5604,98486,0,0,5557,118513,4762,53128,5560,171641,California
Contra Costa,2021-02-13,5012,229877,1412,127791,3600,102086,0,0,3480,120468,1527,54655,3482,175123,California
Contra Costa,2021-02-14,2141,232018,890,128681,1251,103337,0,0,1243,120817,894,55549,1243,176366,California
Contra Costa,2021-02-15,4573,236591,2517,131198,2056,105393,0,0,2366,120987,2197,57746,2367,178733,California
Contra Costa,2021-02-16,10637,247228,5012,136210,5625,111018,0,0,4742,119854,5879,63625,4746,183479,California
Contra Costa,2021-02-17,12590,259818,6323,142533,6267,117285,0,0,5773,118832,6796,70421,5774,189253,California
Contra Costa,2021-02-18,11743,271561,6098,148631,5645,122930,0,0,5402,117912,6324,76745,5404,194657,California
Contra Costa,2021-02-19,11750,283311,7330,155961,4420,127350,0,0,5298,116780,6432,83177,5300,199957,California
Contra Costa,2021-02-20,6710,290021,3061,159022,3649,130999,0,0,4726,119544,1966,85143,4730,204687,California
Contra Costa,2021-02-21,2430,292451,1798,160820,632,131631,0,0,1606,120329,821,85964,1606,206293,California
Contra Costa,2021-02-22,8125,300576,5513,166333,2612,134243,0,0,3740,119706,4366,90330,3743,210036,California
Contra Costa,2021-02-23,12696,313272,7842,174175,4854,139097,0,0,6394,119827,6281,96611,6402,216438,California
Contra Costa,2021-02-24,11210,324482,8244,182419,2966,142063,0,0,5433,119510,5750,102361,5433,221871,California
Contra Costa,2021-02-25,12427,336909,7873,190292,4554,146617,0,0,5715,118549,6683,109044,5722,227593,California
Contra Costa,2021-02-26,11642,348551,7378,197670,4264,150881,0,0,5770,118468,5853,114897,5772,233365,California
Contra Costa,2021-02-27,7270,355821,4697,202367,2573,153454,0,0,4566,120344,2692,117589,4568,237933,California
Contra Costa,2021-02-28,4569,360390,3797,206164,771,154225,1,1,3831,123445,732,118321,3833,241766,California
Contra Costa,2021-03-01,9065,369455,6869,213033,2188,156413,8,9,5608,125636,3428,121749,5619,247385,California
Contra Costa,2021-03-02,11134,380589,7131,220164,4002,160415,1,10,5929,126385,5182,126931,5931,253316,California
Contra Costa,2021-03-03,11802,392391,7453,227617,4348,164763,1,11,6662,127931,5118,132049,6664,259980,California
Contra Costa,2021-03-04,12386,404777,7410,235027,4974,169737,2,13,6404,128380,5958,138007,6407,266387,California
Contra Costa,2021-03-05,11827,416604,7102,242129,4716,174453,9,22,6760,130102,5048,143055,6770,273157,California
Contra Costa,2021-03-06,7686,424290,4296,246425,3074,177527,316,338,5007,132756,2663,145718,5317,278474,California
Contra Costa,2021-03-07,4117,428407,2524,248949,1405,178932,188,526,3271,135369,843,146561,3456,281930,California
Contra Costa,2021-03-08,8460,436867,4008,252957,4124,183056,328,854,5691,138631,2756,149317,6018,287948,California
Contra Costa,2021-03-09,11402,448269,6054,259011,5044,188100,304,1158,5959,139471,5424,154741,6264,294212,California
Contra Costa,2021-03-10,12746,461015,6412,265423,4818,192918,1516,2674,5805,139848,6921,161662,7298,301510,California
Contra Costa,2021-03-11,12796,473811,6725,272148,5496,198414,575,3249,6542,140727,6222,167884,7101,308611,California
Contra Costa,2021-03-12,12920,486731,5323,277471,7022,205436,575,3824,6434,141265,6459,174343,6997,315608,California
Contra Costa,2021-03-13,8075,494806,3271,280742,4368,209804,436,4260,3177,139996,4874,179217,3605,319213,California
Contra Costa,2021-03-14,4541,499347,2676,283418,1363,211167,502,4762,1745,139449,2785,182002,2238,321451,California
Contra Costa,2021-03-15,9697,509044,5280,288698,3642,214809,775,5537,4746,140037,4926,186928,5514,326965,California
Contra Costa,2021-03-16,14656,523700,8751,297449,5493,220302,412,5949,7154,140132,7468,194396,7563,334528,California
Contra Costa,2021-03-17,15438,539138,10678,308127,4531,224833,229,6178,8561,142080,6847,201243,8795,343323,California
Contra Costa,2021-03-18,15717,554855,8796,316923,6433,231266,488,6666,8606,144096,7072,208315,9088,352411,California
Contra Costa,2021-03-19,16023,570878,9268,326191,5308,236574,1447,8113,8190,145920,7811,216126,9635,362046,California
Contra Costa,2021-03-20,10962,581840,6583,332774,4060,240634,319,8432,5117,145538,5818,221944,5436,367482,California
Contra Costa,2021-03-21,4721,586561,4118,336892,502,241136,101,8533,1796,144523,2911,224855,1896,369378,California
Contra Costa,2021-03-22,11951,598512,9019,345911,2668,243804,264,8797,6861,146575,5067,229922,7119,376497,California
Contra Costa,2021-03-23,16071,614583,11078,356989,4818,248622,175,8972,9186,149078,6855,236777,9358,385855,California
Contra Costa,2021-03-24,15418,630001,12030,369019,3173,251795,215,9187,9229,152380,6146,242923,9448,395303,California
Contra Costa,2021-03-25,15730,645731,12267,381286,3170,254965,293,9480,9556,156097,6127,249050,9844,405147,California
Contra Costa,2021-03-26,15422,661153,11073,392359,3942,258907,407,9887,8823,158755,6565,255615,9223,414370,California
Contra Costa,2021-03-27,10823,671976,7044,399403,3260,262167,519,10406,5727,159905,5085,260700,6235,420605,California
Contra Costa,2021-03-28,4364,676340,3106,402509,1202,263369,56,10462,1666,158942,2685,263385,1722,422327,California
Contra Costa,2021-03-29,11192,687532,8721,411230,2350,265719,121,10583,7070,162042,4091,267476,7191,429518,California
Contra Costa,2021-03-30,17213,704745,9445,420675,6405,272124,1363,11946,10611,167428,6574,274050,11960,441478,California
Contra Costa,2021-03-31,18504,723249,12999,433674,4051,276175,1454,13400,11616,173647,6833,280883,13052,454530,California
Contra Costa,2021-04-01,17941,741190,12542,446216,3983,280158,1416,14816,11582,180314,6310,287193,12977,467507,California
Contra Costa,2021-04-02,17869,759059,13165,459381,3667,283825,1037,15853,11840,187170,6012,293205,12868,480375,California
Contra Costa,2021-04-03,11093,770152,6617,465998,2908,286733,1568,17421,6321,190289,4756,297961,7875,488250,California
Contra Costa,2021-04-04,3450,773602,1355,467353,1480,288213,615,18036,863,189186,2578,300539,1475,489725,California
Contra Costa,2021-04-05,12344,785946,8018,475371,3327,291540,999,19035,6653,191161,5674,306213,7649,497374,California
Contra Costa,2021-04-06,17679,803625,12258,487629,3108,294648,2313,21348,9899,195607,7753,313966,12199,509573,California
Contra Costa,2021-04-07,18891,822516,12797,500426,3254,297902,2840,24188,10692,200995,8168,322134,13556,523129,California
Contra Costa,2021-04-08,19015,841531,12680,513106,3393,301295,2942,27130,10183,205307,8797,330931,13109,536238,California
Contra Costa,2021-04-09,19194,860725,12210,525316,4452,305747,2532,29662,10231,209130,8928,339859,12751,548989,California
Contra Costa,2021-04-10,10765,871490,3899,529215,2240,307987,4626,34288,3367,209715,7374,347233,7959,556948,California
Contra Costa,2021-04-11,3461,874951,2058,531273,727,308714,676,34964,1165,209265,2288,349521,1838,558786,California
Contra Costa,2021-04-12,12218,887169,8046,539319,3078,311792,1094,36058,5707,209579,6490,356011,6804,565590,California
Contra Costa,2021-04-13,18237,905406,11218,550537,7011,318803,8,36066,12140,215668,6065,362076,12154,577744,California
Contra Costa,2021-04-14,18023,923429,11339,561876,6681,325484,3,36069,9978,217634,8020,370096,9986,587730,California
Contra Costa,2021-04-15,17804,941233,10937,572813,6866,332350,1,36070,8223,216338,9545,379641,8249,595979,California
Contra Costa,2021-04-16,17230,958463,10729,583542,6500,338850,1,36071,7723,214596,9475,389116,7733,603712,California
Contra Costa,2021-04-17,11746,970209,6473,590015,5273,344123,0,36071,6299,215478,5424,394540,6306,610018,California
Contra Costa,2021-04-18,3007,973216,2336,592351,670,344793,1,36072,1880,216242,1117,395657,1881,611899,California
Contra Costa,2021-04-19,11652,984868,8688,601039,2964,347757,0,36072,3648,211923,7971,403628,3652,615551,California
Contra Costa,2021-04-20,17190,1002058,11206,612245,5984,353741,0,36072,6392,207560,10760,414388,6397,621948,California
Contra Costa,2021-04-21,18102,1020160,14794,627039,3307,357048,1,36073,6429,202382,11619,426007,6441,628389,California
Contra Costa,2021-04-22,17808,1037968,14433,641472,3372,360420,3,36076,6300,197229,11466,437473,6313,634702,California
Contra Costa,2021-04-23,17627,1055595,14045,655517,3580,364000,2,36078,5669,190995,11914,449387,5680,640382,California
Contra Costa,2021-04-24,11231,1066826,8644,664161,2586,366586,1,36079,4317,188431,6885,456272,4321,644703,California
Contra Costa,2021-04-25,3367,1070193,2259,666420,1106,367692,2,36081,2104,189281,1260,457532,2110,646813,California
Contra Costa,2021-04-26,10351,1080544,8618,675038,1709,369401,24,36105,3132,185256,7195,464727,3170,649983,California
Contra Costa,2021-04-27,15073,1095617,11035,686073,3859,373260,179,36284,4129,178658,10915,475642,4317,654300,California
Contra Costa,2021-04-28,14641,1110258,11400,697473,2951,376211,290,36574,3937,172240,10654,486296,4236,658536,California
Contra Costa,2021-04-29,13851,1124109,10738,708211,2941,379152,172,36746,3342,165285,10475,496771,3520,662056,California
Contra Costa,2021-04-30,14220,1138329,11194,719405,2765,381917,261,37007,3284,157938,10898,507669,3551,665607,California
Contra Costa,2021-05-01,8223,1146552,5961,725366,1935,383852,327,37334,1950,153973,6244,513913,2279,667886,California
Contra Costa,2021-05-02,2405,1148957,1631,726997,693,384545,81,37415,1003,153669,1388,515301,1084,668970,California
Contra Costa,2021-05-03,9302,1158259,8166,735163,958,385503,178,37593,1965,148500,7315,522616,2146,671116,California
Contra Costa,2021-05-04,14517,1172776,12536,747699,1649,387152,332,37925,2379,139110,12101,534717,2711,673827,California
Contra Costa,2021-05-05,12954,1185730,11191,758890,1560,388712,203,38128,2489,131373,10429,545146,2692,676519,California
Contra Costa,2021-05-06,10611,1196341,8833,767723,1438,390150,340,38468,2009,125158,8571,553717,2356,678875,California
Contra Costa,2021-05-07,9863,1206204,7930,775653,1705,391855,228,38696,2258,120072,7569,561286,2483,681358,California
Contra Costa,2021-05-08,5577,1211781,4231,779884,1175,393030,171,38867,1343,117379,4213,565499,1520,682878,California
Contra Costa,2021-05-09,2185,1213966,1847,781731,277,393307,61,38928,454,116173,1722,567221,516,683394,California
Contra Costa,2021-05-10,5055,1219021,4049,785780,784,394091,222,39150,1351,114062,3682,570903,1571,684965,California
Contra Costa,2021-05-11,9113,1228134,4823,790603,4048,398139,242,39392,1791,108801,7300,578203,2039,687004,California
Contra Costa,2021-05-12,9417,1237551,4875,795478,4273,402412,269,39661,1611,102911,7777,585980,1887,688891,California
Contra Costa,2021-05-13,12005,1249556,8038,803516,3780,406192,187,39848,4297,99723,7676,593656,4488,693379,California
Contra Costa,2021-05-14,12483,1262039,8370,811886,3826,410018,287,40135,5106,97770,7344,601000,5391,698770,California
Contra Costa,2021-05-15,10281,1272320,7491,819377,2672,412690,118,40253,4521,96672,5740,606740,4642,703412,California
Contra Costa,2021-05-16,2685,1275005,2366,821743,268,412958,51,40304,1233,96509,1446,608186,1283,704695,California
Contra Costa,2021-05-17,7213,1282218,5825,827568,1208,414166,180,40484,3584,96670,3606,611792,3767,708462,California
Contra Costa,2021-05-18,10421,1292639,7115,834683,3085,417251,221,40705,4460,95426,5930,617722,4686,713148,California
Contra Costa,2021-05-19,8596,1301235,6939,841622,1460,418711,197,40902,3850,94759,4718,622440,4051,717199,California
Contra Costa,2021-05-20,7261,1308496,5726,847348,1348,420059,187,41089,3331,94381,3897,626337,3519,720718,California
Contra Costa,2021-05-21,7143,1315639,5471,852819,1458,421517,214,41303,3213,93905,3900,630237,3424,724142,California
Contra Costa,2021-05-22,5178,1320817,4091,856910,907,422424,180,41483,2519,93968,2633,632870,2696,726838,California
Contra Costa,2021-05-23,1289,1322106,860,857770,371,422795,58,41541,606,93957,674,633544,663,727501,California
Contra Costa,2021-05-24,4794,1326900,3963,861733,652,423447,179,41720,2232,93823,2549,636093,2415,729916,California
Contra Costa,2021-05-25,6332,1333232,5145,866878,931,424378,256,41976,2636,93039,3675,639768,2891,732807,California
Contra Costa,2021-05-26,5701,1338933,3666,870544,1844,426222,191,42167,1953,91457,3725,643493,2143,734950,California
Contra Costa,2021-05-27,3832,1342765,2710,873254,944,427166,178,42345,1586,90988,2229,645722,1760,736710,California
Contra Costa,2021-05-28,5399,1348164,3767,877021,1459,428625,173,42518,2229,90243,3145,648867,2400,739110,California
Contra Costa,2021-05-29,3318,1351482,2162,879183,1038,429663,118,42636,1623,90301,1683,650550,1741,740851,California
Contra Costa,2021-05-30,953,1352435,605,879788,319,429982,29,42665,351,90081,600,651150,380,741231,California
Contra Costa,2021-05-31,399,1352834,276,880064,108,430090,15,42680,128,89957,266,651416,142,741373,California
Contra Costa,2021-06-01,4832,1357666,3594,883658,1092,431182,146,42826,1661,88611,3153,654569,1807,743180,California
Contra Costa,2021-06-02,3466,1361132,2452,886110,867,432049,147,42973,1406,88116,2047,656616,1552,744732,California
Contra Costa,2021-06-03,5486,1366618,4573,890683,798,432847,115,43088,1404,85559,4076,660692,1519,746251,California
Contra Costa,2021-06-04,6462,1373080,5421,896104,902,433749,139,43227,1579,82411,4862,665554,1714,747965,California
Contra Costa,2021-06-05,5265,1378345,4468,900572,684,434433,113,43340,1068,79406,4184,669738,1179,749144,California
Contra Costa,2021-06-06,1384,1379729,1211,901783,143,434576,30,43370,323,78701,1058,670796,353,749497,California
Contra Costa,2021-06-07,4990,1384719,4389,906172,501,435077,100,43470,1350,76524,3628,674424,1451,750948,California
Contra Costa,2021-06-08,6130,1390849,5283,911455,724,435801,123,43593,1416,73368,4696,679120,1540,752488,California
Contra Costa,2021-06-09,4903,1395752,4181,915636,573,436374,149,43742,1260,71154,3623,682743,1409,753897,California
Contra Costa,2021-06-10,4831,1400583,4059,919695,602,436976,170,43912,1240,68989,3575,686318,1410,755307,California
Contra Costa,2021-06-11,4874,1405457,3999,923694,676,437652,199,44111,1277,66883,3581,689899,1475,756782,California
Contra Costa,2021-06-12,3189,1408646,2708,926402,414,438066,67,44178,716,65203,2461,692360,781,757563,California
Contra Costa,2021-06-13,1157,1409803,863,927265,186,438252,108,44286,291,64743,859,693219,399,757962,California
Contra Costa,2021-06-14,3942,1413745,3329,930594,481,438733,132,44418,1151,63248,2774,695993,1279,759241,California
Contra Costa,2021-06-15,4216,1417961,3517,934111,538,439271,161,44579,1325,61854,2879,698872,1485,760726,California
Contra Costa,2021-06-16,3499,1421460,2853,936964,459,439730,187,44766,1209,60977,2271,701143,1394,762120,California
Contra Costa,2021-06-17,2787,1424247,2280,939244,381,440111,126,44892,1063,60448,1716,702859,1187,763307,California
Contra Costa,2021-06-18,3698,1427945,3044,942288,464,440575,190,45082,1325,59595,2361,705220,1508,764815,California
Contra Costa,2021-06-19,2045,1429990,1710,943998,231,440806,104,45186,577,58813,1464,706684,682,765497,California
Contra Costa,2021-06-20,793,1430783,667,944665,98,440904,28,45214,333,58717,456,707140,360,765857,California
Contra Costa,2021-06-21,1828,1432611,1388,946053,281,441185,159,45373,975,59005,845,707985,1133,766990,California
Contra Costa,2021-06-22,3053,1435664,2584,948637,329,441514,140,45513,1191,58487,1848,709833,1330,768320,California
Contra Costa,2021-06-23,2577,1438241,2136,950773,337,441851,104,45617,1036,58095,1532,711365,1140,769460,California
Contra Costa,2021-06-24,2361,1440602,1983,952756,250,442101,128,45745,942,57759,1405,712770,1069,770529,California
Contra Costa,2021-06-25,2785,1443387,2270,955026,359,442460,156,45901,1132,57402,1646,714416,1289,771818,California
Contra Costa,2021-06-26,1489,1444876,1220,956246,173,442633,96,45997,485,56981,1002,715418,581,772399,California
Contra Costa,2021-06-27,703,1445579,613,956859,68,442701,22,46019,273,56848,428,715846,295,772694,California
Contra Costa,2021-06-28,2371,1447950,2042,958901,180,442881,149,46168,851,56339,1507,717353,998,773692,California
Contra Costa,2021-06-29,2556,1450506,2132,961033,293,443174,131,46299,986,55897,1557,718910,1115,774807,California
Contra Costa,2021-06-30,2199,1452705,1797,962830,301,443475,101,46400,894,55597,1293,720203,993,775800,California
Contra Costa,2021-07-01,2110,1454815,1767,964597,236,443711,107,46507,858,55323,1242,721445,968,776768,California
Contra Costa,2021-07-02,2196,1457011,1793,966390,302,444013,101,46608,909,55057,1275,722720,1009,777777,California
Contra Costa,2021-07-03,1067,1458078,874,967264,135,444148,58,46666,432,54917,629,723349,489,778266,California
Contra Costa,2021-07-04,54,1458132,21,967285,18,444166,15,46681,20,54918,34,723383,35,778301,California
Contra Costa,2021-07-05,832,1458964,685,967970,107,444273,40,46721,402,54933,427,723810,442,778743,California
Contra Costa,2021-07-06,2641,1461605,2239,970209,272,444545,130,46851,875,54185,1752,725562,1004,779747,California
Contra Costa,2021-07-07,2042,1463647,1708,971917,224,444769,110,46961,781,53823,1250,726812,888,780635,California
Contra Costa,2021-07-08,1864,1465511,1574,973491,201,444970,89,47050,785,53629,1068,727880,874,781509,California
Contra Costa,2021-07-09,2354,1467865,1891,975382,346,445316,117,47167,926,53254,1416,729296,1041,782550,California
Contra Costa,2021-07-10,965,1468830,799,976181,118,445434,48,47215,390,53124,566,729862,436,782986,California
Contra Costa,2021-07-11,691,1469521,466,976647,143,445577,82,47297,282,53081,407,730269,364,783350,California
Contra Costa,2021-07-12,2102,1471623,1839,978486,193,445770,70,47367,878,52815,1213,731482,947,784297,California
Contra Costa,2021-07-13,2071,1473694,1769,980255,230,446000,72,47439,836,52503,1222,732704,910,785207,California
Contra Costa,2021-07-14,1820,1475514,1526,981781,218,446218,76,47515,778,52324,1033,733737,854,786061,California
Contra Costa,2021-07-15,1716,1477230,1491,983272,167,446385,58,47573,817,52311,888,734625,875,786936,California
Contra Costa,2021-07-16,2129,1479359,1795,985067,240,446625,94,47667,980,52245,1136,735761,1070,788006,California
Contra Costa,2021-07-17,1000,1480359,814,985881,159,446784,27,47694,488,52260,500,736261,515,788521,California
Contra Costa,2021-07-18,554,1480913,447,986328,68,446852,39,47733,277,52302,273,736534,315,788836,California
Contra Costa,2021-07-19,1825,1482738,1546,987874,197,447049,82,47815,934,52438,881,737415,1017,789853,California
Contra Costa,2021-07-20,1991,1484729,1686,989560,219,447268,86,47901,985,52515,994,738409,1071,790924,California
Contra Costa,2021-07-21,1895,1486624,1558,991118,260,447528,77,47978,983,52681,894,739303,1060,791984,California
Contra Costa,2021-07-22,1946,1488570,1632,992750,238,447766,76,48054,1094,53009,841,740144,1169,793153,California
Contra Costa,2021-07-23,2217,1490787,1836,994586,291,448057,90,48144,1222,53340,981,741125,1312,794465,California
Contra Costa,2021-07-24,1183,1491970,958,995544,166,448223,59,48203,591,53411,578,741703,649,795114,California
Contra Costa,2021-07-25,551,1492521,459,996003,71,448294,21,48224,417,53718,130,741833,437,795551,California
Contra Costa,2021-07-26,2047,1494568,1727,997730,236,448530,84,48308,1347,54469,682,742515,1433,796984,California
Contra Costa,2021-07-27,2373,1496941,1976,999706,266,448796,131,48439,1369,54983,985,743500,1499,798483,California
Contra Costa,2021-07-28,2162,1499103,1768,1001474,272,449068,122,48561,1204,55369,938,744438,1324,799807,California
Contra Costa,2021-07-29,1995,1501098,1667,1003141,229,449297,99,48660,1110,55715,862,745300,1208,801015,California
Contra Costa,2021-07-30,2455,1503553,2068,1005209,308,449605,79,48739,1415,56239,967,746267,1491,802506,California
Contra Costa,2021-07-31,699,1504252,547,1005756,131,449736,21,48760,404,56387,274,746541,422,802928,California
Del Norte,2020-12-21,22,22,22,22,0,0,0,0,22,22,0,0,22,22,California
Del Norte,2020-12-22,46,68,46,68,0,0,0,0,46,68,0,0,46,68,California
Del Norte,2020-12-23,58,126,48,116,10,10,0,0,56,124,0,0,56,124,California
Del Norte,2020-12-28,35,161,35,151,0,10,0,0,35,159,0,0,35,159,California
Del Norte,2020-12-29,4,165,4,155,0,10,0,0,4,163,0,0,4,163,California
Del Norte,2020-12-30,68,233,56,211,12,22,0,0,68,231,0,0,68,231,California
Del Norte,2020-12-31,16,249,13,224,3,25,0,0,16,247,0,0,16,247,California
Del Norte,2021-01-04,103,352,50,274,53,78,0,0,103,350,0,0,103,350,California
Del Norte,2021-01-05,31,383,0,274,31,109,0,0,31,381,0,0,31,381,California
Del Norte,2021-01-06,77,460,18,292,59,168,0,0,77,458,0,0,77,458,California
Del Norte,2021-01-07,21,481,1,293,20,188,0,0,21,479,0,0,21,479,California
Del Norte,2021-01-08,79,560,7,300,72,260,0,0,79,558,0,0,79,558,California
Del Norte,2021-01-11,39,599,20,320,19,279,0,0,18,556,21,21,19,577,California
Del Norte,2021-01-12,52,651,33,353,19,298,0,0,31,566,21,42,31,608,California
Del Norte,2021-01-13,86,737,42,395,44,342,0,0,53,586,33,75,53,661,California
Del Norte,2021-01-14,54,791,14,409,40,382,0,0,48,628,6,81,48,709,California
Del Norte,2021-01-15,107,898,18,427,89,471,0,0,95,711,12,93,95,804,California
Del Norte,2021-01-17,1,899,1,428,0,471,0,0,1,712,0,93,1,805,California
Del Norte,2021-01-18,2,901,0,428,2,473,0,0,2,714,0,93,2,807,California
Del Norte,2021-01-19,120,1021,58,486,62,535,0,0,77,748,43,136,77,884,California
Del Norte,2021-01-20,161,1182,86,572,75,610,0,0,98,783,63,199,98,982,California
Del Norte,2021-01-21,43,1225,40,612,3,613,0,0,32,804,11,210,32,1014,California
Del Norte,2021-01-22,19,1244,17,629,2,615,0,0,12,809,7,217,12,1026,California
Del Norte,2021-01-23,1,1245,0,629,1,616,0,0,1,810,0,217,1,1027,California
Del Norte,2021-01-24,1,1246,0,629,1,617,0,0,1,811,0,217,1,1028,California
Del Norte,2021-01-25,101,1347,83,712,18,635,0,0,56,822,45,262,56,1084,California
Del Norte,2021-01-26,18,1365,11,723,7,642,0,0,7,818,11,273,7,1091,California
Del Norte,2021-01-27,64,1429,21,744,43,685,0,0,61,876,3,276,61,1152,California
Del Norte,2021-01-28,293,1722,20,764,273,958,0,0,288,1159,5,281,288,1440,California
Del Norte,2021-01-29,63,1785,23,787,40,998,0,0,44,1184,19,300,44,1484,California
Del Norte,2021-01-30,8,1793,1,788,7,1005,0,0,8,1192,0,300,8,1492,California
Del Norte,2021-02-01,40,1833,1,789,39,1044,0,0,25,1202,15,315,25,1517,California
Del Norte,2021-02-02,142,1975,33,822,109,1153,0,0,72,1207,68,383,73,1590,California
Del Norte,2021-02-03,131,2106,44,866,87,1240,0,0,74,1224,57,440,74,1664,California
Del Norte,2021-02-04,70,2176,28,894,42,1282,0,0,40,1234,30,470,40,1704,California
Del Norte,2021-02-05,183,2359,21,915,162,1444,0,0,117,1286,65,535,117,1821,California
Del Norte,2021-02-06,309,2668,3,918,306,1750,0,0,309,1595,0,535,309,2130,California
Del Norte,2021-02-07,1,2669,1,919,0,1750,0,0,1,1596,0,535,1,2131,California
Del Norte,2021-02-08,35,2704,1,920,34,1784,0,0,31,1623,4,539,31,2162,California
Del Norte,2021-02-09,9,2713,6,926,3,1787,0,0,2,1618,7,546,2,2164,California
Del Norte,2021-02-10,142,2855,20,946,122,1909,0,0,85,1647,56,602,85,2249,California
Del Norte,2021-02-11,176,3031,58,1004,118,2027,0,0,63,1597,113,715,63,2312,California
Del Norte,2021-02-12,123,3154,14,1018,109,2136,0,0,69,1612,54,769,69,2381,California
Del Norte,2021-02-13,2,3156,1,1019,1,2137,0,0,2,1614,0,769,2,2383,California
Del Norte,2021-02-14,4,3160,1,1020,3,2140,0,0,3,1616,1,770,3,2386,California
Del Norte,2021-02-15,5,3165,0,1020,5,2145,0,0,3,1617,2,772,3,2389,California
Del Norte,2021-02-16,132,3297,1,1021,131,2276,0,0,13,1511,119,891,13,2402,California
Del Norte,2021-02-17,92,3389,19,1040,73,2349,0,0,24,1468,67,958,24,2426,California
Del Norte,2021-02-18,76,3465,24,1064,52,2401,0,0,50,1492,26,984,50,2476,California
Del Norte,2021-02-19,43,3508,17,1081,26,2427,0,0,33,1515,10,994,33,2509,California
Del Norte,2021-02-20,9,3517,6,1087,3,2430,0,0,6,1518,3,997,6,2515,California
Del Norte,2021-02-21,1,3518,0,1087,1,2431,0,0,0,1517,1,998,0,2515,California
Del Norte,2021-02-22,2,3520,0,1087,2,2433,0,0,2,1519,0,998,2,2517,California
Del Norte,2021-02-23,110,3630,92,1179,18,2451,0,0,32,1474,77,1075,32,2549,California
Del Norte,2021-02-24,159,3789,103,1282,56,2507,0,0,84,1483,75,1150,84,2633,California
Del Norte,2021-02-25,499,4288,149,1431,350,2857,0,0,232,1450,265,1415,232,2865,California
Del Norte,2021-02-26,212,4500,175,1606,37,2894,0,0,165,1568,47,1462,165,3030,California
Del Norte,2021-02-27,153,4653,146,1752,6,2900,1,1,145,1706,8,1470,146,3176,California
Del Norte,2021-02-28,3,4656,0,1752,3,2903,0,1,3,1709,0,1470,3,3179,California
Del Norte,2021-03-01,28,4684,2,1754,26,2929,0,1,4,1690,23,1493,4,3183,California
Del Norte,2021-03-02,233,4917,153,1907,80,3009,0,1,199,1855,34,1527,199,3382,California
Del Norte,2021-03-03,181,5098,111,2018,70,3079,0,1,139,1952,42,1569,139,3521,California
Del Norte,2021-03-04,125,5223,87,2105,38,3117,0,1,95,2018,29,1598,95,3616,California
Del Norte,2021-03-05,126,5349,11,2116,115,3232,0,1,75,2042,51,1649,75,3691,California
Del Norte,2021-03-06,465,5814,77,2193,339,3571,49,50,164,1912,301,1950,171,3862,California
Del Norte,2021-03-07,1,5815,1,2194,0,3571,0,50,1,1913,0,1950,1,3863,California
Del Norte,2021-03-08,29,5844,0,2194,27,3598,2,52,6,1899,22,1972,8,3871,California
Del Norte,2021-03-09,194,6038,113,2307,78,3676,3,55,183,2074,11,1983,186,4057,California
Del Norte,2021-03-10,237,6275,95,2402,113,3789,29,84,134,2134,103,2086,163,4220,California
Del Norte,2021-03-11,150,6425,55,2457,90,3879,5,89,102,2193,48,2134,107,4327,California
Del Norte,2021-03-12,178,6603,88,2545,90,3969,0,89,124,2264,53,2187,124,4451,California
Del Norte,2021-03-13,95,6698,94,2639,1,3970,0,89,92,2353,3,2190,92,4543,California
Del Norte,2021-03-14,2,6700,0,2639,2,3972,0,89,0,2351,2,2192,0,4543,California
Del Norte,2021-03-15,38,6738,0,2639,38,4010,0,89,34,2381,4,2196,34,4577,California
Del Norte,2021-03-16,281,7019,134,2773,147,4157,0,89,258,2616,23,2219,258,4835,California
Del Norte,2021-03-17,284,7303,95,2868,187,4344,2,91,167,2668,117,2336,169,5004,California
Del Norte,2021-03-18,285,7588,107,2975,176,4520,2,93,138,2662,146,2482,140,5144,California
Del Norte,2021-03-19,268,7856,158,3133,104,4624,6,99,90,2580,178,2660,96,5240,California
Del Norte,2021-03-20,156,8012,153,3286,3,4627,0,99,11,2446,145,2805,11,5251,California
Del Norte,2021-03-21,4,8016,2,3288,2,4629,0,99,2,2446,2,2807,2,5253,California
Del Norte,2021-03-22,42,8058,2,3290,39,4668,1,100,38,2482,3,2810,39,5292,California
Del Norte,2021-03-23,334,8392,165,3455,151,4819,18,118,155,2477,177,2987,172,5464,California
Del Norte,2021-03-24,400,8792,107,3562,253,5072,40,158,228,2573,172,3159,268,5732,California
Del Norte,2021-03-25,195,8987,89,3651,106,5178,0,158,80,2539,114,3273,80,5812,California
Del Norte,2021-03-26,234,9221,113,3764,121,5299,0,158,196,2698,37,3310,196,6008,California
Del Norte,2021-03-27,107,9328,86,3850,4,5303,17,175,17,2642,90,3400,34,6042,California
Del Norte,2021-03-28,4,9332,2,3852,2,5305,0,175,1,2640,3,3403,1,6043,California
Del Norte,2021-03-29,56,9388,6,3858,34,5339,16,191,32,2664,24,3427,48,6091,California
Del Norte,2021-03-30,338,9726,119,3977,208,5547,11,202,126,2589,212,3639,137,6228,California
Del Norte,2021-03-31,358,10084,102,4079,238,5785,18,220,200,2651,156,3795,218,6446,California
Del Norte,2021-04-01,162,10246,58,4137,70,5855,34,254,68,2660,93,3888,102,6548,California
Del Norte,2021-04-02,232,10478,78,4215,105,5960,49,303,49,2576,183,4071,99,6647,California
Del Norte,2021-04-03,110,10588,85,4300,2,5962,23,326,6,2502,103,4174,29,6676,California
Del Norte,2021-04-04,4,10592,0,4300,0,5962,4,330,0,2502,4,4178,4,6680,California
Del Norte,2021-04-05,44,10636,3,4303,37,5999,4,334,38,2538,6,4184,42,6722,California
Del Norte,2021-04-06,379,11015,118,4421,224,6223,37,371,145,2491,230,4414,183,6905,California
Del Norte,2021-04-07,439,11454,115,4536,263,6486,61,432,289,2692,150,4564,351,7256,California
Del Norte,2021-04-08,230,11684,54,4590,106,6592,70,502,105,2742,125,4689,175,7431,California
Del Norte,2021-04-09,206,11890,46,4636,83,6675,77,579,99,2810,106,4795,174,7605,California
Del Norte,2021-04-10,47,11937,26,4662,4,6679,17,596,26,2832,21,4816,43,7648,California
Del Norte,2021-04-11,10,11947,3,4665,0,6679,7,603,1,2831,9,4825,8,7656,California
Del Norte,2021-04-12,27,11974,1,4666,9,6688,17,620,1,2824,25,4850,18,7674,California
Del Norte,2021-04-13,297,12271,49,4715,248,6936,0,620,154,2835,143,4993,154,7828,California
Del Norte,2021-04-14,332,12603,23,4738,309,7245,0,620,139,2786,193,5186,144,7972,California
Del Norte,2021-04-15,165,12768,30,4768,135,7380,0,620,45,2712,120,5306,46,8018,California
Del Norte,2021-04-16,162,12930,39,4807,123,7503,0,620,59,2670,102,5408,60,8078,California
Del Norte,2021-04-17,108,13038,76,4883,32,7535,0,620,102,2766,6,5414,102,8180,California
Del Norte,2021-04-18,6,13044,5,4888,1,7536,0,620,5,2770,1,5415,5,8185,California
Del Norte,2021-04-19,51,13095,6,4894,45,7581,0,620,9,2737,42,5457,9,8194,California
Del Norte,2021-04-20,208,13303,40,4934,168,7749,0,620,74,2677,134,5591,74,8268,California
Del Norte,2021-04-21,294,13597,24,4958,270,8019,0,620,68,2522,226,5817,71,8339,California
Del Norte,2021-04-22,118,13715,16,4974,102,8121,0,620,63,2530,55,5872,63,8402,California
Del Norte,2021-04-23,154,13869,23,4997,131,8252,0,620,40,2457,113,5985,40,8442,California
Del Norte,2021-04-24,27,13896,16,5013,11,8263,0,620,21,2472,6,5991,21,8463,California
Del Norte,2021-04-25,2,13898,0,5013,2,8265,0,620,2,2474,0,5991,2,8465,California
Del Norte,2021-04-26,32,13930,1,5014,31,8296,0,620,9,2461,22,6013,9,8474,California
Del Norte,2021-04-27,179,14109,19,5033,155,8451,5,625,49,2386,130,6143,55,8529,California
Del Norte,2021-04-28,352,14461,101,5134,246,8697,5,630,63,2168,287,6430,69,8598,California
Del Norte,2021-04-29,94,14555,7,5141,83,8780,4,634,27,2132,67,6497,31,8629,California
Del Norte,2021-04-30,90,14645,8,5149,72,8852,10,644,47,2147,42,6539,57,8686,California
Del Norte,2021-05-01,7,14652,2,5151,5,8857,0,644,5,2150,2,6541,5,8691,California
Del Norte,2021-05-02,8,14660,0,5151,8,8865,0,644,8,2158,0,6541,8,8699,California
Del Norte,2021-05-03,40,14700,3,5154,34,8899,3,647,2,2127,36,6577,5,8704,California
Del Norte,2021-05-04,223,14923,36,5190,182,9081,5,652,47,2003,176,6753,52,8756,California
Del Norte,2021-05-05,234,15157,20,5210,206,9287,8,660,59,1896,174,6927,67,8823,California
Del Norte,2021-05-06,112,15269,25,5235,74,9361,13,673,25,1847,87,7014,38,8861,California
Del Norte,2021-05-07,150,15419,27,5262,119,9480,4,677,30,1761,120,7134,34,8895,California
Del Norte,2021-05-08,64,15483,54,5316,8,9488,2,679,6,1711,58,7192,8,8903,California
Del Norte,2021-05-09,10,15493,4,5320,3,9491,3,682,3,1710,7,7199,6,8909,California
Del Norte,2021-05-10,25,15518,3,5323,18,9509,4,686,15,1719,10,7209,19,8928,California
Del Norte,2021-05-11,179,15697,50,5373,127,9636,2,688,35,1612,144,7353,37,8965,California
Del Norte,2021-05-12,154,15851,24,5397,120,9756,10,698,27,1523,126,7479,37,9002,California
Del Norte,2021-05-13,68,15919,30,5427,37,9793,1,699,38,1532,30,7509,39,9041,California
Del Norte,2021-05-14,77,15996,26,5453,50,9843,1,700,41,1538,36,7545,42,9083,California
Del Norte,2021-05-15,97,16093,54,5507,37,9880,6,706,53,1553,44,7589,59,9142,California
Del Norte,2021-05-16,11,16104,0,5507,11,9891,0,706,11,1564,0,7589,11,9153,California
Del Norte,2021-05-17,27,16131,4,5511,20,9911,3,709,15,1571,11,7600,18,9171,California
Del Norte,2021-05-18,130,16261,70,5581,60,9971,0,709,82,1605,48,7648,82,9253,California
Del Norte,2021-05-19,97,16358,14,5595,66,10037,17,726,35,1594,62,7710,51,9304,California
Del Norte,2021-05-20,99,16457,31,5626,65,10102,3,729,39,1577,59,7769,42,9346,California
Del Norte,2021-05-21,81,16538,34,5660,44,10146,3,732,44,1587,37,7806,47,9393,California
Del Norte,2021-05-22,24,16562,8,5668,16,10162,0,732,11,1586,12,7818,11,9404,California
Del Norte,2021-05-23,14,16576,5,5673,9,10171,0,732,7,1586,7,7825,7,9411,California
Del Norte,2021-05-24,26,16602,9,5682,17,10188,0,732,17,1594,9,7834,17,9428,California
Del Norte,2021-05-25,47,16649,5,5687,36,10224,6,738,17,1590,27,7861,23,9451,California
Del Norte,2021-05-26,117,16766,36,5723,73,10297,8,746,53,1588,63,7924,61,9512,California
Del Norte,2021-05-27,74,16840,28,5751,42,10339,4,750,34,1587,39,7963,38,9550,California
Del Norte,2021-05-28,53,16893,7,5758,38,10377,8,758,9,1560,44,8007,17,9567,California
Del Norte,2021-05-29,8,16901,0,5758,4,10381,4,762,3,1562,5,8012,7,9574,California
Del Norte,2021-05-30,6,16907,0,5758,6,10387,0,762,1,1558,5,8017,1,9575,California
Del Norte,2021-05-31,4,16911,2,5760,2,10389,0,762,3,1560,1,8018,3,9578,California
Del Norte,2021-06-01,51,16962,6,5766,39,10428,6,768,11,1537,40,8058,17,9595,California
Del Norte,2021-06-02,84,17046,11,5777,68,10496,5,773,20,1498,64,8122,25,9620,California
Del Norte,2021-06-03,64,17110,36,5813,26,10522,2,775,29,1494,35,8157,31,9651,California
Del Norte,2021-06-04,69,17179,24,5837,40,10562,5,780,20,1470,49,8206,25,9676,California
Del Norte,2021-06-05,1,17180,0,5837,1,10563,0,780,0,1469,1,8207,0,9676,California
Del Norte,2021-06-06,10,17190,4,5841,4,10567,2,782,7,1475,3,8210,9,9685,California
Del Norte,2021-06-07,42,17232,9,5850,28,10595,5,787,15,1468,27,8237,20,9705,California
Del Norte,2021-06-08,112,17344,81,5931,26,10621,5,792,33,1427,79,8316,38,9743,California
Del Norte,2021-06-09,58,17402,11,5942,40,10661,7,799,16,1408,42,8358,23,9766,California
Del Norte,2021-06-10,56,17458,26,5968,23,10684,7,806,11,1382,44,8402,18,9784,California
Del Norte,2021-06-11,60,17518,24,5992,27,10711,9,815,14,1359,46,8448,23,9807,California
Del Norte,2021-06-12,17,17535,3,5995,11,10722,3,818,2,1349,15,8463,5,9812,California
Del Norte,2021-06-13,60,17595,43,6038,13,10735,4,822,13,1319,47,8510,17,9829,California
Del Norte,2021-06-14,37,17632,15,6053,18,10753,4,826,15,1317,21,8531,19,9848,California
Del Norte,2021-06-15,37,17669,9,6062,20,10773,8,834,4,1296,33,8564,12,9860,California
Del Norte,2021-06-16,97,17766,36,6098,50,10823,11,845,22,1254,75,8639,33,9893,California
Del Norte,2021-06-17,31,17797,13,6111,15,10838,3,848,6,1238,25,8664,9,9902,California
Del Norte,2021-06-18,49,17846,23,6134,21,10859,5,853,20,1234,29,8693,25,9927,California
Del Norte,2021-06-19,11,17857,0,6134,7,10866,4,857,3,1233,8,8701,7,9934,California
Del Norte,2021-06-20,13,17870,9,6143,4,10870,0,857,8,1236,5,8706,8,9942,California
Del Norte,2021-06-21,23,17893,8,6151,10,10880,5,862,9,1236,14,8720,14,9956,California
Del Norte,2021-06-22,39,17932,9,6160,19,10899,11,873,14,1236,25,8745,25,9981,California
Del Norte,2021-06-23,69,18001,33,6193,30,10929,6,879,32,1238,36,8781,38,10019,California
Del Norte,2021-06-24,45,18046,26,6219,12,10941,7,886,15,1230,30,8811,22,10041,California
Del Norte,2021-06-25,29,18075,14,6233,13,10954,2,888,13,1229,16,8827,15,10056,California
Del Norte,2021-06-26,5,18080,0,6233,5,10959,0,888,2,1228,3,8830,2,10058,California
Del Norte,2021-06-27,13,18093,8,6241,5,10964,0,888,9,1233,4,8834,9,10067,California
Del Norte,2021-06-28,13,18106,6,6247,5,10969,2,890,7,1236,6,8840,9,10076,California
Del Norte,2021-06-29,55,18161,40,6287,12,10981,3,893,19,1222,36,8876,22,10098,California
Del Norte,2021-06-30,33,18194,16,6303,12,10993,5,898,9,1212,24,8900,14,10112,California
Del Norte,2021-07-01,22,18216,8,6311,10,11003,4,902,7,1208,15,8915,11,10123,California
Del Norte,2021-07-02,19,18235,7,6318,11,11014,1,903,6,1202,13,8928,7,10130,California
Del Norte,2021-07-03,3,18238,2,6320,1,11015,0,903,2,1203,1,8929,2,10132,California
Del Norte,2021-07-04,10,18248,9,6329,1,11016,0,903,6,1205,4,8933,6,10138,California
Del Norte,2021-07-05,11,18259,7,6336,4,11020,0,903,2,1198,9,8942,2,10140,California
Del Norte,2021-07-06,32,18291,17,6353,13,11033,2,905,17,1203,14,8956,19,10159,California
Del Norte,2021-07-07,49,18340,22,6375,22,11055,5,910,19,1197,30,8986,24,10183,California
Del Norte,2021-07-08,30,18370,12,6387,14,11069,4,914,11,1194,18,9004,15,10198,California
Del Norte,2021-07-09,21,18391,10,6397,10,11079,1,915,8,1190,13,9017,9,10207,California
Del Norte,2021-07-10,9,18400,5,6402,4,11083,0,915,5,1191,4,9021,5,10212,California
Del Norte,2021-07-11,5,18405,4,6406,1,11084,0,915,2,1190,3,9024,2,10214,California
Del Norte,2021-07-12,22,18427,14,6420,7,11091,1,916,11,1191,11,9035,12,10226,California
Del Norte,2021-07-13,24,18451,13,6433,8,11099,3,919,8,1188,16,9051,13,10239,California
Del Norte,2021-07-14,52,18503,26,6459,19,11118,7,926,15,1173,37,9088,22,10261,California
Del Norte,2021-07-15,21,18524,13,6472,7,11125,1,927,14,1181,7,9095,15,10276,California
Del Norte,2021-07-16,20,18544,10,6482,7,11132,3,930,5,1174,15,9110,8,10284,California
Del Norte,2021-07-17,8,18552,1,6483,7,11139,0,930,4,1174,4,9114,4,10288,California
Del Norte,2021-07-18,6,18558,1,6484,4,11143,1,931,4,1177,2,9116,5,10293,California
Del Norte,2021-07-19,26,18584,15,6499,9,11152,2,933,12,1177,14,9130,14,10307,California
Del Norte,2021-07-20,34,18618,23,6522,6,11158,5,938,13,1175,21,9151,19,10326,California
Del Norte,2021-07-21,34,18652,17,6539,11,11169,6,944,17,1181,17,9168,23,10349,California
Del Norte,2021-07-22,35,18687,24,6563,7,11176,4,948,13,1176,22,9190,17,10366,California
Del Norte,2021-07-23,27,18714,14,6577,9,11185,4,952,15,1184,11,9201,19,10385,California
Del Norte,2021-07-24,12,18726,4,6581,8,11193,0,952,11,1194,1,9202,11,10396,California
Del Norte,2021-07-25,7,18733,1,6582,6,11199,0,952,4,1195,3,9205,4,10400,California
Del Norte,2021-07-26,12,18745,9,6591,3,11202,0,952,10,1203,2,9207,10,10410,California
Del Norte,2021-07-27,40,18785,14,6605,23,11225,3,955,20,1206,20,9227,23,10433,California
Del Norte,2021-07-28,34,18819,10,6615,21,11246,3,958,15,1205,19,9246,18,10451,California
Del Norte,2021-07-29,34,18853,14,6629,13,11259,7,965,21,1220,13,9259,28,10479,California
Del Norte,2021-07-30,38,18891,21,6650,13,11272,4,969,23,1232,15,9274,27,10506,California
Del Norte,2021-07-31,21,18912,6,6656,14,11286,1,970,18,1248,3,9277,19,10525,California
El Dorado,2020-12-15,12,12,12,12,0,0,0,0,12,12,0,0,12,12,California
El Dorado,2020-12-16,40,52,40,52,0,0,0,0,40,52,0,0,40,52,California
El Dorado,2020-12-17,33,85,33,85,0,0,0,0,33,85,0,0,33,85,California
El Dorado,2020-12-18,261,346,261,346,0,0,0,0,261,346,0,0,261,346,California
El Dorado,2020-12-19,121,467,121,467,0,0,0,0,121,467,0,0,121,467,California
El Dorado,2020-12-20,84,551,84,551,0,0,0,0,84,551,0,0,84,551,California
El Dorado,2020-12-21,316,867,315,866,1,1,0,0,316,867,0,0,316,867,California
El Dorado,2020-12-22,244,1111,220,1086,24,25,0,0,244,1111,0,0,244,1111,California
El Dorado,2020-12-23,192,1303,142,1228,50,75,0,0,192,1303,0,0,192,1303,California
El Dorado,2020-12-24,84,1387,63,1291,21,96,0,0,84,1387,0,0,84,1387,California
El Dorado,2020-12-25,8,1395,8,1299,0,96,0,0,8,1395,0,0,8,1395,California
El Dorado,2020-12-26,45,1440,27,1326,18,114,0,0,45,1440,0,0,45,1440,California
El Dorado,2020-12-27,38,1478,34,1360,4,118,0,0,38,1478,0,0,38,1478,California
El Dorado,2020-12-28,217,1695,167,1527,50,168,0,0,217,1695,0,0,217,1695,California
El Dorado,2020-12-29,464,2159,143,1670,321,489,0,0,464,2159,0,0,464,2159,California
El Dorado,2020-12-30,514,2673,140,1810,374,863,0,0,514,2673,0,0,514,2673,California
El Dorado,2020-12-31,109,2782,69,1879,40,903,0,0,109,2782,0,0,109,2782,California
El Dorado,2021-01-01,8,2790,4,1883,4,907,0,0,8,2790,0,0,8,2790,California
El Dorado,2021-01-02,155,2945,142,2025,13,920,0,0,155,2945,0,0,155,2945,California
El Dorado,2021-01-03,95,3040,18,2043,77,997,0,0,95,3040,0,0,95,3040,California
El Dorado,2021-01-04,195,3235,63,2106,132,1129,0,0,195,3235,0,0,195,3235,California
El Dorado,2021-01-05,230,3465,74,2180,156,1285,0,0,212,3429,18,18,212,3447,California
El Dorado,2021-01-06,241,3706,167,2347,74,1359,0,0,176,3541,64,82,176,3623,California
El Dorado,2021-01-07,339,4045,140,2487,199,1558,0,0,260,3722,79,161,260,3883,California
El Dorado,2021-01-08,996,5041,513,3000,483,2041,0,0,772,4270,224,385,772,4655,California
El Dorado,2021-01-09,200,5241,164,3164,36,2077,0,0,129,4328,71,456,129,4784,California
El Dorado,2021-01-10,183,5424,133,3297,50,2127,0,0,109,4364,74,530,110,4894,California
El Dorado,2021-01-11,666,6090,297,3594,369,2496,0,0,464,4628,201,731,465,5359,California
El Dorado,2021-01-12,812,6902,429,4023,383,2879,0,0,559,4934,253,984,559,5918,California
El Dorado,2021-01-13,710,7612,303,4326,407,3286,0,0,544,5312,166,1150,544,6462,California
El Dorado,2021-01-14,803,8415,222,4548,581,3867,0,0,706,5923,95,1245,706,7168,California
El Dorado,2021-01-15,805,9220,186,4734,619,4486,0,0,731,6580,74,1319,731,7899,California
El Dorado,2021-01-16,223,9443,103,4837,120,4606,0,0,197,6751,26,1345,197,8096,California
El Dorado,2021-01-17,107,9550,49,4886,58,4664,0,0,90,6824,17,1362,90,8186,California
El Dorado,2021-01-18,434,9984,148,5034,286,4950,0,0,361,7112,73,1435,361,8547,California
El Dorado,2021-01-19,754,10738,450,5484,304,5254,0,0,604,7567,150,1585,605,9152,California
El Dorado,2021-01-20,1017,11755,692,6176,325,5579,0,0,900,8351,116,1701,900,10052,California
El Dorado,2021-01-21,1275,13030,681,6857,594,6173,0,0,1068,9253,166,1867,1068,11120,California
El Dorado,2021-01-22,1254,14284,845,7702,409,6582,0,0,1190,10380,63,1930,1190,12310,California
El Dorado,2021-01-23,880,15164,619,8321,261,6843,0,0,763,11026,117,2047,763,13073,California
El Dorado,2021-01-24,134,15298,81,8402,53,6896,0,0,113,11118,21,2068,113,13186,California
El Dorado,2021-01-25,700,15998,293,8695,407,7303,0,0,609,11636,91,2159,609,13795,California
El Dorado,2021-01-26,702,16700,382,9077,320,7623,0,0,591,12116,111,2270,591,14386,California
El Dorado,2021-01-27,1004,17704,397,9474,607,8230,0,0,662,12435,343,2613,662,15048,California
El Dorado,2021-01-28,1118,18822,456,9930,662,8892,0,0,753,12823,365,2978,753,15801,California
El Dorado,2021-01-29,1063,19885,557,10487,506,9398,0,0,768,13298,294,3272,769,16570,California
El Dorado,2021-01-30,850,20735,299,10786,551,9949,0,0,748,13946,100,3372,748,17318,California
El Dorado,2021-01-31,245,20980,220,11006,25,9974,0,0,191,14083,54,3426,191,17509,California
El Dorado,2021-02-01,810,21790,373,11379,437,10411,0,0,660,14593,150,3576,660,18169,California
El Dorado,2021-02-02,865,22655,383,11762,482,10893,0,0,700,15128,165,3741,700,18869,California
El Dorado,2021-02-03,917,23572,487,12249,430,11323,0,0,703,15617,214,3955,703,19572,California
El Dorado,2021-02-04,1268,24840,718,12967,550,11873,0,0,881,16113,385,4340,881,20453,California
El Dorado,2021-02-05,1525,26365,619,13586,906,12779,0,0,886,16397,602,4942,886,21339,California
El Dorado,2021-02-06,1082,27447,330,13916,752,13531,0,0,977,17270,105,5047,978,22317,California
El Dorado,2021-02-07,262,27709,177,14093,85,13616,0,0,194,17397,67,5114,194,22511,California
El Dorado,2021-02-08,896,28605,425,14518,471,14087,0,0,613,17729,281,5395,613,23124,California
El Dorado,2021-02-09,987,29592,554,15072,433,14520,0,0,551,17844,436,5831,551,23675,California
El Dorado,2021-02-10,1274,30866,746,15818,528,15048,0,0,672,17915,601,6432,672,24347,California
El Dorado,2021-02-11,2185,33051,902,16720,1283,16331,0,0,762,17259,1419,7851,763,25110,California
El Dorado,2021-02-12,1594,34645,832,17552,762,17093,0,0,678,17023,915,8766,679,25789,California
El Dorado,2021-02-13,1258,35903,668,18220,590,17683,0,0,663,17093,593,9359,663,26452,California
El Dorado,2021-02-14,497,36400,156,18376,341,18024,0,0,401,17398,96,9455,401,26853,California
El Dorado,2021-02-15,1189,37589,391,18767,798,18822,0,0,826,17865,363,9818,830,27683,California
El Dorado,2021-02-16,1220,38809,540,19307,680,19502,0,0,675,17997,544,10362,676,28359,California
El Dorado,2021-02-17,964,39773,428,19735,536,20038,0,0,466,17965,498,10860,466,28825,California
El Dorado,2021-02-18,2135,41908,1043,20778,1092,21130,0,0,1086,18005,1046,11906,1086,29911,California
El Dorado,2021-02-19,1248,43156,668,21446,580,21710,0,0,700,18160,545,12451,700,30611,California
El Dorado,2021-02-20,1112,44268,464,21910,648,22358,0,0,696,18446,411,12862,697,31308,California
El Dorado,2021-02-21,378,44646,245,22155,133,22491,0,0,181,18430,197,13059,181,31489,California
El Dorado,2021-02-22,933,45579,467,22622,466,22957,0,0,295,18090,635,13694,295,31784,California
El Dorado,2021-02-23,917,46496,519,23141,398,23355,0,0,363,17903,550,14244,363,32147,California
El Dorado,2021-02-24,1078,47574,475,23616,603,23958,0,0,448,17723,628,14872,448,32595,California
El Dorado,2021-02-25,1986,49560,1196,24812,790,24748,0,0,707,17165,1269,16141,711,33306,California
El Dorado,2021-02-26,2517,52077,1576,26388,941,25689,0,0,1687,18030,822,16963,1687,34993,California
El Dorado,2021-02-27,1791,53868,454,26842,1337,27026,0,0,1333,18908,455,17418,1333,36326,California
El Dorado,2021-02-28,990,54858,239,27081,751,27777,0,0,518,18957,470,17888,519,36845,California
El Dorado,2021-03-01,1207,56065,479,27560,726,28503,2,2,670,19093,536,18424,672,37517,California
El Dorado,2021-03-02,974,57039,294,27854,679,29182,1,3,503,19130,468,18892,505,38022,California
El Dorado,2021-03-03,1796,58835,496,28350,1300,30482,0,3,1219,19783,569,19461,1222,39244,California
El Dorado,2021-03-04,2585,61420,1585,29935,999,31481,1,4,1219,19643,1360,20821,1220,40464,California
El Dorado,2021-03-05,1627,63047,451,30386,1171,32652,5,9,1075,20177,546,21367,1080,41544,California
El Dorado,2021-03-06,760,63807,228,30614,501,33153,31,40,400,20251,357,21724,431,41975,California
El Dorado,2021-03-07,892,64699,201,30815,656,33809,35,75,259,19916,629,22353,294,42269,California
El Dorado,2021-03-08,1381,66080,388,31203,918,34727,75,150,892,20396,485,22838,965,43234,California
El Dorado,2021-03-09,1018,67098,241,31444,708,35435,69,219,604,20671,398,23236,673,43907,California
El Dorado,2021-03-10,991,68089,349,31793,585,36020,57,276,576,20895,408,23644,632,44539,California
El Dorado,2021-03-11,3091,71180,1868,33661,1034,37054,189,465,1310,20635,1756,25400,1496,46035,California
El Dorado,2021-03-12,1830,73010,633,34294,945,37999,252,717,764,20602,1049,26449,1016,47051,California
El Dorado,2021-03-13,1149,74159,350,34644,515,38514,284,1001,439,20617,706,27155,721,47772,California
El Dorado,2021-03-14,1027,75186,205,34849,710,39224,112,1113,283,20270,742,27897,395,48167,California
El Dorado,2021-03-15,1424,76610,306,35155,988,40212,130,1243,619,20216,801,28698,747,48914,California
El Dorado,2021-03-16,1249,77859,437,35592,666,40878,146,1389,575,20267,669,29367,720,49634,California
El Dorado,2021-03-17,1192,79051,390,35982,701,41579,101,1490,775,20724,416,29783,873,50507,California
El Dorado,2021-03-18,3066,82117,1813,37795,1211,42790,42,1532,2011,21736,1041,30824,2053,52560,California
El Dorado,2021-03-19,1137,83254,363,38158,614,43404,160,1692,626,22012,508,31332,784,53344,California
El Dorado,2021-03-20,1100,84354,269,38427,816,44220,15,1707,508,21955,580,31912,523,53867,California
El Dorado,2021-03-21,1117,85471,428,38855,684,44904,5,1712,922,22691,192,32104,928,54795,California
El Dorado,2021-03-22,1531,87002,504,39359,944,45848,83,1795,1197,23643,328,32432,1280,56075,California
El Dorado,2021-03-23,1172,88174,464,39823,613,46461,95,1890,736,24052,422,32854,831,56906,California
El Dorado,2021-03-24,1480,89654,641,40464,640,47101,199,2089,646,24091,806,33660,845,57751,California
El Dorado,2021-03-25,2551,92205,1712,42176,731,47832,108,2197,1375,24408,1167,34827,1484,59235,California
El Dorado,2021-03-26,1858,94063,710,42886,1034,48866,114,2311,926,24541,906,35733,1039,60274,California
El Dorado,2021-03-27,1525,95588,193,43079,1328,50194,4,2315,477,23981,1041,36774,481,60755,California
El Dorado,2021-03-28,700,96288,187,43266,501,50695,12,2327,157,23612,538,37312,169,60924,California
El Dorado,2021-03-29,1340,97628,449,43715,875,51570,16,2343,827,23946,509,37821,843,61767,California
El Dorado,2021-03-30,1399,99027,432,44147,868,52438,99,2442,690,24034,700,38521,788,62555,California
El Dorado,2021-03-31,1585,100612,595,44742,920,53358,70,2512,656,23832,925,39446,723,63278,California
El Dorado,2021-04-01,3259,103871,1786,46528,1391,54749,82,2594,1540,23740,1715,41161,1623,64901,California
El Dorado,2021-04-02,1912,105783,572,47100,1244,55993,96,2690,737,23405,1168,42329,833,65734,California
El Dorado,2021-04-03,761,106544,302,47402,339,56332,120,2810,228,23224,529,42858,348,66082,California
El Dorado,2021-04-04,276,106820,83,47485,145,56477,48,2858,96,23190,179,43037,145,66227,California
El Dorado,2021-04-05,1450,108270,430,47915,927,57404,93,2951,588,23017,853,43890,680,66907,California
El Dorado,2021-04-06,1436,109706,537,48452,678,58082,221,3172,441,22685,990,44880,658,67565,California
El Dorado,2021-04-07,1618,111324,575,49027,585,58667,458,3630,536,22597,1078,45958,990,68555,California
El Dorado,2021-04-08,2738,114062,1751,50778,747,59414,240,3870,1121,22347,1609,47567,1359,69914,California
El Dorado,2021-04-09,1451,115513,450,51228,777,60191,224,4094,569,22254,879,48446,786,70700,California
El Dorado,2021-04-10,1018,116531,225,51453,681,60872,112,4206,662,22673,353,48799,772,71472,California
El Dorado,2021-04-11,781,117312,459,51912,306,61178,16,4222,211,22331,569,49368,227,71699,California
El Dorado,2021-04-12,1311,118623,513,52425,647,61825,151,4373,561,22301,741,50109,711,72410,California
El Dorado,2021-04-13,1142,119765,621,53046,521,62346,0,4373,513,22189,625,50734,513,72923,California
El Dorado,2021-04-14,1114,120879,476,53522,637,62983,1,4374,375,21843,722,51456,376,73299,California
El Dorado,2021-04-15,2549,123428,1711,55233,838,63821,0,4374,954,21209,1589,53045,955,74254,California
El Dorado,2021-04-16,1488,124916,525,55758,963,64784,0,4374,609,20947,872,53917,610,74864,California
El Dorado,2021-04-17,1030,125946,210,55968,819,65603,1,4375,712,21344,315,54232,712,75576,California
El Dorado,2021-04-18,1225,127171,119,56087,1106,66709,0,4375,429,20980,793,55025,429,76005,California
El Dorado,2021-04-19,1749,128920,449,56536,1300,68009,0,4375,692,20622,1050,56075,692,76697,California
El Dorado,2021-04-20,1164,130084,409,56945,755,68764,0,4375,483,20429,677,56752,484,77181,California
El Dorado,2021-04-21,1251,131335,544,57489,702,69466,5,4380,642,20472,601,57353,644,77825,California
El Dorado,2021-04-22,2638,133973,1750,59239,888,70354,0,4380,1091,20021,1544,58897,1093,78918,California
El Dorado,2021-04-23,1464,135437,539,59778,924,71278,1,4381,743,20049,718,59615,746,79664,California
El Dorado,2021-04-24,1058,136495,525,60303,533,71811,0,4381,815,20624,240,59855,815,80479,California
El Dorado,2021-04-25,842,137337,456,60759,386,72197,0,4381,482,20746,360,60215,482,80961,California
El Dorado,2021-04-26,1234,138571,514,61273,703,72900,17,4398,583,20699,646,60861,599,81560,California
El Dorado,2021-04-27,1169,139740,455,61728,676,73576,38,4436,533,20641,629,61490,571,82131,California
El Dorado,2021-04-28,1145,140885,433,62161,672,74248,40,4476,498,20535,645,62135,539,82670,California
El Dorado,2021-04-29,2054,142939,1421,63582,601,74849,32,4508,624,19764,1427,63562,656,83326,California
El Dorado,2021-04-30,2194,145133,1400,64982,752,75601,42,4550,1411,20450,766,64328,1452,84778,California
El Dorado,2021-05-01,621,145754,282,65264,311,75912,28,4578,283,20430,331,64659,311,85089,California
El Dorado,2021-05-02,303,146057,214,65478,59,75971,30,4608,99,20357,201,64860,128,85217,California
El Dorado,2021-05-03,844,146901,419,65897,374,76345,51,4659,287,20143,553,65413,339,85556,California
El Dorado,2021-05-04,934,147835,479,66376,395,76740,60,4719,339,19951,591,66004,399,85955,California
El Dorado,2021-05-05,916,148751,463,66839,378,77118,75,4794,443,19998,471,66475,518,86473,California
El Dorado,2021-05-06,1154,149905,507,67346,599,77717,48,4842,486,19870,658,67133,530,87003,California
El Dorado,2021-05-07,1012,150917,399,67745,554,78271,59,4901,410,19736,602,67735,468,87471,California
El Dorado,2021-05-08,688,151605,164,67909,487,78758,37,4938,208,19504,477,68212,245,87716,California
El Dorado,2021-05-09,237,151842,97,68006,112,78870,28,4966,104,19504,132,68344,132,87848,California
El Dorado,2021-05-10,835,152677,277,68283,499,79369,59,5025,243,19222,582,68926,300,88148,California
El Dorado,2021-05-11,708,153385,318,68601,328,79697,62,5087,288,19156,417,69343,351,88499,California
El Dorado,2021-05-12,654,154039,346,68947,267,79964,41,5128,252,19048,402,69745,294,88793,California
El Dorado,2021-05-13,1278,155317,807,69754,431,80395,40,5168,471,18757,801,70546,510,89303,California
El Dorado,2021-05-14,1436,156753,839,70593,513,80908,84,5252,677,18764,754,71300,761,90064,California
El Dorado,2021-05-15,914,157667,565,71158,291,81199,58,5310,323,18554,591,71891,381,90445,California
El Dorado,2021-05-16,882,158549,469,71627,387,81586,26,5336,236,18171,645,72536,262,90707,California
El Dorado,2021-05-17,1611,160160,689,72316,873,82459,49,5385,561,17734,1046,73582,609,91316,California
El Dorado,2021-05-18,1054,161214,542,72858,458,82917,54,5439,436,17609,617,74199,492,91808,California
El Dorado,2021-05-19,878,162092,388,73246,436,83353,54,5493,310,17411,561,74760,363,92171,California
El Dorado,2021-05-20,1218,163310,688,73934,452,83805,78,5571,448,17166,768,75528,523,92694,California
El Dorado,2021-05-21,2358,165668,1765,75699,553,84358,40,5611,810,16474,1542,77070,850,93544,California
El Dorado,2021-05-22,710,166378,207,75906,466,84824,37,5648,223,16248,486,77556,260,93804,California
El Dorado,2021-05-23,386,166764,133,76039,225,85049,28,5676,94,16081,289,77845,122,93926,California
El Dorado,2021-05-24,920,167684,484,76523,367,85416,69,5745,331,15894,585,78430,398,94324,California
El Dorado,2021-05-25,638,168322,278,76801,322,85738,38,5783,235,15767,399,78829,272,94596,California
El Dorado,2021-05-26,826,169148,411,77212,392,86130,23,5806,285,15534,541,79370,308,94904,California
El Dorado,2021-05-27,626,169774,248,77460,343,86473,35,5841,310,15563,315,79685,344,95248,California
El Dorado,2021-05-28,755,170529,281,77741,409,86882,65,5906,320,15515,433,80118,385,95633,California
El Dorado,2021-05-29,394,170923,112,77853,265,87147,17,5923,171,15482,221,80339,188,95821,California
El Dorado,2021-05-30,173,171096,101,77954,58,87205,14,5937,82,15488,90,80429,96,95917,California
El Dorado,2021-05-31,38,171134,12,77966,14,87219,12,5949,8,15478,30,80459,20,95937,California
El Dorado,2021-06-01,693,171827,301,78267,352,87571,40,5989,238,15304,452,80911,278,96215,California
El Dorado,2021-06-02,634,172461,306,78573,277,87848,51,6040,264,15251,368,81279,315,96530,California
El Dorado,2021-06-03,734,173195,340,78913,351,88199,43,6083,177,14914,557,81836,220,96750,California
El Dorado,2021-06-04,905,174100,544,79457,327,88526,34,6117,195,14435,708,82544,229,96979,California
El Dorado,2021-06-05,391,174491,226,79683,153,88679,12,6129,81,14219,309,82853,93,97072,California
El Dorado,2021-06-06,284,174775,198,79881,70,88749,16,6145,52,14055,231,83084,67,97139,California
El Dorado,2021-06-07,793,175568,494,80375,259,89008,40,6185,172,13654,613,83697,212,97351,California
El Dorado,2021-06-08,632,176200,383,80758,215,89223,34,6219,132,13322,497,84194,165,97516,California
El Dorado,2021-06-09,467,176667,279,81037,163,89386,25,6244,110,13100,357,84551,135,97651,California
El Dorado,2021-06-10,593,177260,370,81407,192,89578,31,6275,161,12862,430,84981,192,97843,California
El Dorado,2021-06-11,660,177920,398,81805,218,89796,44,6319,129,12505,530,85511,173,98016,California
El Dorado,2021-06-12,261,178181,152,81957,90,89886,19,6338,58,12380,202,85713,77,98093,California
El Dorado,2021-06-13,161,178342,89,82046,54,89940,18,6356,32,12302,128,85841,50,98143,California
El Dorado,2021-06-14,518,178860,364,82410,124,90064,30,6386,122,12058,396,86237,152,98295,California
El Dorado,2021-06-15,465,179325,257,82667,171,90235,37,6423,123,11880,338,86575,160,98455,California
El Dorado,2021-06-16,508,179833,359,83026,107,90342,42,6465,128,11671,379,86954,170,98625,California
El Dorado,2021-06-17,436,180269,266,83292,137,90479,33,6498,138,11546,297,87251,172,98797,California
El Dorado,2021-06-18,415,180684,270,83562,110,90589,35,6533,121,11409,293,87544,156,98953,California
El Dorado,2021-06-19,249,180933,151,83713,83,90672,15,6548,90,11356,158,87702,105,99058,California
El Dorado,2021-06-20,125,181058,91,83804,28,90700,6,6554,52,11341,73,87775,58,99116,California
El Dorado,2021-06-21,324,181382,167,83971,131,90831,26,6580,121,11289,199,87974,147,99263,California
El Dorado,2021-06-22,400,181782,257,84228,115,90946,28,6608,128,11174,271,88245,156,99419,California
El Dorado,2021-06-23,426,182208,294,84522,110,91056,22,6630,135,11042,289,88534,157,99576,California
El Dorado,2021-06-24,393,182601,243,84765,136,91192,14,6644,146,10955,247,88781,160,99736,California
El Dorado,2021-06-25,351,182952,212,84977,101,91293,38,6682,135,10917,211,88992,173,99909,California
El Dorado,2021-06-26,209,183161,123,85100,71,91364,15,6697,70,10865,138,89130,86,99995,California
El Dorado,2021-06-27,119,183280,83,85183,30,91394,6,6703,54,10860,65,89195,60,100055,California
El Dorado,2021-06-28,305,183585,215,85398,64,91458,26,6729,132,10846,172,89367,158,100213,California
El Dorado,2021-06-29,296,183881,173,85571,102,91560,21,6750,119,10811,175,89542,140,100353,California
El Dorado,2021-06-30,246,184127,175,85746,59,91619,12,6762,121,10820,124,89666,133,100486,California
El Dorado,2021-07-01,235,184362,136,85882,83,91702,16,6778,90,10779,145,89811,104,100590,California
El Dorado,2021-07-02,261,184623,165,86047,71,91773,25,6803,113,10770,147,89958,138,100728,California
El Dorado,2021-07-03,100,184723,76,86123,19,91792,5,6808,47,10769,53,90011,52,100780,California
El Dorado,2021-07-04,4,184727,0,86123,1,91793,3,6811,0,10768,4,90015,3,100783,California
El Dorado,2021-07-05,158,184885,98,86221,53,91846,7,6818,86,10788,72,90087,92,100875,California
El Dorado,2021-07-06,296,185181,188,86409,76,91922,32,6850,116,10758,178,90265,148,101023,California
El Dorado,2021-07-07,266,185447,173,86582,78,92000,15,6865,124,10756,141,90406,139,101162,California
El Dorado,2021-07-08,304,185751,175,86757,116,92116,13,6878,149,10764,153,90559,161,101323,California
El Dorado,2021-07-09,292,186043,191,86948,79,92195,22,6900,115,10726,175,90734,137,101460,California
El Dorado,2021-07-10,142,186185,105,87053,30,92225,7,6907,51,10694,90,90824,58,101518,California
El Dorado,2021-07-11,90,186275,68,87121,13,92238,9,6916,30,10673,60,90884,39,101557,California
El Dorado,2021-07-12,255,186530,179,87300,67,92305,9,6925,122,10671,133,91017,131,101688,California
El Dorado,2021-07-13,315,186845,207,87507,83,92388,25,6950,136,10655,177,91194,161,101849,California
El Dorado,2021-07-14,194,187039,116,87623,64,92452,14,6964,84,10645,106,91300,96,101945,California
El Dorado,2021-07-15,326,187365,233,87856,80,92532,13,6977,171,10676,153,91453,184,102129,California
El Dorado,2021-07-16,295,187660,200,88056,68,92600,27,7004,158,10725,136,91589,185,102314,California
El Dorado,2021-07-17,117,187777,79,88135,30,92630,8,7012,48,10713,68,91657,56,102370,California
El Dorado,2021-07-18,98,187875,71,88206,24,92654,3,7015,48,10715,49,91706,51,102421,California
El Dorado,2021-07-19,303,188178,210,88416,85,92739,8,7023,150,10723,150,91856,158,102579,California
El Dorado,2021-07-20,309,188487,195,88611,99,92838,15,7038,174,10781,131,91987,189,102768,California
El Dorado,2021-07-21,268,188755,174,88785,81,92919,13,7051,125,10777,143,92130,139,102907,California
El Dorado,2021-07-22,273,189028,178,88963,82,93001,13,7064,161,10839,112,92242,174,103081,California
El Dorado,2021-07-23,316,189344,210,89173,88,93089,18,7082,182,10905,133,92375,199,103280,California
El Dorado,2021-07-24,141,189485,95,89268,44,93133,2,7084,69,10905,71,92446,71,103351,California
El Dorado,2021-07-25,91,189576,55,89323,28,93161,8,7092,59,10942,30,92476,67,103418,California
El Dorado,2021-07-26,318,189894,214,89537,92,93253,12,7104,222,11081,95,92571,234,103652,California
El Dorado,2021-07-27,398,190292,267,89804,103,93356,28,7132,249,11212,146,92717,277,103929,California
El Dorado,2021-07-28,308,190600,191,89995,93,93449,24,7156,189,11308,117,92834,213,104142,California
El Dorado,2021-07-29,326,190926,221,90216,87,93536,18,7174,206,11416,116,92950,224,104366,California
El Dorado,2021-07-30,371,191297,243,90459,92,93628,36,7210,212,11509,155,93105,248,104614,California
El Dorado,2021-07-31,99,191396,68,90527,21,93649,10,7220,59,11540,38,93143,69,104683,California
Fresno,2020-12-15,4,4,4,4,0,0,0,0,4,4,0,0,4,4,California
Fresno,2020-12-16,125,129,125,129,0,0,0,0,125,129,0,0,125,129,California
Fresno,2020-12-17,123,252,123,252,0,0,0,0,123,252,0,0,123,252,California
Fresno,2020-12-18,348,600,348,600,0,0,0,0,348,600,0,0,348,600,California
Fresno,2020-12-19,162,762,162,762,0,0,0,0,162,762,0,0,162,762,California
Fresno,2020-12-20,258,1020,255,1017,3,3,0,0,258,1020,0,0,258,1020,California
Fresno,2020-12-21,931,1951,929,1946,2,5,0,0,960,1980,0,0,960,1980,California
Fresno,2020-12-22,906,2857,873,2819,33,38,0,0,910,2890,0,0,910,2890,California
Fresno,2020-12-23,1095,3952,1048,3867,47,85,0,0,1096,3986,0,0,1096,3986,California
Fresno,2020-12-24,593,4545,567,4434,26,111,0,0,593,4579,0,0,593,4579,California
Fresno,2020-12-25,3,4548,1,4435,2,113,0,0,3,4582,0,0,3,4582,California
Fresno,2020-12-26,724,5272,714,5149,10,123,0,0,724,5306,0,0,724,5306,California
Fresno,2020-12-27,308,5580,209,5358,99,222,0,0,308,5614,0,0,308,5614,California
Fresno,2020-12-28,1098,6678,802,6160,296,518,0,0,1098,6712,0,0,1098,6712,California
Fresno,2020-12-29,1761,8439,997,7157,764,1282,0,0,1760,8472,0,0,1760,8472,California
Fresno,2020-12-30,986,9425,444,7601,542,1824,0,0,985,9456,1,1,985,9457,California
Fresno,2020-12-31,922,10347,308,7909,614,2438,0,0,922,10378,0,1,922,10379,California
Fresno,2021-01-01,10,10357,4,7913,6,2444,0,0,10,10388,0,1,10,10389,California
Fresno,2021-01-02,1027,11384,711,8624,316,2760,0,0,1027,11415,0,1,1027,11416,California
Fresno,2021-01-03,156,11540,129,8753,27,2787,0,0,156,11571,0,1,156,11572,California
Fresno,2021-01-04,626,12166,376,9129,250,3037,0,0,626,12197,0,1,626,12198,California
Fresno,2021-01-05,790,12956,313,9442,477,3514,0,0,715,12838,75,76,716,12914,California
Fresno,2021-01-06,997,13953,349,9791,648,4162,0,0,822,13485,175,251,822,13736,California
Fresno,2021-01-07,1915,15868,919,10710,996,5158,0,0,1660,14893,255,506,1663,15399,California
Fresno,2021-01-08,1789,17657,612,11322,1177,6335,0,0,1424,15955,363,869,1425,16824,California
Fresno,2021-01-09,639,18296,391,11713,248,6583,0,0,360,16036,279,1148,360,17184,California
Fresno,2021-01-10,513,18809,483,12196,30,6613,0,0,201,15925,312,1460,201,17385,California
Fresno,2021-01-11,2231,21040,1813,14009,418,7031,0,0,1533,16763,699,2159,1537,18922,California
Fresno,2021-01-12,2534,23574,1827,15836,707,7738,0,0,1681,17591,855,3014,1683,20605,California
Fresno,2021-01-13,3583,27157,2443,18279,1140,8878,0,0,2721,19453,862,3876,2724,23329,California
Fresno,2021-01-14,4172,31329,2203,20482,1969,10847,0,0,3697,22676,474,4350,3697,27026,California
Fresno,2021-01-15,3676,35005,2540,23022,1136,11983,0,0,3318,25640,358,4708,3322,30348,California
Fresno,2021-01-16,3139,38144,2307,25329,832,12815,0,0,2670,27843,469,5177,2672,33020,California
Fresno,2021-01-17,976,39120,556,25885,420,13235,0,0,777,28421,199,5376,777,33797,California
Fresno,2021-01-18,3089,42209,2374,28259,715,13950,0,0,2430,30195,658,6034,2432,36229,California
Fresno,2021-01-19,4357,46566,2556,30815,1801,15751,0,0,3692,33226,665,6699,3696,39925,California
Fresno,2021-01-20,3057,49623,1231,32046,1826,17577,0,0,2740,35656,313,7012,2743,42668,California
Fresno,2021-01-21,4439,54062,2078,34124,2361,19938,0,0,4072,39391,344,7356,4079,46747,California
Fresno,2021-01-22,3329,57391,1354,35478,1975,21913,0,0,2945,41970,367,7723,2946,49693,California
Fresno,2021-01-23,3057,60448,1979,37457,1078,22991,0,0,2334,43586,723,8446,2339,52032,California
Fresno,2021-01-24,564,61012,380,37837,184,23175,0,0,353,43730,211,8657,355,52387,California
Fresno,2021-01-25,2438,63450,861,38698,1577,24752,0,0,1856,45007,582,9239,1859,54246,California
Fresno,2021-01-26,2097,65547,606,39304,1491,26243,0,0,1331,45575,764,10003,1332,55578,California
Fresno,2021-01-27,2412,67959,1241,40545,1171,27414,0,0,1732,46643,675,10678,1743,57321,California
Fresno,2021-01-28,4570,72529,3067,43612,1503,28917,0,0,3472,49024,1094,11772,3475,60796,California
Fresno,2021-01-29,1678,74207,953,44565,725,29642,0,0,1372,50096,301,12073,1373,62169,California
Fresno,2021-01-30,1423,75630,525,45090,898,30540,0,0,1005,50683,418,12491,1005,63174,California
Fresno,2021-01-31,228,75858,216,45306,12,30552,0,0,74,50603,154,12645,74,63248,California
Fresno,2021-02-01,3358,79216,1663,46969,1695,32247,0,0,1762,50783,1594,14239,1774,65022,California
Fresno,2021-02-02,2753,81969,564,47533,2189,34436,0,0,1586,51234,1151,15390,1602,66624,California
Fresno,2021-02-03,3585,85554,2116,49649,1469,35905,0,0,1543,50751,2027,17417,1544,68168,California
Fresno,2021-02-04,4230,89784,1910,51559,2320,38225,0,0,1922,50400,2278,19695,1927,70095,California
Fresno,2021-02-05,5358,95142,2730,54289,2628,40853,0,0,2297,49647,3054,22749,2301,72396,California
Fresno,2021-02-06,2933,98075,2042,56331,891,41744,0,0,961,48644,1965,24714,962,73358,California
Fresno,2021-02-07,465,98540,282,56613,183,41927,0,0,266,48712,198,24912,266,73624,California
Fresno,2021-02-08,4296,102836,2290,58903,2006,43933,0,0,1816,48071,2466,27378,1825,75449,California
Fresno,2021-02-09,5340,108176,2088,60991,3252,47185,0,0,3114,49046,2148,29526,3123,78572,California
Fresno,2021-02-10,3903,112079,1234,62225,2669,49854,0,0,1959,49128,1889,31415,1971,80543,California
Fresno,2021-02-11,6476,118555,2092,64317,4384,54238,0,0,3315,49305,3143,34558,3320,83863,California
Fresno,2021-02-12,5448,124003,1393,65710,4055,58293,0,0,2730,49346,2699,37257,2740,86603,California
Fresno,2021-02-13,3762,127765,1577,67287,2185,60478,0,0,2089,49780,1660,38917,2094,88697,California
Fresno,2021-02-14,1582,129347,290,67577,1292,61770,0,0,847,49897,732,39649,849,89546,California
Fresno,2021-02-15,2902,132249,272,67849,2630,64400,0,0,1801,50605,1097,40746,1805,91351,California
Fresno,2021-02-16,6769,139018,2425,70274,4344,68744,0,0,4248,52359,2500,43246,4254,95605,California
Fresno,2021-02-17,5353,144371,2475,72749,2878,71622,0,0,2976,53004,2335,45581,2980,98585,California
Fresno,2021-02-18,6929,151300,2933,75682,3996,75618,0,0,2579,51288,4306,49887,2590,101175,California
Fresno,2021-02-19,3975,155275,1136,76818,2839,78457,0,0,1837,51004,2124,52011,1840,103015,California
Fresno,2021-02-20,4648,159923,2551,79369,2097,80554,0,0,3125,52621,1515,53526,3132,106147,California
Fresno,2021-02-21,207,160130,187,79556,20,80574,0,0,133,52695,59,53585,133,106280,California
Fresno,2021-02-22,2346,162476,1051,80607,1295,81869,0,0,1282,52927,1053,54638,1285,107565,California
Fresno,2021-02-23,4792,167268,2326,82933,2466,84335,0,0,3881,55913,897,55535,3883,111448,California
Fresno,2021-02-24,4324,171592,1547,84480,2777,87112,0,0,3517,58642,792,56327,3521,114969,California
Fresno,2021-02-25,8915,180507,3830,88310,5085,92197,0,0,7347,64498,1499,57826,7355,122324,California
Fresno,2021-02-26,9341,189848,3843,92153,5498,97695,0,0,7951,71092,1362,59188,7956,130280,California
Fresno,2021-02-27,7532,197380,3241,95394,4290,101985,1,1,6784,77151,730,59918,6789,137069,California
Fresno,2021-02-28,1711,199091,545,95939,1166,103151,0,1,1608,78672,88,60006,1609,138678,California
Fresno,2021-03-01,5247,204338,1386,97325,3860,107011,1,2,3798,81046,1429,61435,3803,142481,California
Fresno,2021-03-02,10017,214355,3449,100774,6568,113579,0,2,8588,88258,1404,62839,8616,151097,California
Fresno,2021-03-03,7142,221497,1804,102578,5336,118915,2,4,6109,93461,1019,63858,6222,157319,California
Fresno,2021-03-04,10624,232121,4166,106744,6458,125373,0,4,8835,100546,1761,65619,8846,166165,California
Fresno,2021-03-05,9622,241743,3740,110484,5880,131253,2,6,8293,107721,1195,66814,8370,174535,California
Fresno,2021-03-06,7126,248869,3981,114465,3026,134279,119,125,6119,112967,997,67811,6243,180778,California
Fresno,2021-03-07,1563,250432,692,115157,789,135068,82,207,1289,114068,271,68082,1372,182150,California
Fresno,2021-03-08,5370,255802,2064,117221,3140,138208,166,373,4060,117009,1297,69379,4238,186388,California
Fresno,2021-03-09,8682,264484,3802,121023,4605,142813,275,648,4671,118005,3988,73367,4984,191372,California
Fresno,2021-03-10,6886,271370,2880,123903,3616,146429,390,1038,5362,122251,1514,74881,5760,197132,California
Fresno,2021-03-11,11605,282975,4591,128494,6463,152892,551,1589,6301,123901,5277,80158,6927,204059,California
Fresno,2021-03-12,12058,295033,5146,133640,6483,159375,429,2018,9042,130518,2993,83151,9610,213669,California
Fresno,2021-03-13,8344,303377,4069,137709,3258,162633,1017,3035,4000,131291,4319,87470,5092,218761,California
Fresno,2021-03-14,1787,305164,485,138194,1013,163646,289,3324,677,131159,1098,88568,966,219727,California
Fresno,2021-03-15,7146,312310,3182,141376,3789,167435,175,3499,4924,134255,2206,90774,5302,225029,California
Fresno,2021-03-16,10232,322542,4557,145933,5284,172719,391,3890,5401,135346,4798,95572,5889,230918,California
Fresno,2021-03-17,8749,331291,3994,149927,4044,176763,711,4601,5915,139574,2808,98380,7036,237954,California
Fresno,2021-03-18,12586,343877,6822,156749,5088,181851,676,5277,7024,142256,5513,103893,8195,246149,California
Fresno,2021-03-19,11266,355143,5975,162724,4676,186527,615,5892,6878,145774,4352,108245,7870,254019,California
Fresno,2021-03-20,7666,362809,4646,167370,2694,189221,326,6218,3744,146267,3895,112140,4388,258407,California
Fresno,2021-03-21,1854,364663,1263,168633,212,189433,379,6597,1011,146823,836,112976,1392,259799,California
Fresno,2021-03-22,5734,370397,2947,171580,2188,191621,599,7196,3795,149538,1920,114896,4635,264434,California
Fresno,2021-03-23,10705,381102,5371,176951,4826,196447,508,7704,5077,149971,5601,120497,6034,270468,California
Fresno,2021-03-24,8930,390032,3866,180817,4230,200677,834,8538,4945,151858,3945,124442,5832,276300,California
Fresno,2021-03-25,12285,402317,5716,186533,5748,206425,821,9359,4699,149930,7530,131972,5602,281902,California
Fresno,2021-03-26,12302,414619,5484,192017,6168,212593,650,10009,4317,146996,7924,139896,4990,286892,California
Fresno,2021-03-27,10171,424790,4879,196896,4210,216803,1082,11091,2884,143720,7245,147141,3969,290861,California
Fresno,2021-03-28,3445,428235,1332,198228,1414,218217,699,11790,1088,143611,2344,149485,2235,293096,California
Fresno,2021-03-29,6018,434253,2024,200252,3455,221672,539,12329,2852,143876,3138,152623,3403,296499,California
Fresno,2021-03-30,11036,445289,4289,204541,5840,227512,907,13236,3757,141299,7240,159863,4663,301162,California
Fresno,2021-03-31,9762,455051,3409,207950,5335,232847,1018,14254,3638,139874,6073,165936,4648,305810,California
Fresno,2021-04-01,12242,467293,4211,212161,7169,240016,862,15116,3966,136486,8170,174106,4782,310592,California
Fresno,2021-04-02,12140,479433,4639,216800,6708,246724,793,15909,4117,133523,7875,181981,4912,315504,California
Fresno,2021-04-03,6444,485877,3536,220336,2642,249366,266,16175,2128,131657,4294,186275,2428,317932,California
Fresno,2021-04-04,1513,487390,540,220876,927,250293,46,16221,547,131295,955,187230,593,318525,California
Fresno,2021-04-05,8382,495772,4498,225374,3073,253366,811,17032,2452,128716,5910,193140,3331,321856,California
Fresno,2021-04-06,9725,505497,4068,229442,4452,257818,1205,18237,3560,127373,6124,199264,4781,326637,California
Fresno,2021-04-07,10660,516157,5505,234947,3920,261738,1235,19472,3546,125114,7064,206328,4805,331442,California
Fresno,2021-04-08,11065,527222,5241,240188,4649,266387,1175,20647,3493,122306,7512,213840,4704,336146,California
Fresno,2021-04-09,11812,539034,5519,245707,4875,271262,1418,22065,3704,119389,8056,221896,5139,341285,California
Fresno,2021-04-10,7925,546959,5178,250885,2225,273487,522,22587,3672,119348,4232,226128,4191,345476,California
Fresno,2021-04-11,1402,548361,942,251827,369,273856,91,22678,444,118932,952,227080,536,346012,California
Fresno,2021-04-12,7653,556014,4129,255956,2569,276425,955,23633,2455,117174,5166,232246,3408,349420,California
Fresno,2021-04-13,9070,565084,4336,260292,4664,281089,70,23703,3529,115368,5501,237747,3695,353115,California
Fresno,2021-04-14,9768,574852,5823,266115,3944,285033,1,23704,3789,113272,5933,243680,3837,356952,California
Fresno,2021-04-15,8482,583334,4217,270332,4262,289295,3,23707,3144,111114,5307,248987,3149,360101,California
Fresno,2021-04-16,9641,592975,4694,275026,4945,294240,2,23709,3925,109378,5669,254656,3933,364034,California
Fresno,2021-04-17,5677,598652,3791,278817,1886,296126,0,23709,2669,109067,2982,257638,2671,366705,California
Fresno,2021-04-18,1168,599820,683,279500,485,296611,0,23709,525,108954,638,258276,525,367230,California
Fresno,2021-04-19,5818,605638,3243,282743,2572,299183,3,23712,2245,107675,3530,261806,2251,369481,California
Fresno,2021-04-20,7226,612864,3694,286437,3524,302707,8,23720,2674,105834,4522,266328,2681,372162,California
Fresno,2021-04-21,7110,619974,4226,290663,2875,305582,9,23729,2879,104543,4182,270510,2891,375053,California
Fresno,2021-04-22,6631,626605,3394,294057,3236,308818,1,23730,2425,102836,4136,274646,2429,377482,California
Fresno,2021-04-23,7449,634054,4107,298164,3325,312143,17,23747,2839,101167,4513,279159,2844,380326,California
Fresno,2021-04-24,4231,638285,2535,300699,1696,313839,0,23747,1921,100806,2282,281441,1921,382247,California
Fresno,2021-04-25,1390,639675,562,301261,825,314664,3,23750,694,100815,688,282129,697,382944,California
Fresno,2021-04-26,4385,644060,2254,303515,2085,316749,46,23796,1849,100206,2503,284632,1894,384838,California
Fresno,2021-04-27,4964,649024,2558,306073,2280,319029,126,23922,1939,99273,2996,287628,2063,386901,California
Fresno,2021-04-28,4963,653987,2842,308915,1991,321020,130,24052,2090,98650,2844,290472,2221,389122,California
Fresno,2021-04-29,4973,658960,2799,311714,2037,323057,137,24189,1897,97640,3041,293513,2031,391153,California
Fresno,2021-04-30,5624,664584,3458,315172,2033,325090,133,24322,2255,96697,3330,296843,2387,393540,California
Fresno,2021-05-01,4252,668836,3493,318665,622,325712,137,24459,1258,95122,2969,299812,1394,394934,California
Fresno,2021-05-02,1274,670110,790,319455,431,326143,53,24512,632,95174,630,300442,682,395616,California
Fresno,2021-05-03,4128,674238,2748,322203,1185,327328,195,24707,1330,93927,2767,303209,1520,397136,California
Fresno,2021-05-04,5004,679242,2646,324849,2205,329533,153,24860,1589,92284,3387,306596,1744,398880,California
Fresno,2021-05-05,5449,684691,3467,328316,1755,331288,227,25087,1697,90484,3720,310316,1920,400800,California
Fresno,2021-05-06,4592,689283,2995,331311,1495,332783,102,25189,1580,89190,2976,313292,1682,402482,California
Fresno,2021-05-07,5179,694462,3442,334753,1571,334354,166,25355,1597,87394,3555,316847,1759,404241,California
Fresno,2021-05-08,4101,698563,2670,337423,1282,335636,149,25504,1268,86007,2805,319652,1418,405659,California
Fresno,2021-05-09,721,699284,390,337813,286,335922,45,25549,349,86035,366,320018,394,406053,California
Fresno,2021-05-10,3021,702305,1620,339433,1258,337180,143,25692,940,85048,2070,322088,1083,407136,California
Fresno,2021-05-11,3958,706263,2111,341544,1752,338932,95,25787,1280,83762,2661,324749,1375,408511,California
Fresno,2021-05-12,4190,710453,2734,344278,1293,340225,163,25950,1411,82590,2747,327496,1575,410086,California
Fresno,2021-05-13,4191,714644,2461,346739,1627,341852,103,26053,1868,82279,2283,329779,1972,412058,California
Fresno,2021-05-14,5157,719801,3108,349847,1865,343717,184,26237,2172,81687,2949,332728,2357,414415,California
Fresno,2021-05-15,3669,723470,2754,352601,783,344500,132,26369,1874,81910,1780,334508,2003,416418,California
Fresno,2021-05-16,1598,725068,1090,353691,474,344974,34,26403,920,82193,672,335180,955,417373,California
Fresno,2021-05-17,4205,729273,2844,356535,1201,346175,160,26563,2219,82615,1955,337135,2377,419750,California
Fresno,2021-05-18,4127,733400,2554,359089,1419,347594,154,26717,2076,82818,2024,339159,2227,421977,California
Fresno,2021-05-19,4364,737764,2770,361859,1420,349014,174,26891,2060,82773,2280,341439,2235,424212,California
Fresno,2021-05-20,4158,741922,2498,364357,1470,350484,190,27081,1904,82632,2233,343672,2092,426304,California
Fresno,2021-05-21,4665,746587,3071,367428,1499,351983,95,27176,2105,82302,2527,346199,2197,428501,California
Fresno,2021-05-22,3965,750552,2937,370365,854,352837,174,27350,2277,83080,1671,347870,2449,430950,California
Fresno,2021-05-23,1025,751577,693,371058,302,353139,30,27380,530,83154,486,348356,560,431510,California
Fresno,2021-05-24,3317,754894,2111,373169,1091,354230,115,27495,1533,83042,1760,350116,1648,433158,California
Fresno,2021-05-25,3230,758124,1934,375103,1171,355401,125,27620,1353,82656,1863,351979,1477,434635,California
Fresno,2021-05-26,3258,761382,2148,377251,1002,356403,108,27728,1571,82667,1667,353646,1678,436313,California
Fresno,2021-05-27,3163,764545,1925,379176,1131,357534,107,27835,1317,82271,1822,355468,1426,437739,California
Fresno,2021-05-28,3453,767998,2219,381395,1139,358673,95,27930,1868,82677,1557,357025,1963,439702,California
Fresno,2021-05-29,2298,770296,1670,383065,557,359230,71,28001,1192,82845,1096,358121,1264,440966,California
Fresno,2021-05-30,906,771202,545,383610,325,359555,36,28037,420,82832,468,358589,455,441421,California
Fresno,2021-05-31,323,771525,160,383770,152,359707,11,28048,134,82792,183,358772,143,441564,California
Fresno,2021-06-01,3036,774561,1826,385596,1112,360819,98,28146,1141,82158,1871,360643,1237,442801,California
Fresno,2021-06-02,2670,777231,1718,387314,863,361682,89,28235,1060,81732,1577,362220,1151,443952,California
Fresno,2021-06-03,2980,780211,2040,389354,838,362520,102,28337,1115,81103,1844,364064,1215,445167,California
Fresno,2021-06-04,3262,783473,2359,391713,800,363320,103,28440,1074,80119,2162,366226,1178,446345,California
Fresno,2021-06-05,3143,786616,2324,394037,696,364016,123,28563,1231,79585,1886,368112,1352,447697,California
Fresno,2021-06-06,1189,787805,943,394980,208,364224,38,28601,350,79141,833,368945,389,448086,California
Fresno,2021-06-07,3115,790920,2441,397421,583,364807,91,28692,894,77928,2198,371143,985,449071,California
Fresno,2021-06-08,2775,793695,2040,399461,649,365456,86,28778,808,76867,1954,373097,893,449964,California
Fresno,2021-06-09,2965,796660,2210,401671,656,366112,99,28877,982,75982,1964,375061,1079,451043,California
Fresno,2021-06-10,2674,799334,1945,403616,659,366771,70,28947,913,75227,1737,376798,982,452025,California
Fresno,2021-06-11,3234,802568,2276,405892,846,367617,112,29059,1182,74504,2016,378814,1293,453318,California
Fresno,2021-06-12,2915,805483,2307,408199,443,368060,165,29224,779,73321,2122,380936,939,454257,California
Fresno,2021-06-13,717,806200,463,408662,237,368297,17,29241,191,73007,522,381458,208,454465,California
Fresno,2021-06-14,2544,808744,1847,410509,564,368861,133,29374,961,72539,1560,383018,1092,455557,California
Fresno,2021-06-15,2389,811133,1714,412223,595,369456,80,29454,946,72135,1427,384445,1023,456580,California
Fresno,2021-06-16,2647,813780,1896,414119,638,370094,113,29567,1044,71701,1589,386034,1155,457735,California
Fresno,2021-06-17,2271,816051,1588,415707,589,370683,94,29661,955,71448,1300,387334,1047,458782,California
Fresno,2021-06-18,3023,819074,2165,417872,740,371423,118,29779,1204,70968,1802,389136,1322,460104,California
Fresno,2021-06-19,1695,820769,1252,419124,367,371790,76,29855,581,70513,1110,390246,655,460759,California
Fresno,2021-06-20,503,821272,354,419478,138,371928,11,29866,194,70416,302,390548,205,460964,California
Fresno,2021-06-21,1645,822917,1093,420571,486,372414,66,29932,947,70745,684,391232,1013,461977,California
Fresno,2021-06-22,2190,825107,1514,422085,566,372980,110,30042,1020,70716,1156,392388,1127,463104,California
Fresno,2021-06-23,2073,827180,1482,423567,524,373504,67,30109,1021,70768,1034,393422,1086,464190,California
Fresno,2021-06-24,2017,829197,1427,424994,514,374018,76,30185,904,70651,1096,394518,979,465169,California
Fresno,2021-06-25,2073,831270,1440,426434,549,374567,84,30269,978,70638,1075,395593,1062,466231,California
Fresno,2021-06-26,1835,833105,1421,427855,314,374881,100,30369,716,70340,1114,396707,816,467047,California
Fresno,2021-06-27,915,834020,676,428531,140,375021,99,30468,464,70454,446,397153,560,467607,California
Fresno,2021-06-28,1634,835654,1236,429767,301,375322,97,30565,727,70379,896,398049,821,468428,California
Fresno,2021-06-29,1797,837451,1189,430956,524,375846,84,30649,805,70283,984,399033,888,469316,California
Fresno,2021-06-30,1735,839186,1184,432140,461,376307,90,30739,756,70165,964,399997,846,470162,California
Fresno,2021-07-01,1601,840787,1164,433304,371,376678,66,30805,696,70032,893,400890,760,470922,California
Fresno,2021-07-02,1723,842510,1228,434532,428,377106,67,30872,821,70027,892,401782,887,471809,California
Fresno,2021-07-03,1077,843587,793,435325,254,377360,30,30902,533,70057,533,402315,563,472372,California
Fresno,2021-07-04,86,843673,28,435353,52,377412,6,30908,32,70041,54,402369,38,472410,California
Fresno,2021-07-05,1017,844690,731,436084,245,377657,41,30949,451,69970,562,402931,491,472901,California
Fresno,2021-07-06,2051,846741,1428,437512,534,378191,89,31038,815,69662,1211,404142,903,473804,California
Fresno,2021-07-07,1794,848535,1362,438874,361,378552,71,31109,784,69519,996,405138,853,474657,California
Fresno,2021-07-08,1765,850300,1151,440025,493,379045,121,31230,754,69393,999,406137,873,475530,California
Fresno,2021-07-09,2078,852378,1512,441537,480,379525,86,31316,913,69240,1152,407289,999,476529,California
Fresno,2021-07-10,1176,853554,827,442364,266,379791,83,31399,470,69097,696,407985,553,477082,California
Fresno,2021-07-11,481,854035,354,442718,117,379908,10,31409,248,69129,226,408211,258,477340,California
Fresno,2021-07-12,1650,855685,1248,443966,336,380244,66,31475,709,68976,928,409139,775,478115,California
Fresno,2021-07-13,1611,857296,1148,445114,428,380672,35,31510,666,68746,933,410072,703,478818,California
Fresno,2021-07-14,1901,859197,1371,446485,464,381136,66,31576,821,68568,1065,411137,887,479705,California
Fresno,2021-07-15,1539,860736,1079,447564,428,381564,32,31608,779,68628,751,411888,811,480516,California
Fresno,2021-07-16,2111,862847,1500,449064,537,382101,74,31682,1002,68609,1095,412983,1076,481592,California
Fresno,2021-07-17,1335,864182,1004,450068,279,382380,52,31734,629,68600,690,413673,681,482273,California
Fresno,2021-07-18,624,864806,495,450563,122,382502,7,31741,324,68637,293,413966,330,482603,California
Fresno,2021-07-19,1770,866576,1345,451908,357,382859,68,31809,925,68795,836,414802,994,483597,California
Fresno,2021-07-20,1765,868341,1228,453136,488,383347,49,31858,931,68959,817,415619,981,484578,California
Fresno,2021-07-21,1892,870233,1392,454528,449,383796,51,31909,1052,69246,816,416435,1103,485681,California
Fresno,2021-07-22,1784,872017,1278,455806,446,384242,60,31969,1040,69626,717,417152,1097,486778,California
Fresno,2021-07-23,2268,874285,1660,457466,533,384775,75,32044,1316,70078,937,418089,1389,488167,California
Fresno,2021-07-24,1280,875565,946,458412,306,385081,28,32072,774,70383,496,418585,801,488968,California
Fresno,2021-07-25,537,876102,385,458797,150,385231,2,32074,416,70682,119,418704,418,489386,California
Fresno,2021-07-26,1842,877944,1391,460188,400,385631,51,32125,1194,71287,638,419342,1243,490629,California
Fresno,2021-07-27,1862,879806,1299,461487,526,386157,37,32162,1139,71747,715,420057,1175,491804,California
Fresno,2021-07-28,2341,882147,1739,463226,537,386694,65,32227,1461,72408,861,420918,1522,493326,California
Fresno,2021-07-29,2003,884150,1456,464682,497,387191,50,32277,1249,72971,736,421654,1299,494625,California
Fresno,2021-07-30,2560,886710,1907,466589,589,387780,64,32341,1631,73754,911,422565,1694,496319,California
Fresno,2021-07-31,868,887578,613,467202,216,387996,39,32380,575,74081,287,422852,614,496933,California
Glenn,2020-12-17,1,1,1,1,0,0,0,0,1,1,0,0,1,1,California
Glenn,2020-12-20,1,2,1,2,0,0,0,0,1,2,0,0,1,2,California
Glenn,2020-12-21,10,12,10,12,0,0,0,0,10,12,0,0,10,12,California
Glenn,2020-12-22,58,70,58,70,0,0,0,0,58,70,0,0,58,70,California
Glenn,2020-12-23,28,98,28,98,0,0,0,0,28,98,0,0,28,98,California
Glenn,2020-12-24,9,107,9,107,0,0,0,0,9,107,0,0,9,107,California
Glenn,2020-12-26,2,109,2,109,0,0,0,0,2,109,0,0,2,109,California
Glenn,2020-12-27,4,113,4,113,0,0,0,0,4,113,0,0,4,113,California
Glenn,2020-12-28,21,134,21,134,0,0,0,0,21,134,0,0,21,134,California
Glenn,2020-12-29,82,216,82,216,0,0,0,0,82,216,0,0,82,216,California
Glenn,2020-12-30,127,343,104,320,23,23,0,0,127,343,0,0,127,343,California
Glenn,2020-12-31,37,380,8,328,29,52,0,0,37,380,0,0,37,380,California
Glenn,2021-01-02,4,384,4,332,0,52,0,0,4,384,0,0,4,384,California
Glenn,2021-01-04,7,391,5,337,2,54,0,0,7,391,0,0,7,391,California
Glenn,2021-01-05,12,403,9,346,3,57,0,0,12,403,0,0,12,403,California
Glenn,2021-01-06,58,461,8,354,50,107,0,0,58,461,0,0,58,461,California
Glenn,2021-01-07,65,526,11,365,54,161,0,0,64,524,1,1,64,525,California
Glenn,2021-01-08,12,538,9,374,3,164,0,0,12,536,0,1,12,537,California
Glenn,2021-01-10,1,539,1,375,0,164,0,0,0,535,1,2,0,537,California
Glenn,2021-01-11,29,568,28,403,1,165,0,0,13,532,16,18,13,550,California
Glenn,2021-01-12,43,611,38,441,5,170,0,0,14,517,29,47,14,564,California
Glenn,2021-01-13,220,831,156,597,64,234,0,0,177,651,43,90,177,741,California
Glenn,2021-01-14,119,950,30,627,89,323,0,0,109,750,10,100,109,850,California
Glenn,2021-01-15,42,992,34,661,8,331,0,0,37,782,5,105,37,887,California
Glenn,2021-01-16,35,1027,14,675,21,352,0,0,25,797,10,115,25,912,California
Glenn,2021-01-17,5,1032,3,678,2,354,0,0,2,796,3,118,2,914,California
Glenn,2021-01-18,18,1050,17,695,1,355,0,0,9,796,9,127,9,923,California
Glenn,2021-01-19,30,1080,20,715,10,365,0,0,13,792,17,144,13,936,California
Glenn,2021-01-20,162,1242,93,808,69,434,0,0,82,794,80,224,82,1018,California
Glenn,2021-01-21,119,1361,93,901,26,460,0,0,29,733,90,314,29,1047,California
Glenn,2021-01-22,345,1706,67,968,278,738,0,0,338,1064,7,321,338,1385,California
Glenn,2021-01-23,16,1722,10,978,6,744,0,0,12,1072,4,325,12,1397,California
Glenn,2021-01-24,2,1724,2,980,0,744,0,0,2,1074,0,325,2,1399,California
Glenn,2021-01-25,27,1751,9,989,18,762,0,0,24,1095,3,328,24,1423,California
Glenn,2021-01-26,32,1783,15,1004,17,779,0,0,25,1113,7,335,25,1448,California
Glenn,2021-01-27,188,1971,12,1016,176,955,0,0,166,1257,22,357,166,1614,California
Glenn,2021-01-28,153,2124,8,1024,145,1100,0,0,118,1340,35,392,118,1732,California
Glenn,2021-01-29,300,2424,12,1036,288,1388,0,0,286,1612,14,406,286,2018,California
Glenn,2021-01-30,4,2428,0,1036,4,1392,0,0,4,1616,0,406,4,2022,California
Glenn,2021-01-31,1,2429,0,1036,1,1393,0,0,1,1617,0,406,1,2023,California
Glenn,2021-02-01,31,2460,11,1047,20,1413,0,0,19,1624,12,418,19,2042,California
Glenn,2021-02-02,32,2492,16,1063,16,1429,0,0,22,1636,10,428,22,2064,California
Glenn,2021-02-03,280,2772,126,1189,154,1583,0,0,134,1625,146,574,135,2199,California
Glenn,2021-02-04,82,2854,15,1204,67,1650,0,0,25,1593,57,631,25,2224,California
Glenn,2021-02-05,325,3179,25,1229,300,1950,0,0,304,1876,21,652,304,2528,California
Glenn,2021-02-06,20,3199,2,1231,18,1968,0,0,19,1894,1,653,19,2547,California
Glenn,2021-02-07,2,3201,2,1233,0,1968,0,0,2,1896,0,653,2,2549,California
Glenn,2021-02-08,22,3223,17,1250,5,1973,0,0,6,1886,16,669,6,2555,California
Glenn,2021-02-09,53,3276,19,1269,34,2007,0,0,38,1909,15,684,38,2593,California
Glenn,2021-02-10,143,3419,18,1287,125,2132,0,0,74,1914,69,753,74,2667,California
Glenn,2021-02-11,271,3690,169,1456,102,2234,0,0,186,2016,85,838,187,2854,California
Glenn,2021-02-12,418,4108,98,1554,320,2554,0,0,351,2300,67,905,351,3205,California
Glenn,2021-02-13,39,4147,9,1563,30,2584,0,0,17,2295,22,927,17,3222,California
Glenn,2021-02-14,1,4148,0,1563,1,2585,0,0,1,2296,0,927,1,3223,California
Glenn,2021-02-15,10,4158,1,1564,9,2594,0,0,8,2302,2,929,8,3231,California
Glenn,2021-02-16,45,4203,9,1573,36,2630,0,0,26,2309,19,948,26,3257,California
Glenn,2021-02-17,384,4587,14,1587,370,3000,0,0,305,2535,79,1027,305,3562,California
Glenn,2021-02-18,185,4772,150,1737,35,3035,0,0,160,2671,24,1051,160,3722,California
Glenn,2021-02-19,307,5079,16,1753,291,3326,0,0,29,2422,278,1329,29,3751,California
Glenn,2021-02-20,10,5089,0,1753,10,3336,0,0,2,2416,8,1337,2,3753,California
Glenn,2021-02-22,37,5126,17,1770,20,3356,0,0,18,2416,18,1355,18,3771,California
Glenn,2021-02-23,45,5171,12,1782,33,3389,0,0,30,2431,15,1370,30,3801,California
Glenn,2021-02-24,269,5440,53,1835,216,3605,0,0,58,2278,211,1581,58,3859,California
Glenn,2021-02-25,346,5786,228,2063,118,3723,0,0,231,2392,117,1698,231,4090,California
Glenn,2021-02-26,310,6096,25,2088,285,4008,0,0,22,2127,287,1985,22,4112,California
Glenn,2021-02-27,14,6110,4,2092,10,4018,0,0,5,2124,8,1993,5,4117,California
Glenn,2021-02-28,6,6116,3,2095,3,4021,0,0,3,2125,2,1995,3,4120,California
Glenn,2021-03-01,28,6144,6,2101,22,4043,0,0,12,2121,16,2011,12,4132,California
Glenn,2021-03-02,40,6184,10,2111,30,4073,0,0,21,2123,19,2030,21,4153,California
Glenn,2021-03-03,222,6406,39,2150,183,4256,0,0,121,2145,99,2129,121,4274,California
Glenn,2021-03-04,547,6953,205,2355,342,4598,0,0,363,2324,184,2313,363,4637,California
Glenn,2021-03-05,362,7315,47,2402,315,4913,0,0,36,2034,326,2639,36,4673,California
Glenn,2021-03-06,33,7348,3,2405,29,4942,1,1,10,2022,23,2662,11,4684,California
Glenn,2021-03-07,5,7353,0,2405,5,4947,0,1,3,2024,1,2663,3,4687,California
Glenn,2021-03-08,20,7373,3,2408,16,4963,1,2,18,2041,2,2665,19,4706,California
Glenn,2021-03-09,85,7458,11,2419,70,5033,4,6,52,2063,33,2698,55,4761,California
Glenn,2021-03-10,191,7649,81,2500,108,5141,2,8,105,2084,86,2784,107,4868,California
Glenn,2021-03-11,600,8249,182,2682,395,5536,23,31,416,2342,184,2968,442,5310,California
Glenn,2021-03-12,419,8668,13,2695,342,5878,64,95,40,2067,379,3347,104,5414,California
Glenn,2021-03-13,13,8681,1,2696,4,5882,8,103,1,2064,12,3359,9,5423,California
Glenn,2021-03-14,1,8682,0,2696,1,5883,0,103,0,2063,1,3360,0,5423,California
Glenn,2021-03-15,77,8759,16,2712,56,5939,5,108,60,2111,17,3377,65,5488,California
Glenn,2021-03-16,116,8875,34,2746,71,6010,11,119,70,2146,46,3423,81,5569,California
Glenn,2021-03-17,421,9296,103,2849,311,6321,7,126,116,1962,305,3728,121,5690,California
Glenn,2021-03-18,540,9836,236,3085,49,6370,255,381,53,1782,487,4215,307,5997,California
Glenn,2021-03-19,98,9934,16,3101,75,6445,7,388,75,1842,22,4237,82,6079,California
Glenn,2021-03-20,134,10068,2,3103,131,6576,1,389,130,1969,4,4241,131,6210,California
Glenn,2021-03-21,6,10074,5,3108,0,6576,1,390,3,1971,2,4243,4,6214,California
Glenn,2021-03-22,124,10198,56,3164,61,6637,7,397,104,2064,18,4261,111,6325,California
Glenn,2021-03-23,176,10374,67,3231,61,6698,48,445,105,2147,70,4331,153,6478,California
Glenn,2021-03-24,213,10587,105,3336,103,6801,5,450,122,2185,89,4420,127,6605,California
Glenn,2021-03-25,522,11109,277,3613,151,6952,94,544,386,2531,134,4554,480,7085,California
Glenn,2021-03-26,243,11352,36,3649,171,7123,36,580,193,2710,50,4604,229,7314,California
Glenn,2021-03-27,167,11519,19,3668,142,7265,6,586,155,2859,12,4616,161,7475,California
Glenn,2021-03-28,14,11533,9,3677,5,7270,0,586,10,2865,4,4620,10,7485,California
Glenn,2021-03-29,60,11593,20,3697,37,7307,3,589,45,2898,15,4635,48,7533,California
Glenn,2021-03-30,71,11664,40,3737,30,7337,1,590,40,2910,29,4664,41,7574,California
Glenn,2021-03-31,131,11795,35,3772,95,7432,1,591,42,2865,88,4752,43,7617,California
Glenn,2021-04-01,672,12467,206,3978,457,7889,9,600,249,2702,421,5173,258,7875,California
Glenn,2021-04-02,169,12636,26,4004,132,8021,11,611,131,2806,38,5211,142,8017,California
Glenn,2021-04-03,96,12732,4,4008,85,8106,7,618,85,2887,11,5222,92,8109,California
Glenn,2021-04-04,11,12743,5,4013,4,8110,2,620,7,2892,4,5226,9,8118,California
Glenn,2021-04-05,68,12811,27,4040,28,8138,13,633,31,2899,37,5263,44,8162,California
Glenn,2021-04-06,143,12954,52,4092,52,8190,39,672,36,2867,106,5369,74,8236,California
Glenn,2021-04-07,162,13116,48,4140,60,8250,54,726,75,2909,87,5456,129,8365,California
Glenn,2021-04-08,672,13788,214,4354,423,8673,35,761,159,2592,511,5967,194,8559,California
Glenn,2021-04-09,160,13948,57,4411,86,8759,17,778,103,2654,57,6024,119,8678,California
Glenn,2021-04-10,78,14026,1,4412,60,8819,17,795,58,2710,19,6043,75,8753,California
Glenn,2021-04-11,16,14042,8,4420,3,8822,5,800,7,2713,9,6052,12,8765,California
Glenn,2021-04-12,118,14160,26,4446,62,8884,30,830,22,2669,96,6148,52,8817,California
Glenn,2021-04-13,119,14279,64,4510,55,8939,0,830,29,2608,90,6238,29,8846,California
Glenn,2021-04-14,122,14401,45,4555,77,9016,0,830,69,2624,53,6291,69,8915,California
Glenn,2021-04-15,362,14763,277,4832,85,9101,0,830,74,2411,287,6578,74,8989,California
Glenn,2021-04-16,168,14931,41,4873,127,9228,0,830,79,2401,89,6667,79,9068,California
Glenn,2021-04-17,168,15099,16,4889,152,9380,0,830,30,2301,130,6797,30,9098,California
Glenn,2021-04-18,19,15118,6,4895,13,9393,0,830,15,2312,4,6801,15,9113,California
Glenn,2021-04-19,85,15203,17,4912,68,9461,0,830,24,2276,60,6861,24,9137,California
Glenn,2021-04-20,135,15338,89,5001,46,9507,0,830,56,2253,79,6940,56,9193,California
Glenn,2021-04-21,449,15787,349,5350,100,9607,0,830,291,2387,157,7097,291,9484,California
Glenn,2021-04-22,221,16008,54,5404,167,9774,0,830,39,2245,181,7278,39,9523,California
Glenn,2021-04-23,196,16204,36,5440,160,9934,0,830,49,2148,146,7424,49,9572,California
Glenn,2021-04-24,183,16387,32,5472,151,10085,0,830,30,2026,152,7576,30,9602,California
Glenn,2021-04-25,28,16415,17,5489,11,10096,0,830,20,2038,8,7584,20,9622,California
Glenn,2021-04-26,50,16465,14,5503,36,10132,0,830,19,2026,31,7615,19,9641,California
Glenn,2021-04-27,65,16530,50,5553,10,10142,5,835,33,2032,31,7646,37,9678,California
Glenn,2021-04-28,269,16799,190,5743,68,10210,11,846,117,2009,151,7797,128,9806,California
Glenn,2021-04-29,189,16988,28,5771,159,10369,2,848,41,1904,148,7945,43,9849,California
Glenn,2021-04-30,167,17155,41,5812,124,10493,2,850,42,1823,125,8070,44,9893,California
Glenn,2021-05-01,108,17263,13,5825,94,10587,1,851,25,1766,83,8153,26,9919,California
Glenn,2021-05-02,31,17294,13,5838,9,10596,9,860,14,1772,17,8170,23,9942,California
Glenn,2021-05-03,41,17335,26,5864,14,10610,1,861,14,1760,27,8197,15,9957,California
Glenn,2021-05-04,60,17395,36,5900,19,10629,5,866,28,1761,32,8229,33,9990,California
Glenn,2021-05-05,128,17523,39,5939,78,10707,11,877,52,1748,76,8305,63,10053,California
Glenn,2021-05-06,115,17638,42,5981,67,10774,6,883,43,1725,72,8377,49,10102,California
Glenn,2021-05-07,123,17761,36,6017,78,10852,9,892,30,1672,92,8469,39,10141,California
Glenn,2021-05-08,66,17827,12,6029,50,10902,4,896,21,1653,44,8513,25,10166,California
Glenn,2021-05-09,17,17844,11,6040,6,10908,0,896,11,1658,6,8519,11,10177,California
Glenn,2021-05-10,37,17881,15,6055,17,10925,5,901,13,1652,24,8543,18,10195,California
Glenn,2021-05-11,87,17968,61,6116,17,10942,9,910,16,1606,71,8614,25,10220,California
Glenn,2021-05-12,347,18315,264,6380,69,11011,14,924,37,1347,310,8924,51,10271,California
Glenn,2021-05-13,160,18475,61,6441,80,11091,19,943,66,1338,94,9018,85,10356,California
Glenn,2021-05-14,108,18583,24,6465,79,11170,5,948,34,1303,74,9092,39,10395,California
Glenn,2021-05-15,68,18651,40,6505,25,11195,3,951,33,1304,34,9126,35,10430,California
Glenn,2021-05-16,30,18681,17,6522,13,11208,0,951,8,1290,22,9148,8,10438,California
Glenn,2021-05-17,86,18767,61,6583,21,11229,4,955,61,1330,25,9173,65,10503,California
Glenn,2021-05-18,70,18837,49,6632,17,11246,4,959,21,1306,49,9222,25,10528,California
Glenn,2021-05-19,197,19034,116,6748,69,11315,12,971,68,1257,128,9350,79,10607,California
Glenn,2021-05-20,121,19155,79,6827,40,11355,2,973,82,1302,39,9389,84,10691,California
Glenn,2021-05-21,71,19226,27,6854,43,11398,1,974,28,1288,43,9432,29,10720,California
Glenn,2021-05-22,55,19281,23,6877,32,11430,0,974,29,1291,26,9458,29,10749,California
Glenn,2021-05-23,28,19309,15,6892,13,11443,0,974,12,1288,15,9473,12,10761,California
Glenn,2021-05-24,30,19339,11,6903,15,11458,4,978,11,1285,18,9491,15,10776,California
Glenn,2021-05-25,47,19386,35,6938,10,11468,2,980,23,1286,24,9515,25,10801,California
Glenn,2021-05-26,72,19458,14,6952,54,11522,4,984,25,1268,47,9562,29,10830,California
Glenn,2021-05-27,105,19563,65,7017,39,11561,1,985,49,1264,54,9616,50,10880,California
Glenn,2021-05-28,62,19625,18,7035,37,11598,7,992,31,1271,31,9647,38,10918,California
Glenn,2021-05-29,47,19672,11,7046,32,11630,4,996,21,1270,26,9673,25,10943,California
Glenn,2021-05-30,21,19693,13,7059,8,11638,0,996,8,1266,12,9685,8,10951,California
Glenn,2021-05-31,4,19697,0,7059,4,11642,0,996,0,1262,4,9689,0,10951,California
Glenn,2021-06-01,60,19757,35,7094,22,11664,3,999,25,1255,35,9724,28,10979,California
Glenn,2021-06-02,98,19855,49,7143,46,11710,3,1002,39,1238,59,9783,42,11021,California
Glenn,2021-06-03,79,19934,44,7187,28,11738,7,1009,18,1203,60,9843,25,11046,California
Glenn,2021-06-04,79,20013,38,7225,37,11775,4,1013,43,1214,36,9879,47,11093,California
Glenn,2021-06-05,55,20068,30,7255,22,11797,3,1016,17,1196,38,9917,20,11113,California
Glenn,2021-06-06,31,20099,27,7282,3,11800,1,1017,15,1197,15,9932,16,11129,California
Glenn,2021-06-07,68,20167,59,7341,7,11807,2,1019,12,1156,55,9987,14,11143,California
Glenn,2021-06-08,35,20202,19,7360,11,11818,5,1024,16,1158,19,10006,21,11164,California
Glenn,2021-06-09,63,20265,36,7396,20,11838,7,1031,32,1166,31,10037,39,11203,California
Glenn,2021-06-10,120,20385,89,7485,25,11863,6,1037,35,1122,85,10122,41,11244,California
Glenn,2021-06-11,91,20476,60,7545,28,11891,3,1040,27,1088,64,10186,30,11274,California
Glenn,2021-06-12,35,20511,19,7564,13,11904,3,1043,13,1082,22,10208,16,11290,California
Glenn,2021-06-13,11,20522,11,7575,0,11904,0,1043,5,1081,6,10214,5,11295,California
Glenn,2021-06-14,39,20561,26,7601,10,11914,3,1046,15,1076,23,10237,18,11313,California
Glenn,2021-06-15,49,20610,33,7634,15,11929,1,1047,22,1072,27,10264,23,11336,California
Glenn,2021-06-16,84,20694,49,7683,34,11963,1,1048,57,1105,25,10289,58,11394,California
Glenn,2021-06-17,64,20758,38,7721,22,11985,4,1052,10,1065,54,10343,14,11408,California
Glenn,2021-06-18,82,20840,44,7765,17,12002,21,1073,27,1058,55,10398,48,11456,California
Glenn,2021-06-19,41,20881,20,7785,21,12023,0,1073,23,1063,18,10416,23,11479,California
Glenn,2021-06-20,15,20896,11,7796,4,12027,0,1073,4,1056,11,10427,4,11483,California
Glenn,2021-06-21,25,20921,17,7813,6,12033,2,1075,18,1069,7,10434,20,11503,California
Glenn,2021-06-22,49,20970,34,7847,13,12046,2,1077,23,1069,25,10459,25,11528,California
Glenn,2021-06-23,53,21023,36,7883,14,12060,3,1080,27,1073,26,10485,30,11558,California
Glenn,2021-06-24,44,21067,27,7910,13,12073,4,1084,17,1067,27,10512,21,11579,California
Glenn,2021-06-25,69,21136,49,7959,19,12092,1,1085,32,1063,37,10549,33,11612,California
Glenn,2021-06-26,35,21171,20,7979,14,12106,1,1086,16,1061,19,10568,17,11629,California
Glenn,2021-06-27,17,21188,13,7992,4,12110,0,1086,4,1052,13,10581,4,11633,California
Glenn,2021-06-28,27,21215,23,8015,1,12111,3,1089,12,1051,15,10596,14,11647,California
Glenn,2021-06-29,33,21248,16,8031,12,12123,5,1094,11,1045,22,10618,16,11663,California
Glenn,2021-06-30,74,21322,50,8081,20,12143,4,1098,35,1045,39,10657,39,11702,California
Glenn,2021-07-01,56,21378,40,8121,13,12156,3,1101,16,1024,40,10697,19,11721,California
Glenn,2021-07-02,59,21437,35,8156,19,12175,5,1106,20,1011,38,10735,25,11746,California
Glenn,2021-07-03,35,21472,27,8183,7,12182,1,1107,23,1023,12,10747,24,11770,California
Glenn,2021-07-04,3,21475,2,8185,0,12182,1,1108,0,1021,3,10750,1,11771,California
Glenn,2021-07-05,20,21495,17,8202,1,12183,2,1110,6,1015,14,10764,8,11779,California
Glenn,2021-07-06,47,21542,36,8238,10,12193,1,1111,24,1017,23,10787,25,11804,California
Glenn,2021-07-07,69,21611,63,8301,4,12197,2,1113,33,1016,36,10823,35,11839,California
Glenn,2021-07-08,33,21644,16,8317,10,12207,7,1120,11,1012,22,10845,18,11857,California
Glenn,2021-07-09,72,21716,45,8362,18,12225,9,1129,29,1007,43,10888,38,11895,California
Glenn,2021-07-10,14,21730,10,8372,4,12229,0,1129,5,1003,9,10897,5,11900,California
Glenn,2021-07-11,9,21739,8,8380,1,12230,0,1129,2,998,7,10904,2,11902,California
Glenn,2021-07-12,28,21767,23,8403,3,12233,2,1131,13,998,15,10919,15,11917,California
Glenn,2021-07-13,39,21806,26,8429,11,12244,2,1133,16,993,23,10942,18,11935,California
Glenn,2021-07-14,57,21863,44,8473,11,12255,2,1135,24,987,32,10974,26,11961,California
Glenn,2021-07-15,45,21908,28,8501,10,12265,7,1142,15,980,29,11003,22,11983,California
Glenn,2021-07-16,53,21961,41,8542,8,12273,4,1146,28,987,25,11028,32,12015,California
Glenn,2021-07-17,26,21987,14,8556,12,12285,0,1146,10,981,16,11044,10,12025,California
Glenn,2021-07-18,9,21996,9,8565,0,12285,0,1146,7,986,2,11046,7,12032,California
Glenn,2021-07-19,38,22034,32,8597,4,12289,2,1148,17,985,20,11066,19,12051,California
Glenn,2021-07-20,39,22073,33,8630,4,12293,2,1150,24,996,15,11081,26,12077,California
Glenn,2021-07-21,85,22158,71,8701,10,12303,4,1154,53,1022,31,11112,57,12134,California
Glenn,2021-07-22,36,22194,31,8732,2,12305,3,1157,18,1025,18,11130,21,12155,California
Glenn,2021-07-23,64,22258,48,8780,12,12317,4,1161,43,1051,21,11151,47,12202,California
Glenn,2021-07-24,34,22292,29,8809,4,12321,1,1162,8,1034,26,11177,9,12211,California
Glenn,2021-07-25,7,22299,5,8814,2,12323,0,1162,6,1039,1,11178,6,12217,California
Glenn,2021-07-26,35,22334,31,8845,3,12326,1,1163,24,1053,11,11189,25,12242,California
Glenn,2021-07-27,41,22375,34,8879,4,12330,3,1166,17,1049,24,11213,20,12262,California
Glenn,2021-07-28,77,22452,58,8937,14,12344,5,1171,32,1041,45,11258,37,12299,California
Glenn,2021-07-29,29,22481,16,8953,13,12357,0,1171,18,1048,11,11269,18,12317,California
Glenn,2021-07-30,30,22511,20,8973,7,12364,3,1174,18,1057,12,11281,21,12338,California
Glenn,2021-07-31,14,22525,12,8985,2,12366,0,1174,9,1061,5,11286,9,12347,California
Humboldt,2020-12-15,3,3,3,3,0,0,0,0,3,3,0,0,3,3,California
Humboldt,2020-12-16,16,19,16,19,0,0,0,0,16,19,0,0,16,19,California
Humboldt,2020-12-17,120,139,120,139,0,0,0,0,120,139,0,0,120,139,California
Humboldt,2020-12-18,175,314,175,314,0,0,0,0,175,314,0,0,175,314,California
Humboldt,2020-12-19,10,324,10,324,0,0,0,0,10,324,0,0,10,324,California
Humboldt,2020-12-20,27,351,27,351,0,0,0,0,27,351,0,0,27,351,California
Humboldt,2020-12-21,167,518,167,518,0,0,0,0,167,518,0,0,167,518,California
Humboldt,2020-12-22,338,856,338,856,0,0,0,0,338,856,0,0,338,856,California
Humboldt,2020-12-23,322,1178,263,1119,59,59,0,0,324,1180,0,0,324,1180,California
Humboldt,2020-12-24,26,1204,3,1122,23,82,0,0,26,1206,0,0,26,1206,California
Humboldt,2020-12-25,2,1206,2,1124,0,82,0,0,2,1208,0,0,2,1208,California
Humboldt,2020-12-26,6,1212,5,1129,1,83,0,0,6,1214,0,0,6,1214,California
Humboldt,2020-12-28,209,1421,151,1280,58,141,0,0,209,1423,0,0,209,1423,California
Humboldt,2020-12-29,186,1607,126,1406,60,201,0,0,187,1610,0,0,187,1610,California
Humboldt,2020-12-30,236,1843,130,1536,106,307,0,0,236,1846,0,0,236,1846,California
Humboldt,2020-12-31,245,2088,81,1617,164,471,0,0,245,2091,0,0,245,2091,California
Humboldt,2021-01-01,3,2091,2,1619,1,472,0,0,3,2094,0,0,3,2094,California
Humboldt,2021-01-02,40,2131,2,1621,38,510,0,0,40,2134,0,0,40,2134,California
Humboldt,2021-01-04,218,2349,141,1762,77,587,0,0,219,2353,0,0,219,2353,California
Humboldt,2021-01-05,134,2483,23,1785,111,698,0,0,134,2486,1,1,134,2487,California
Humboldt,2021-01-06,314,2797,214,1999,100,798,0,0,240,2664,62,63,240,2727,California
Humboldt,2021-01-07,438,3235,325,2324,113,911,0,0,321,2884,101,164,321,3048,California
Humboldt,2021-01-08,438,3673,298,2622,140,1051,0,0,297,3046,135,299,297,3345,California
Humboldt,2021-01-09,66,3739,43,2665,23,1074,0,0,64,3109,2,301,65,3410,California
Humboldt,2021-01-10,84,3823,84,2749,0,1074,0,0,4,3033,80,381,4,3414,California
Humboldt,2021-01-11,290,4113,280,3029,10,1084,0,0,69,2885,217,598,69,3483,California
Humboldt,2021-01-12,503,4616,340,3369,163,1247,0,0,284,2972,197,795,284,3767,California
Humboldt,2021-01-13,500,5116,279,3648,221,1468,0,0,322,3120,175,970,323,4090,California
Humboldt,2021-01-14,563,5679,176,3824,387,1855,0,0,506,3570,57,1027,507,4597,California
Humboldt,2021-01-15,372,6051,29,3853,343,2198,0,0,354,3906,18,1045,354,4951,California
Humboldt,2021-01-16,168,6219,5,3858,163,2361,0,0,167,4072,1,1046,167,5118,California
Humboldt,2021-01-17,7,6226,4,3862,3,2364,0,0,7,4079,0,1046,7,5125,California
Humboldt,2021-01-18,308,6534,273,4135,35,2399,0,0,149,4069,159,1205,149,5274,California
Humboldt,2021-01-19,660,7194,401,4536,259,2658,0,0,528,4471,126,1331,528,5802,California
Humboldt,2021-01-20,953,8147,425,4961,528,3186,0,0,785,5098,160,1491,787,6589,California
Humboldt,2021-01-21,970,9117,259,5220,711,3897,0,0,927,5982,43,1534,927,7516,California
Humboldt,2021-01-22,688,9805,380,5600,308,4205,0,0,678,6651,10,1544,679,8195,California
Humboldt,2021-01-23,931,10736,284,5884,647,4852,0,0,922,7565,9,1553,923,9118,California
Humboldt,2021-01-24,228,10964,1,5885,227,5079,0,0,227,7791,1,1554,227,9345,California
Humboldt,2021-01-25,354,11318,237,6122,117,5196,0,0,156,7749,198,1752,156,9501,California
Humboldt,2021-01-26,546,11864,153,6275,393,5589,0,0,480,8163,66,1818,480,9981,California
Humboldt,2021-01-27,1275,13139,585,6860,690,6279,0,0,1201,9299,67,1885,1203,11184,California
Humboldt,2021-01-28,1465,14604,637,7497,828,7107,0,0,1321,10481,141,2026,1323,12507,California
Humboldt,2021-01-29,1173,15777,551,8048,622,7729,0,0,692,10692,481,2507,692,13199,California
Humboldt,2021-01-30,1029,16806,470,8518,559,8288,0,0,984,11632,45,2552,985,14184,California
Humboldt,2021-01-31,320,17126,318,8836,2,8290,0,0,319,11950,1,2553,319,14503,California
Humboldt,2021-02-01,320,17446,175,9011,145,8435,0,0,183,11996,137,2690,183,14686,California
Humboldt,2021-02-02,454,17900,79,9090,375,8810,0,0,349,12245,102,2792,351,15037,California
Humboldt,2021-02-03,678,18578,266,9356,412,9222,0,0,524,12615,154,2946,524,15561,California
Humboldt,2021-02-04,655,19233,260,9616,395,9617,0,0,446,12855,206,3152,446,16007,California
Humboldt,2021-02-05,829,20062,108,9724,721,10338,0,0,625,13277,203,3355,625,16632,California
Humboldt,2021-02-06,1087,21149,473,10197,614,10952,0,0,1037,14266,49,3404,1038,17670,California
Humboldt,2021-02-07,375,21524,5,10202,370,11322,0,0,370,14633,4,3408,371,18041,California
Humboldt,2021-02-08,341,21865,145,10347,196,11518,0,0,183,14659,157,3565,183,18224,California
Humboldt,2021-02-09,504,22369,230,10577,274,11792,0,0,176,14508,327,3892,176,18400,California
Humboldt,2021-02-10,563,22932,369,10946,194,11986,0,0,205,14360,353,4245,205,18605,California
Humboldt,2021-02-11,1331,24263,399,11345,932,12918,0,0,493,14021,834,5079,495,19100,California
Humboldt,2021-02-12,1180,25443,753,12098,427,13345,0,0,722,14286,457,5536,722,19822,California
Humboldt,2021-02-13,1555,26998,605,12703,950,14295,0,0,926,14586,627,6163,927,20749,California
Humboldt,2021-02-14,116,27114,5,12708,111,14406,0,0,112,14695,3,6166,112,20861,California
Humboldt,2021-02-15,297,27411,82,12790,215,14621,0,0,195,14789,101,6267,195,21056,California
Humboldt,2021-02-16,554,27965,124,12914,430,15051,0,0,251,14740,302,6569,253,21309,California
Humboldt,2021-02-17,453,28418,279,13193,174,15225,0,0,130,14549,321,6890,130,21439,California
Humboldt,2021-02-18,1027,29445,605,13798,422,15647,0,0,273,14071,751,7641,273,21712,California
Humboldt,2021-02-19,487,29932,441,14239,46,15693,0,0,90,13768,393,8034,90,21802,California
Humboldt,2021-02-20,1759,31691,1036,15275,723,16416,0,0,485,12985,1271,9305,488,22290,California
Humboldt,2021-02-21,498,32189,490,15765,8,16424,0,0,187,12862,311,9616,188,22478,California
Humboldt,2021-02-22,143,32332,98,15863,45,16469,0,0,29,12780,111,9727,29,22507,California
Humboldt,2021-02-23,188,32520,72,15935,116,16585,0,0,46,12686,140,9867,46,22553,California
Humboldt,2021-02-24,1298,33818,792,16727,506,17091,0,0,628,12647,667,10534,628,23181,California
Humboldt,2021-02-25,867,34685,326,17053,541,17632,0,0,235,12253,629,11163,235,23416,California
Humboldt,2021-02-26,2257,36942,111,17164,2146,19778,0,0,450,10904,1800,12963,451,23867,California
Humboldt,2021-02-27,1807,38749,1151,18315,656,20434,0,0,918,10939,887,13850,922,24789,California
Humboldt,2021-02-28,132,38881,13,18328,119,20553,0,0,121,11051,9,13859,121,24910,California
Humboldt,2021-03-01,272,39153,47,18375,225,20778,0,0,196,11172,75,13934,196,25106,California
Humboldt,2021-03-02,314,39467,51,18426,263,21041,0,0,168,11194,146,14080,168,25274,California
Humboldt,2021-03-03,1714,41181,1131,19557,583,21624,0,0,1248,11984,459,14539,1249,26523,California
Humboldt,2021-03-04,937,42118,115,19672,822,22446,0,0,299,11647,638,15177,301,26824,California
Humboldt,2021-03-05,962,43080,193,19865,758,23204,11,11,394,11488,564,15741,405,27229,California
Humboldt,2021-03-06,1813,44893,953,20818,811,24015,49,60,795,11315,1016,16757,843,28072,California
Humboldt,2021-03-07,389,45282,297,21115,59,24074,33,93,158,11274,231,16988,190,28262,California
Humboldt,2021-03-08,284,45566,8,21123,192,24266,84,177,182,11439,101,17089,266,28528,California
Humboldt,2021-03-09,512,46078,208,21331,153,24419,151,328,249,11575,261,17350,397,28925,California
Humboldt,2021-03-10,700,46778,472,21803,71,24490,157,485,426,11883,273,17623,581,29506,California
Humboldt,2021-03-11,1487,48265,459,22262,928,25418,100,585,657,11814,825,18448,756,30262,California
Humboldt,2021-03-12,1768,50033,1098,23360,447,25865,223,808,1064,12409,695,19143,1290,31552,California
Humboldt,2021-03-13,1600,51633,1051,24411,497,26362,52,860,678,12222,915,20058,728,32280,California
Humboldt,2021-03-14,146,51779,20,24431,118,26480,8,868,29,12142,117,20175,37,32317,California
Humboldt,2021-03-15,282,52061,51,24482,208,26688,23,891,60,12001,222,20397,81,32398,California
Humboldt,2021-03-16,634,52695,200,24682,172,26860,262,1153,259,12146,374,20771,519,32917,California
Humboldt,2021-03-17,735,53430,395,25077,232,27092,108,1261,342,12204,392,21163,450,33367,California
Humboldt,2021-03-18,1746,55176,1169,26246,534,27626,43,1304,1016,12540,723,21886,1059,34426,California
Humboldt,2021-03-19,1078,56254,62,26308,699,28325,317,1621,442,12664,634,22520,758,35184,California
Humboldt,2021-03-20,1417,57671,787,27095,616,28941,14,1635,382,12031,1030,23550,397,35581,California
Humboldt,2021-03-21,254,57925,37,27132,190,29131,27,1662,207,12218,46,23596,233,35814,California
Humboldt,2021-03-22,121,58046,18,27150,53,29184,50,1712,64,12277,55,23651,114,35928,California
Humboldt,2021-03-23,419,58465,42,27192,335,29519,42,1754,324,12549,94,23745,366,36294,California
Humboldt,2021-03-24,1418,59883,389,27581,981,30500,48,1802,1037,13260,373,24118,1084,37378,California
Humboldt,2021-03-25,1847,61730,1217,28798,567,31067,63,1865,923,13325,920,25038,985,38363,California
Humboldt,2021-03-26,2049,63779,439,29237,1552,32619,58,1923,1597,14533,446,25484,1654,40017,California
Humboldt,2021-03-27,2162,65941,1565,30802,422,33041,175,2098,1169,14888,989,26473,1344,41361,California
Humboldt,2021-03-28,271,66212,84,30886,115,33156,72,2170,78,14847,192,26665,151,41512,California
Humboldt,2021-03-29,471,66683,125,31011,249,33405,97,2267,196,14866,273,26938,292,41804,California
Humboldt,2021-03-30,954,67637,304,31315,536,33941,114,2381,559,15148,390,27328,672,42476,California
Humboldt,2021-03-31,1889,69526,542,31857,1250,35191,97,2478,1410,16181,475,27803,1508,43984,California
Humboldt,2021-04-01,2119,71645,709,32566,1317,36508,93,2571,1481,17123,630,28433,1572,45556,California
Humboldt,2021-04-02,1727,73372,1113,33679,508,37016,106,2677,611,16731,1109,29542,717,46273,California
Humboldt,2021-04-03,1674,75046,1516,35195,144,37160,14,2691,659,16399,1005,30547,673,46946,California
Humboldt,2021-04-04,478,75524,369,35564,100,37260,9,2700,398,16727,79,30626,407,47353,California
Humboldt,2021-04-05,783,76307,466,36030,269,37529,48,2748,444,16883,336,30962,492,47845,California
Humboldt,2021-04-06,851,77158,321,36351,395,37924,135,2883,589,17349,256,31218,722,48567,California
Humboldt,2021-04-07,1526,78684,1081,37432,292,38216,153,3036,999,17977,524,31742,1152,49719,California
Humboldt,2021-04-08,1775,80459,1098,38530,506,38722,171,3207,742,17860,1030,32772,913,50632,California
Humboldt,2021-04-09,1449,81908,441,38971,850,39572,158,3365,1155,18871,293,33065,1304,51936,California
Humboldt,2021-04-10,945,82853,141,39112,633,40205,171,3536,747,19591,196,33261,916,52852,California
Humboldt,2021-04-11,649,83502,142,39254,36,40241,471,4007,129,19670,520,33781,599,53451,California
Humboldt,2021-04-12,445,83947,232,39486,86,40327,127,4134,281,19916,163,33944,409,53860,California
Humboldt,2021-04-13,595,84542,327,39813,262,40589,6,4140,558,20444,35,33979,563,54423,California
Humboldt,2021-04-14,1457,85999,1055,40868,402,40991,0,4140,1338,21664,118,34097,1338,55761,California
Humboldt,2021-04-15,1821,87820,1189,42057,628,41619,4,4144,1246,22356,556,34653,1248,57009,California
Humboldt,2021-04-16,1136,88956,520,42577,616,42235,0,4144,552,22327,581,35234,552,57561,California
Humboldt,2021-04-17,1888,90844,1567,44144,320,42555,1,4145,988,22422,894,36128,989,58550,California
Humboldt,2021-04-18,672,91516,356,44500,315,42870,1,4146,82,21920,584,36712,82,58632,California
Humboldt,2021-04-19,204,91720,82,44582,122,42992,0,4146,89,21896,113,36825,89,58721,California
Humboldt,2021-04-20,515,92235,140,44722,375,43367,0,4146,253,21888,261,37086,253,58974,California
Humboldt,2021-04-21,1125,93360,392,45114,733,44100,0,4146,454,21681,662,37748,455,59429,California
Humboldt,2021-04-22,908,94268,542,45656,365,44465,1,4147,462,21700,443,38191,462,59891,California
Humboldt,2021-04-23,2216,96484,313,45969,1903,46368,0,4147,343,20175,1868,40059,343,60234,California
Humboldt,2021-04-24,1111,97595,892,46861,214,46582,5,4152,357,19786,751,40810,362,60596,California
Humboldt,2021-04-25,385,97980,245,47106,140,46722,0,4152,196,19796,186,40996,196,60792,California
Humboldt,2021-04-26,393,98373,270,47376,119,46841,4,4156,112,19631,279,41275,114,60906,California
Humboldt,2021-04-27,810,99183,311,47687,470,47311,29,4185,180,19212,628,41903,209,61115,California
Humboldt,2021-04-28,1614,100797,848,48535,720,48031,46,4231,421,18489,1190,43093,467,61582,California
Humboldt,2021-04-29,1820,102617,640,49175,1142,49173,38,4269,306,17326,1507,44600,344,61926,California
Humboldt,2021-04-30,1317,103934,438,49613,844,50017,35,4304,207,16463,1103,45703,240,62166,California
Humboldt,2021-05-01,493,104427,395,50008,75,50092,23,4327,305,16604,187,45890,328,62494,California
Humboldt,2021-05-02,238,104665,188,50196,40,50132,10,4337,117,16611,120,46010,127,62621,California
Humboldt,2021-05-03,633,105298,387,50583,222,50354,24,4361,103,16211,528,46538,128,62749,California
Humboldt,2021-05-04,870,106168,524,51107,301,50655,45,4406,264,15916,603,47141,308,63057,California
Humboldt,2021-05-05,1765,107933,1135,52242,571,51226,59,4465,192,14601,1564,48705,249,63306,California
Humboldt,2021-05-06,1718,109651,1095,53337,369,51595,254,4719,143,13426,1572,50277,397,63703,California
Humboldt,2021-05-07,1437,111088,315,53652,1062,52657,60,4779,238,12526,1196,51473,296,63999,California
Humboldt,2021-05-08,746,111834,148,53800,574,53231,24,4803,88,11982,656,52129,112,64111,California
Humboldt,2021-05-09,911,112745,858,54658,43,53274,10,4813,47,11175,864,52993,57,64168,California
Humboldt,2021-05-10,221,112966,38,54696,141,53415,42,4855,83,11162,138,53131,125,64293,California
Humboldt,2021-05-11,541,113507,186,54882,282,53697,73,4928,205,11105,335,53466,278,64571,California
Humboldt,2021-05-12,624,114131,142,55024,436,54133,46,4974,230,10987,393,53859,275,64846,California
Humboldt,2021-05-13,633,114764,301,55325,305,54438,27,5001,288,10959,343,54202,315,65161,California
Humboldt,2021-05-14,710,115474,144,55469,461,54899,105,5106,233,10822,474,54676,337,65498,California
Humboldt,2021-05-15,792,116266,648,56117,134,55033,10,5116,213,10468,577,55253,223,65721,California
Humboldt,2021-05-16,120,116386,54,56171,62,55095,4,5120,68,10488,52,55305,72,65793,California
Humboldt,2021-05-17,409,116795,215,56386,172,55267,22,5142,221,10545,186,55491,243,66036,California
Humboldt,2021-05-18,660,117455,322,56708,309,55576,29,5171,360,10633,300,55791,388,66424,California
Humboldt,2021-05-19,984,118439,547,57255,394,55970,43,5214,318,10330,662,56453,359,66783,California
Humboldt,2021-05-20,834,119273,607,57862,214,56184,13,5227,598,10709,233,56686,612,67395,California
Humboldt,2021-05-21,888,120161,291,58153,530,56714,67,5294,351,10590,537,57223,418,67813,California
Humboldt,2021-05-22,418,120579,322,58475,88,56802,8,5302,148,10478,268,57491,156,67969,California
Humboldt,2021-05-23,396,120975,328,58803,65,56867,3,5305,75,10235,321,57812,78,68047,California
Humboldt,2021-05-24,337,121312,173,58976,135,57002,29,5334,182,10291,155,57967,211,68258,California
Humboldt,2021-05-25,532,121844,340,59316,167,57169,25,5359,287,10361,242,58209,312,68570,California
Humboldt,2021-05-26,649,122493,310,59626,315,57484,24,5383,305,10347,343,58552,329,68899,California
Humboldt,2021-05-27,465,122958,248,59874,180,57664,37,5420,277,10473,188,58740,314,69213,California
Humboldt,2021-05-28,414,123372,193,60067,172,57836,49,5469,170,10451,241,58981,219,69432,California
Humboldt,2021-05-29,174,123546,102,60169,66,57902,6,5475,91,10465,83,59064,97,69529,California
Humboldt,2021-05-30,106,123652,45,60214,56,57958,5,5480,50,10465,55,59119,55,69584,California
Humboldt,2021-05-31,72,123724,27,60241,39,57997,6,5486,48,10495,23,59142,53,69637,California
Humboldt,2021-06-01,465,124189,268,60509,182,58179,15,5501,187,10419,278,59420,202,69839,California
Humboldt,2021-06-02,536,124725,252,60761,229,58408,55,5556,238,10417,293,59713,291,70130,California
Humboldt,2021-06-03,389,125114,226,60987,141,58549,22,5578,83,10244,278,59991,105,70235,California
Humboldt,2021-06-04,511,125625,320,61307,167,58716,24,5602,138,10076,329,60320,161,70396,California
Humboldt,2021-06-05,410,126035,315,61622,50,58766,45,5647,207,10180,148,60468,252,70648,California
Humboldt,2021-06-06,173,126208,119,61741,44,58810,10,5657,69,10161,98,60566,79,70727,California
Humboldt,2021-06-07,365,126573,219,61960,122,58932,24,5681,117,10055,247,60813,141,70868,California
Humboldt,2021-06-08,521,127094,303,62263,189,59121,29,5710,148,9860,371,61184,176,71044,California
Humboldt,2021-06-09,403,127497,207,62470,148,59269,48,5758,129,9765,272,61456,177,71221,California
Humboldt,2021-06-10,567,128064,446,62916,94,59363,27,5785,96,9419,467,61923,121,71342,California
Humboldt,2021-06-11,439,128503,244,63160,167,59530,28,5813,100,9210,338,62261,129,71471,California
Humboldt,2021-06-12,183,128686,132,63292,50,59580,1,5814,51,9131,131,62392,52,71523,California
Humboldt,2021-06-13,216,128902,148,63440,42,59622,26,5840,94,9130,120,62512,119,71642,California
Humboldt,2021-06-14,418,129320,254,63694,137,59759,27,5867,112,8965,304,62816,139,71781,California
Humboldt,2021-06-15,551,129871,375,64069,148,59907,28,5895,158,8763,387,63203,185,71966,California
Humboldt,2021-06-16,484,130355,324,64393,113,60020,47,5942,143,8621,332,63535,190,72156,California
Humboldt,2021-06-17,407,130762,262,64655,99,60119,46,5988,101,8462,306,63841,147,72303,California
Humboldt,2021-06-18,415,131177,239,64894,147,60266,29,6017,146,8373,263,64104,174,72477,California
Humboldt,2021-06-19,204,131381,136,65030,47,60313,21,6038,86,8362,117,64221,106,72583,California
Humboldt,2021-06-20,80,131461,36,65066,30,60343,14,6052,33,8364,45,64266,47,72630,California
Humboldt,2021-06-21,155,131616,72,65138,54,60397,29,6081,53,8344,102,64368,82,72712,California
Humboldt,2021-06-22,352,131968,224,65362,109,60506,19,6100,148,8308,203,64571,167,72879,California
Humboldt,2021-06-23,355,132323,249,65611,75,60581,31,6131,106,8201,242,64813,135,73014,California
Humboldt,2021-06-24,217,132540,107,65718,53,60634,57,6188,88,8219,125,64938,143,73157,California
Humboldt,2021-06-25,262,132802,149,65867,99,60733,14,6202,107,8188,152,65090,121,73278,California
Humboldt,2021-06-26,253,133055,191,66058,38,60771,24,6226,63,8085,190,65280,87,73365,California
Humboldt,2021-06-27,74,133129,51,66109,21,60792,2,6228,26,8065,48,65328,28,73393,California
Humboldt,2021-06-28,157,133286,99,66208,30,60822,28,6256,70,8076,87,65415,98,73491,California
Humboldt,2021-06-29,266,133552,158,66366,75,60897,33,6289,89,8022,175,65590,121,73612,California
Humboldt,2021-06-30,224,133776,145,66511,59,60956,20,6309,93,8006,129,65719,113,73725,California
Humboldt,2021-07-01,199,133975,113,66624,68,61024,18,6327,90,8007,107,65826,108,73833,California
Humboldt,2021-07-02,264,134239,140,66764,83,61107,41,6368,106,7997,157,65983,147,73980,California
Humboldt,2021-07-03,91,134330,62,66826,19,61126,10,6378,40,7997,50,66033,50,74030,California
Humboldt,2021-07-04,9,134339,4,66830,5,61131,0,6378,5,7998,4,66037,5,74035,California
Humboldt,2021-07-05,146,134485,99,66929,35,61166,12,6390,65,7995,80,66117,77,74112,California
Humboldt,2021-07-06,252,134737,161,67090,71,61237,20,6410,69,7901,182,66299,88,74200,California
Humboldt,2021-07-07,261,134998,159,67249,65,61302,37,6447,80,7839,179,66478,117,74317,California
Humboldt,2021-07-08,189,135187,127,67376,45,61347,17,6464,72,7813,115,66593,89,74406,California
Humboldt,2021-07-09,227,135414,140,67516,66,61413,21,6485,79,7764,148,66741,99,74505,California
Humboldt,2021-07-10,128,135542,88,67604,30,61443,10,6495,55,7756,73,66814,65,74570,California
Humboldt,2021-07-11,80,135622,54,67658,14,61457,12,6507,35,7758,45,66859,47,74617,California
Humboldt,2021-07-12,112,135734,66,67724,40,61497,6,6513,53,7758,59,66918,59,74676,California
Humboldt,2021-07-13,177,135911,119,67843,38,61535,20,6533,53,7711,120,67038,73,74749,California
Humboldt,2021-07-14,246,136157,162,68005,71,61606,13,6546,99,7679,143,67181,111,74860,California
Humboldt,2021-07-15,150,136307,90,68095,49,61655,11,6557,51,7643,97,67278,61,74921,California
Humboldt,2021-07-16,243,136550,155,68250,67,61722,21,6578,105,7634,136,67414,127,75048,California
Humboldt,2021-07-17,95,136645,68,68318,26,61748,1,6579,45,7631,49,67463,46,75094,California
Humboldt,2021-07-18,49,136694,26,68344,15,61763,8,6587,21,7632,28,67491,29,75123,California
Humboldt,2021-07-19,155,136849,100,68444,42,61805,13,6600,77,7644,78,67569,90,75213,California
Humboldt,2021-07-20,264,137113,149,68593,72,61877,43,6643,114,7653,148,67717,157,75370,California
Humboldt,2021-07-21,233,137346,168,68761,44,61921,21,6664,118,7679,113,67830,139,75509,California
Humboldt,2021-07-22,196,137542,111,68872,64,61985,21,6685,89,7682,107,67937,110,75619,California
Humboldt,2021-07-23,264,137806,159,69031,89,62074,16,6701,142,7719,121,68058,158,75777,California
Humboldt,2021-07-24,168,137974,111,69142,25,62099,32,6733,81,7748,84,68142,113,75890,California
Humboldt,2021-07-25,60,138034,35,69177,15,62114,10,6743,35,7768,25,68167,45,75935,California
Humboldt,2021-07-26,181,138215,120,69297,48,62162,13,6756,102,7805,78,68245,115,76050,California
Humboldt,2021-07-27,223,138438,137,69434,67,62229,19,6775,125,7855,93,68338,143,76193,California
Humboldt,2021-07-28,244,138682,163,69597,64,62293,17,6792,146,7920,98,68436,163,76356,California
Humboldt,2021-07-29,190,138872,119,69716,50,62343,21,6813,106,7965,82,68518,127,76483,California
Humboldt,2021-07-30,279,139151,169,69885,84,62427,26,6839,147,8009,125,68643,169,76652,California
Humboldt,2021-07-31,80,139231,49,69934,17,62444,14,6853,33,8011,44,68687,46,76698,California
Imperial,2020-12-16,1,1,1,1,0,0,0,0,1,1,0,0,1,1,California
Imperial,2020-12-17,4,5,4,5,0,0,0,0,4,5,0,0,4,5,California
Imperial,2020-12-18,16,21,16,21,0,0,0,0,16,21,0,0,16,21,California
Imperial,2020-12-20,2,23,2,23,0,0,0,0,2,23,0,0,2,23,California
Imperial,2020-12-21,185,208,185,208,0,0,0,0,185,208,0,0,185,208,California
Imperial,2020-12-22,242,450,240,448,2,2,0,0,242,450,0,0,242,450,California
Imperial,2020-12-23,211,661,210,658,1,3,0,0,211,661,0,0,211,661,California
Imperial,2020-12-24,7,668,7,665,0,3,0,0,7,668,0,0,7,668,California
Imperial,2020-12-25,1,669,1,666,0,3,0,0,1,669,0,0,1,669,California
Imperial,2020-12-26,4,673,2,668,2,5,0,0,4,673,0,0,4,673,California
Imperial,2020-12-27,62,735,0,668,62,67,0,0,62,735,0,0,62,735,California
Imperial,2020-12-28,218,953,116,784,102,169,0,0,218,953,0,0,218,953,California
Imperial,2020-12-29,194,1147,39,823,155,324,0,0,194,1147,0,0,194,1147,California
Imperial,2020-12-30,369,1516,51,874,318,642,0,0,369,1516,0,0,369,1516,California
Imperial,2020-12-31,200,1716,29,903,171,813,0,0,200,1716,0,0,200,1716,California
Imperial,2021-01-01,31,1747,5,908,26,839,0,0,31,1747,0,0,31,1747,California
Imperial,2021-01-02,6,1753,1,909,5,844,0,0,6,1753,0,0,6,1753,California
Imperial,2021-01-03,90,1843,0,909,90,934,0,0,90,1843,0,0,90,1843,California
Imperial,2021-01-04,90,1933,10,919,80,1014,0,0,90,1933,0,0,90,1933,California
Imperial,2021-01-05,174,2107,15,934,159,1173,0,0,174,2107,0,0,174,2107,California
Imperial,2021-01-06,197,2304,27,961,170,1343,0,0,196,2302,1,1,196,2303,California
Imperial,2021-01-07,333,2637,14,975,319,1662,0,0,328,2625,5,6,328,2631,California
Imperial,2021-01-08,199,2836,56,1031,143,1805,0,0,187,2800,12,18,187,2818,California
Imperial,2021-01-09,24,2860,21,1052,3,1808,0,0,24,2824,0,18,24,2842,California
Imperial,2021-01-10,6,2866,0,1052,6,1814,0,0,6,2830,0,18,6,2848,California
Imperial,2021-01-11,401,3267,242,1294,159,1973,0,0,175,2779,226,244,175,3023,California
Imperial,2021-01-12,585,3852,475,1769,110,2083,0,0,319,2833,265,509,319,3342,California
Imperial,2021-01-13,392,4244,138,1907,254,2337,0,0,289,3019,103,612,289,3631,California
Imperial,2021-01-14,307,4551,189,2096,118,2455,0,0,301,3315,5,617,301,3932,California
Imperial,2021-01-15,247,4798,182,2278,65,2520,0,0,239,3546,8,625,239,4171,California
Imperial,2021-01-16,97,4895,75,2353,22,2542,0,0,96,3641,1,626,96,4267,California
Imperial,2021-01-17,19,4914,6,2359,13,2555,0,0,18,3658,1,627,18,4285,California
Imperial,2021-01-18,1080,5994,404,2763,676,3231,0,0,981,4541,99,726,982,5267,California
Imperial,2021-01-19,180,6174,136,2899,44,3275,0,0,131,4623,49,775,131,5398,California
Imperial,2021-01-20,312,6486,202,3101,110,3385,0,0,273,4857,39,814,273,5671,California
Imperial,2021-01-21,468,6954,215,3316,253,3638,0,0,444,5277,24,838,444,6115,California
Imperial,2021-01-22,482,7436,193,3509,289,3927,0,0,473,5741,9,847,473,6588,California
Imperial,2021-01-23,1067,8503,293,3802,774,4701,0,0,1064,6802,3,850,1064,7652,California
Imperial,2021-01-24,27,8530,6,3808,21,4722,0,0,26,6827,1,851,26,7678,California
Imperial,2021-01-25,229,8759,10,3818,219,4941,0,0,44,6688,183,1034,44,7722,California
Imperial,2021-01-26,403,9162,196,4014,207,5148,0,0,257,6801,145,1179,258,7980,California
Imperial,2021-01-27,605,9767,174,4188,431,5579,0,0,267,6730,338,1517,267,8247,California
Imperial,2021-01-28,665,10432,174,4362,491,6070,0,0,554,7173,111,1628,554,8801,California
Imperial,2021-01-29,466,10898,310,4672,156,6226,0,0,413,7533,53,1681,413,9214,California
Imperial,2021-01-30,88,10986,42,4714,46,6272,0,0,71,7587,17,1698,71,9285,California
Imperial,2021-01-31,37,11023,13,4727,24,6296,0,0,36,7622,1,1699,36,9321,California
Imperial,2021-02-01,477,11500,76,4803,401,6697,0,0,264,7674,212,1911,264,9585,California
Imperial,2021-02-02,773,12273,89,4892,684,7381,0,0,586,8073,187,2098,586,10171,California
Imperial,2021-02-03,635,12908,187,5079,448,7829,0,0,371,8182,262,2360,371,10542,California
Imperial,2021-02-04,1952,14860,1396,6475,556,8385,0,0,1511,9254,440,2800,1512,12054,California
Imperial,2021-02-05,478,15338,261,6736,217,8602,0,0,241,9259,238,3038,243,12297,California
Imperial,2021-02-06,894,16232,852,7588,42,8644,0,0,857,10077,39,3077,857,13154,California
Imperial,2021-02-07,50,16282,17,7605,33,8677,0,0,46,10119,4,3081,46,13200,California
Imperial,2021-02-08,297,16579,66,7671,231,8908,0,0,228,10278,69,3150,228,13428,California
Imperial,2021-02-09,531,17110,183,7854,348,9256,0,0,357,10464,174,3324,360,13788,California
Imperial,2021-02-10,505,17615,77,7931,428,9684,0,0,134,10230,371,3695,137,13925,California
Imperial,2021-02-11,1099,18714,394,8325,705,10389,0,0,191,9521,903,4598,194,14119,California
Imperial,2021-02-12,2239,20953,1480,9805,759,11148,0,0,1874,11033,368,4966,1880,15999,California
Imperial,2021-02-13,126,21079,62,9867,64,11212,0,0,107,11119,22,4988,108,16107,California
Imperial,2021-02-14,61,21140,37,9904,24,11236,0,0,57,11172,4,4992,57,16164,California
Imperial,2021-02-15,176,21316,65,9969,111,11347,0,0,132,11263,44,5036,135,16299,California
Imperial,2021-02-16,566,21882,283,10252,283,11630,0,0,337,11375,229,5265,341,16640,California
Imperial,2021-02-17,476,22358,315,10567,161,11791,0,0,111,11126,365,5630,116,16756,California
Imperial,2021-02-18,704,23062,346,10913,358,12149,0,0,172,10777,531,6161,182,16938,California
Imperial,2021-02-19,813,23875,412,11325,401,12550,0,0,217,10401,595,6756,219,17157,California
Imperial,2021-02-20,1083,24958,217,11542,866,13416,0,0,348,10030,733,7489,362,17519,California
Imperial,2021-02-21,630,25588,595,12137,35,13451,0,0,617,10638,12,7501,620,18139,California
Imperial,2021-02-22,884,26472,618,12755,266,13717,0,0,806,11371,78,7579,811,18950,California
Imperial,2021-02-23,1184,27656,566,13321,618,14335,0,0,1008,12218,175,7754,1022,19972,California
Imperial,2021-02-24,887,28543,414,13735,473,14808,0,0,748,12843,137,7891,762,20734,California
Imperial,2021-02-25,1015,29558,436,14171,579,15387,0,0,584,13021,430,8321,608,21342,California
Imperial,2021-02-26,2447,32005,1449,15620,998,16385,0,0,1907,14412,539,8860,1930,23272,California
Imperial,2021-02-27,1087,33092,982,16602,105,16490,0,0,278,13901,810,9670,299,23571,California
Imperial,2021-02-28,123,33215,97,16699,26,16516,0,0,99,13987,24,9694,110,23681,California
Imperial,2021-03-01,646,33861,393,17092,249,16765,4,4,548,14457,93,9787,563,24244,California
Imperial,2021-03-02,843,34704,328,17420,514,17279,1,5,478,14588,363,10150,494,24738,California
Imperial,2021-03-03,1050,35754,115,17535,935,18214,0,5,632,14834,414,10564,660,25398,California
Imperial,2021-03-04,887,36641,158,17693,728,18942,1,6,584,15169,300,10864,635,26033,California
Imperial,2021-03-05,3240,39881,2301,19994,939,19881,0,6,1824,15607,1419,12283,1857,27890,California
Imperial,2021-03-06,862,40743,353,20347,507,20388,2,8,759,16296,99,12382,788,28678,California
Imperial,2021-03-07,183,40926,118,20465,61,20449,4,12,124,16391,58,12440,153,28831,California
Imperial,2021-03-08,533,41459,412,20877,82,20531,39,51,418,16768,114,12554,491,29322,California
Imperial,2021-03-09,794,42253,394,21271,151,20682,249,300,472,17169,322,12876,723,30045,California
Imperial,2021-03-10,893,43146,395,21666,306,20988,192,492,400,17282,492,13368,605,30650,California
Imperial,2021-03-11,1975,45121,543,22209,1159,22147,273,765,1258,18124,713,14081,1555,32205,California
Imperial,2021-03-12,5036,50157,3536,25745,1236,23383,264,1029,3182,19746,1846,15927,3468,35673,California
Imperial,2021-03-13,1258,51415,126,25871,896,24279,236,1265,900,20554,355,16282,1163,36836,California
Imperial,2021-03-14,234,51649,66,25937,152,24431,16,1281,160,20673,73,16355,192,37028,California
Imperial,2021-03-15,819,52468,287,26224,229,24660,303,1584,435,21049,381,16736,757,37785,California
Imperial,2021-03-16,1326,53794,392,26616,419,25079,515,2099,638,21548,684,17420,1183,38968,California
Imperial,2021-03-17,1765,55559,765,27381,808,25887,192,2291,1073,22138,684,18104,1274,40242,California
Imperial,2021-03-18,1969,57528,1289,28670,595,26482,85,2376,1362,22988,602,18706,1452,41694,California
Imperial,2021-03-19,3961,61489,2881,31551,1056,27538,24,2400,1963,22989,1991,20697,1992,43686,California
Imperial,2021-03-20,1855,63344,596,32147,1241,28779,18,2418,1355,23879,490,21187,1380,45066,California
Imperial,2021-03-21,298,63642,109,32256,184,28963,5,2423,168,23930,130,21317,181,45247,California
Imperial,2021-03-22,1182,64824,433,32689,722,29685,27,2450,658,24106,521,21838,697,45944,California
Imperial,2021-03-23,1638,66462,577,33266,1039,30724,22,2472,997,24495,637,22475,1026,46970,California
Imperial,2021-03-24,2330,68792,661,33927,1226,31950,443,2915,1241,25097,1085,23560,1687,48657,California
Imperial,2021-03-25,3354,72146,820,34747,906,32856,1628,4543,1266,25901,2082,25642,2886,51543,California
Imperial,2021-03-26,3384,75530,1277,36024,1089,33945,1018,5561,982,25518,2389,28031,2006,53549,California
Imperial,2021-03-27,722,76252,346,36370,308,34253,68,5629,468,25804,250,28281,536,54085,California
Imperial,2021-03-28,272,76524,95,36465,169,34422,8,5637,189,25922,81,28362,199,54284,California
Imperial,2021-03-29,1673,78197,428,36893,438,34860,807,6444,378,25819,1290,29652,1187,55471,California
Imperial,2021-03-30,2259,80456,756,37649,619,35479,884,7328,708,25861,1547,31199,1589,57060,California
Imperial,2021-03-31,1699,82155,793,38442,850,36329,56,7384,1070,26360,626,31825,1125,58185,California
Imperial,2021-04-01,2265,84420,491,38933,1448,37777,326,7710,920,26271,1335,33160,1246,59431,California
Imperial,2021-04-02,2303,86723,538,39471,1629,39406,136,7846,1471,27055,823,33983,1607,61038,California
Imperial,2021-04-03,1596,88319,481,39952,1025,40431,90,7936,715,26983,879,34862,807,61845,California
Imperial,2021-04-04,127,88446,77,40029,33,40464,17,7953,38,26950,89,34951,56,61901,California
Imperial,2021-04-05,3528,91974,2363,42392,942,41406,223,8176,825,25312,2692,37643,1054,62955,California
Imperial,2021-04-06,1491,93465,607,42999,618,42024,266,8442,727,25550,759,38402,997,63952,California
Imperial,2021-04-07,2317,95782,629,43628,1251,43275,437,8879,1592,26845,728,39130,2023,65975,California
Imperial,2021-04-08,2361,98143,1147,44775,855,44130,359,9238,1101,27048,1255,40385,1458,67433,California
Imperial,2021-04-09,3624,101767,1733,46508,1096,45226,795,10033,1607,27438,2007,42392,2397,69830,California
Imperial,2021-04-10,1422,103189,249,46757,850,46076,323,10356,267,26875,1151,43543,588,70418,California
Imperial,2021-04-11,263,103452,67,46824,163,46239,33,10389,91,26830,171,43714,126,70544,California
Imperial,2021-04-12,1525,104977,831,47655,471,46710,223,10612,855,27247,662,44376,1079,71623,California
Imperial,2021-04-13,3022,107999,1956,49611,1064,47774,2,10614,2063,28361,954,45330,2068,73691,California
Imperial,2021-04-14,2140,110139,1024,50635,1116,48890,0,10614,1411,29056,721,46051,1416,75107,California
Imperial,2021-04-15,2074,112213,952,51587,1122,50012,0,10614,1368,29732,698,46749,1374,76481,California
Imperial,2021-04-16,3603,115816,1837,53424,1766,51778,0,10614,2248,30641,1342,48091,2251,78732,California
Imperial,2021-04-17,1905,117721,966,54390,937,52715,2,10616,1461,31667,438,48529,1464,80196,California
Imperial,2021-04-18,281,118002,90,54480,191,52906,0,10616,93,31577,186,48715,96,80292,California
Imperial,2021-04-19,890,118892,287,54767,603,53509,0,10616,433,31561,454,49169,438,80730,California
Imperial,2021-04-20,1422,120314,572,55339,849,54358,1,10617,788,31721,631,49800,791,81521,California
Imperial,2021-04-21,1527,121841,404,55743,1122,55480,1,10618,862,31927,657,50457,863,82384,California
Imperial,2021-04-22,2584,124425,856,56599,1728,57208,0,10618,1783,32926,786,51243,1785,84169,California
Imperial,2021-04-23,2935,127360,562,57161,2373,59581,0,10618,1132,32293,1769,53012,1136,85305,California
Imperial,2021-04-24,622,127982,349,57510,273,59854,0,10618,246,32165,374,53386,246,85551,California
Imperial,2021-04-25,283,128265,109,57619,174,60028,0,10618,133,32151,147,53533,133,85684,California
Imperial,2021-04-26,1294,129559,508,58127,781,60809,5,10623,731,32331,556,54089,736,86420,California
Imperial,2021-04-27,1223,130782,403,58530,808,61617,12,10635,613,32354,603,54692,626,87046,California
Imperial,2021-04-28,1573,132355,671,59201,867,62484,35,10670,719,32262,846,55538,754,87800,California
Imperial,2021-04-29,1940,134295,896,60097,994,63478,50,10720,861,32109,1066,56604,913,88713,California
Imperial,2021-04-30,3382,137677,1714,61811,1629,65107,39,10759,1638,32050,1736,58340,1677,90390,California
Imperial,2021-05-01,408,138085,158,61969,248,65355,2,10761,209,32068,195,58535,213,90603,California
Imperial,2021-05-02,100,138185,34,62003,59,65414,7,10768,47,32070,53,58588,55,90658,California
Imperial,2021-05-03,1717,139902,579,62582,1090,66504,48,10816,400,31213,1304,59892,447,91105,California
Imperial,2021-05-04,1870,141772,1000,63582,843,67347,27,10843,604,30589,1255,61147,631,91736,California
Imperial,2021-05-05,1599,143371,926,64508,652,67999,21,10864,504,30033,1082,62229,526,92262,California
Imperial,2021-05-06,1818,145189,1178,65686,598,68597,42,10906,587,29440,1224,63453,631,92893,California
Imperial,2021-05-07,2718,147907,1487,67173,1174,69771,57,10963,920,28644,1776,65229,980,93873,California
Imperial,2021-05-08,838,148745,660,67833,169,69940,9,10972,221,28264,610,65839,230,94103,California
Imperial,2021-05-09,111,148856,75,67908,34,69974,2,10974,32,28224,75,65914,35,94138,California
Imperial,2021-05-10,1205,150061,315,68223,766,70740,124,11098,367,27885,829,66743,490,94628,California
Imperial,2021-05-11,1552,151613,489,68712,1041,71781,22,11120,541,27448,1005,67748,568,95196,California
Imperial,2021-05-12,928,152541,284,68996,603,72384,41,11161,354,27273,569,68317,394,95590,California
Imperial,2021-05-13,2000,154541,1295,70291,633,73017,72,11233,908,27173,1078,69395,978,96568,California
Imperial,2021-05-14,1851,156392,986,71277,802,73819,63,11296,1197,27792,641,70036,1260,97828,California
Imperial,2021-05-15,1308,157700,495,71772,791,74610,22,11318,494,27500,809,70845,517,98345,California
Imperial,2021-05-16,130,157830,89,71861,37,74647,4,11322,57,27489,72,70917,61,98406,California
Imperial,2021-05-17,2006,159836,738,72599,1213,75860,55,11377,697,26938,1303,72220,752,99158,California
Imperial,2021-05-18,1821,161657,910,73509,831,76691,80,11457,985,27176,828,73048,1066,100224,California
Imperial,2021-05-19,1390,163047,626,74135,693,77384,71,11528,641,27148,739,73787,711,100935,California
Imperial,2021-05-20,1958,165005,1071,75206,807,78191,80,11608,825,26937,1116,74903,905,101840,California
Imperial,2021-05-21,2010,167015,1256,76462,689,78880,65,11673,1008,27020,990,75893,1073,102913,California
Imperial,2021-05-22,370,167385,202,76664,144,79024,24,11697,177,27035,186,76079,201,103114,California
Imperial,2021-05-23,100,167485,38,76702,53,79077,9,11706,37,27020,61,76140,46,103160,California
Imperial,2021-05-24,1305,168790,642,77344,599,79676,64,11770,531,26847,767,76907,594,103754,California
Imperial,2021-05-25,1583,170373,499,77843,1036,80712,48,11818,566,26457,1005,77912,615,104369,California
Imperial,2021-05-26,1144,171517,584,78427,502,81214,58,11876,509,26392,631,78543,566,104935,California
Imperial,2021-05-27,1427,172944,764,79191,584,81798,79,11955,703,26455,719,79262,782,105717,California
Imperial,2021-05-28,1158,174102,629,79820,436,82234,93,12048,427,26257,719,79981,521,106238,California
Imperial,2021-05-29,357,174459,156,79976,159,82393,42,12090,167,26276,189,80170,208,106446,California
Imperial,2021-05-30,106,174565,33,80009,71,82464,2,12092,72,26316,34,80204,74,106520,California
Imperial,2021-05-31,83,174648,23,80032,53,82517,7,12099,39,26318,44,80248,46,106566,California
Imperial,2021-06-01,1342,175990,588,80620,633,83150,121,12220,506,26120,826,81074,628,107194,California
Imperial,2021-06-02,1232,177222,631,81251,472,83622,129,12349,613,26250,610,81684,740,107934,California
Imperial,2021-06-03,1384,178606,767,82018,479,84101,138,12487,625,26261,752,82436,763,108697,California
Imperial,2021-06-04,2529,181135,1747,83765,622,84723,160,12647,1047,26002,1465,83901,1206,109903,California
Imperial,2021-06-05,485,181620,274,84039,153,84876,58,12705,228,26036,252,84153,286,110189,California
Imperial,2021-06-06,87,181707,50,84089,25,84901,12,12717,45,26052,42,84195,58,110247,California
Imperial,2021-06-07,1036,182743,670,84759,295,85196,71,12788,493,26076,540,84735,564,110811,California
Imperial,2021-06-08,1491,184234,1068,85827,334,85530,89,12877,601,25881,884,85619,689,111500,California
Imperial,2021-06-09,1146,185380,791,86618,278,85808,77,12954,524,25865,616,86235,600,112100,California
Imperial,2021-06-10,1232,186612,800,87418,358,86166,74,13028,445,25602,782,87017,519,112619,California
Imperial,2021-06-11,1742,188354,1226,88644,448,86614,68,13096,746,25437,982,87999,817,113436,California
Imperial,2021-06-12,340,188694,166,88810,141,86755,33,13129,161,25454,177,88176,194,113630,California
Imperial,2021-06-13,89,188783,26,88836,61,86816,2,13131,57,25483,31,88207,60,113690,California
Imperial,2021-06-14,890,189673,633,89469,212,87028,45,13176,383,25408,503,88710,428,114118,California
Imperial,2021-06-15,1112,190785,774,90243,289,87317,49,13225,503,25359,603,89313,554,114672,California
Imperial,2021-06-16,1047,191832,670,90913,307,87624,70,13295,501,25391,541,89854,573,115245,California
Imperial,2021-06-17,1134,192966,803,91716,271,87895,60,13355,478,25276,651,90505,536,115781,California
Imperial,2021-06-18,1187,194153,831,92547,285,88180,71,13426,718,25607,457,90962,788,116569,California
Imperial,2021-06-19,353,194506,221,92768,117,88297,15,13441,177,25624,175,91137,192,116761,California
Imperial,2021-06-20,67,194573,32,92800,31,88328,4,13445,24,25609,43,91180,28,116789,California
Imperial,2021-06-21,693,195266,422,93222,233,88561,38,13483,426,25814,261,91441,466,117255,California
Imperial,2021-06-22,1198,196464,832,94054,315,88876,51,13534,654,25982,537,91978,705,117960,California
Imperial,2021-06-23,1163,197627,795,94849,304,89180,64,13598,631,26155,521,92499,694,118654,California
Imperial,2021-06-24,1071,198698,728,95577,295,89475,48,13646,555,26245,513,93012,603,119257,California
Imperial,2021-06-25,1463,200161,1087,96664,292,89767,84,13730,633,26143,817,93829,715,119972,California
Imperial,2021-06-26,268,200429,172,96836,88,89855,8,13738,90,26065,176,94005,98,120070,California
Imperial,2021-06-27,126,200555,62,96898,59,89914,5,13743,53,26049,73,94078,57,120127,California
Imperial,2021-06-28,656,201211,478,97376,157,90071,21,13764,341,26100,310,94388,361,120488,California
Imperial,2021-06-29,890,202101,654,98030,182,90253,54,13818,409,26088,477,94865,465,120953,California
Imperial,2021-06-30,897,202998,583,98613,289,90542,25,13843,383,25989,509,95374,410,121363,California
Imperial,2021-07-01,806,203804,577,99190,213,90755,16,13859,392,25990,407,95781,408,121771,California
Imperial,2021-07-02,949,204753,639,99829,284,91039,26,13885,405,25882,538,96319,430,122201,California
Imperial,2021-07-03,246,204999,125,99954,115,91154,6,13891,98,25843,142,96461,103,122304,California
Imperial,2021-07-04,43,205042,15,99969,25,91179,3,13894,20,25843,23,96484,23,122327,California
Imperial,2021-07-05,206,205248,91,100060,108,91287,7,13901,84,25812,121,96605,90,122417,California
Imperial,2021-07-06,984,206232,688,100748,267,91554,29,13930,387,25639,590,97195,417,122834,California
Imperial,2021-07-07,853,207085,553,101301,198,91752,102,14032,317,25528,529,97724,418,123252,California
Imperial,2021-07-08,745,207830,538,101839,180,91932,27,14059,324,25464,415,98139,351,123603,California
Imperial,2021-07-09,1026,208856,753,102592,245,92177,28,14087,453,25380,565,98704,481,124084,California
Imperial,2021-07-10,255,209111,133,102725,119,92296,3,14090,126,25382,127,98831,129,124213,California
Imperial,2021-07-11,95,209206,41,102766,54,92350,0,14090,49,25386,45,98876,49,124262,California
Imperial,2021-07-12,685,209891,510,103276,161,92511,14,14104,262,25243,418,99294,275,124537,California
Imperial,2021-07-13,738,210629,545,103821,174,92685,19,14123,345,25219,388,99682,364,124901,California
Imperial,2021-07-14,811,211440,584,104405,204,92889,23,14146,305,25051,495,100177,327,125228,California
Imperial,2021-07-15,719,212159,522,104927,180,93069,17,14163,322,24999,391,100568,339,125567,California
Imperial,2021-07-16,774,212933,555,105482,197,93266,22,14185,372,24998,396,100964,395,125962,California
Imperial,2021-07-17,196,213129,87,105569,109,93375,0,14185,101,25004,95,101059,101,126063,California
Imperial,2021-07-18,56,213185,29,105598,26,93401,1,14186,29,25007,27,101086,30,126093,California
Imperial,2021-07-19,573,213758,374,105972,183,93584,16,14202,251,24957,316,101402,266,126359,California
Imperial,2021-07-20,857,214615,618,106590,205,93789,34,14236,394,24932,453,101855,428,126787,California
Imperial,2021-07-21,707,215322,425,107015,265,94054,17,14253,349,24949,352,102207,369,127156,California
Imperial,2021-07-22,747,216069,513,107528,214,94268,20,14273,336,24902,403,102610,356,127512,California
Imperial,2021-07-23,652,216721,450,107978,186,94454,16,14289,321,24915,324,102934,337,127849,California
Imperial,2021-07-24,210,216931,107,108085,100,94554,3,14292,130,24970,78,103012,133,127982,California
Imperial,2021-07-25,41,216972,10,108095,31,94585,0,14292,26,24982,14,103026,26,128008,California
Imperial,2021-07-26,458,217430,275,108370,156,94741,27,14319,258,25073,195,103221,286,128294,California
Imperial,2021-07-27,676,218106,470,108840,179,94920,27,14346,353,25138,317,103538,382,128676,California
Imperial,2021-07-28,579,218685,384,109224,166,95086,29,14375,327,25246,247,103785,355,129031,California
Imperial,2021-07-29,420,219105,294,109518,111,95197,15,14390,215,25276,200,103985,230,129261,California
Imperial,2021-07-30,506,219611,352,109870,132,95329,22,14412,261,25315,244,104229,283,129544,California
Imperial,2021-07-31,125,219736,93,109963,30,95359,2,14414,63,25318,62,104291,65,129609,California
Inyo,2020-12-19,85,85,85,85,0,0,0,0,85,85,0,0,85,85,California
Inyo,2020-12-20,59,144,59,144,0,0,0,0,59,144,0,0,59,144,California
Inyo,2020-12-21,88,232,85,229,3,3,0,0,88,232,0,0,88,232,California
Inyo,2020-12-22,102,334,101,330,1,4,0,0,102,334,0,0,102,334,California
Inyo,2020-12-23,69,403,65,395,4,8,0,0,69,403,0,0,69,403,California
Inyo,2020-12-24,15,418,15,410,0,8,0,0,15,418,0,0,15,418,California
Inyo,2020-12-25,1,419,0,410,1,9,0,0,1,419,0,0,1,419,California
Inyo,2020-12-26,73,492,73,483,0,9,0,0,73,492,0,0,73,492,California
Inyo,2020-12-28,47,539,35,518,12,21,0,0,47,539,0,0,47,539,California
Inyo,2020-12-29,18,557,18,536,0,21,0,0,18,557,0,0,18,557,California
Inyo,2020-12-30,56,613,54,590,2,23,0,0,56,613,0,0,56,613,California
Inyo,2020-12-31,29,642,0,590,29,52,0,0,29,642,0,0,29,642,California
Inyo,2021-01-01,1,643,0,590,1,53,0,0,1,643,0,0,1,643,California
Inyo,2021-01-03,1,644,0,590,1,54,0,0,1,644,0,0,1,644,California
Inyo,2021-01-04,5,649,2,592,3,57,0,0,5,649,0,0,5,649,California
Inyo,2021-01-05,35,684,0,592,35,92,0,0,35,684,0,0,35,684,California
Inyo,2021-01-06,60,744,0,592,60,152,0,0,60,744,0,0,60,744,California
Inyo,2021-01-07,31,775,1,593,30,182,0,0,31,775,0,0,31,775,California
Inyo,2021-01-08,8,783,8,601,0,182,0,0,3,774,5,5,4,779,California
Inyo,2021-01-09,86,869,86,687,0,182,0,0,0,688,86,91,0,779,California
Inyo,2021-01-10,53,922,53,740,0,182,0,0,0,635,53,144,0,779,California
Inyo,2021-01-11,97,1019,82,822,15,197,0,0,16,570,81,225,16,795,California
Inyo,2021-01-12,133,1152,112,934,21,218,0,0,27,491,106,331,27,822,California
Inyo,2021-01-13,85,1237,67,1001,18,236,0,0,21,449,64,395,22,844,California
Inyo,2021-01-14,60,1297,13,1014,47,283,0,0,50,489,10,405,50,894,California
Inyo,2021-01-15,156,1453,28,1042,128,411,0,0,156,645,0,405,156,1050,California
Inyo,2021-01-16,72,1525,72,1114,0,411,0,0,0,573,72,477,0,1050,California
Inyo,2021-01-18,57,1582,35,1149,22,433,0,0,19,554,38,515,19,1069,California
Inyo,2021-01-19,110,1692,69,1218,41,474,0,0,94,632,16,531,94,1163,California
Inyo,2021-01-20,147,1839,69,1287,78,552,0,0,90,665,57,588,90,1253,California
Inyo,2021-01-21,117,1956,57,1344,60,612,0,0,116,780,1,589,116,1369,California
Inyo,2021-01-22,62,2018,0,1344,62,674,0,0,60,838,2,591,60,1429,California
Inyo,2021-01-23,47,2065,45,1389,2,676,0,0,46,884,0,591,46,1475,California
Inyo,2021-01-25,49,2114,5,1394,44,720,0,0,35,905,14,605,35,1510,California
Inyo,2021-01-26,129,2243,48,1442,81,801,0,0,123,1022,6,611,123,1633,California
Inyo,2021-01-27,24,2267,2,1444,22,823,0,0,23,1044,1,612,23,1656,California
Inyo,2021-01-28,89,2356,2,1446,87,910,0,0,60,1075,29,641,60,1716,California
Inyo,2021-01-29,24,2380,2,1448,22,932,0,0,22,1095,2,643,22,1738,California
Inyo,2021-01-30,10,2390,0,1448,10,942,0,0,10,1105,0,643,10,1748,California
Inyo,2021-01-31,24,2414,3,1451,21,963,0,0,3,1087,21,664,3,1751,California
Inyo,2021-02-01,11,2425,10,1461,1,964,0,0,1,1078,10,674,1,1752,California
Inyo,2021-02-02,130,2555,14,1475,116,1080,0,0,104,1156,26,700,104,1856,California
Inyo,2021-02-03,116,2671,0,1475,116,1196,0,0,72,1185,44,744,73,1929,California
Inyo,2021-02-04,148,2819,32,1507,116,1312,0,0,88,1214,60,804,89,2018,California
Inyo,2021-02-05,107,2926,51,1558,56,1368,0,0,105,1317,2,806,105,2123,California
Inyo,2021-02-06,3,2929,3,1561,0,1368,0,0,2,1319,0,806,2,2125,California
Inyo,2021-02-07,4,2933,2,1563,2,1370,0,0,4,1323,0,806,4,2129,California
Inyo,2021-02-08,112,3045,5,1568,107,1477,0,0,94,1399,18,824,94,2223,California
Inyo,2021-02-09,199,3244,50,1618,149,1626,0,0,129,1458,70,894,129,2352,California
Inyo,2021-02-10,142,3386,14,1632,128,1754,0,0,109,1534,33,927,109,2461,California
Inyo,2021-02-11,224,3610,57,1689,167,1921,0,0,128,1566,96,1023,128,2589,California
Inyo,2021-02-12,294,3904,49,1738,245,2166,0,0,166,1605,127,1150,166,2755,California
Inyo,2021-02-13,49,3953,45,1783,4,2170,0,0,5,1566,44,1194,5,2760,California
Inyo,2021-02-14,2,3955,0,1783,2,2172,0,0,2,1568,0,1194,2,2762,California
Inyo,2021-02-15,26,3981,7,1790,19,2191,0,0,5,1552,21,1215,5,2767,California
Inyo,2021-02-16,175,4156,47,1837,128,2319,0,0,89,1558,83,1298,89,2856,California
Inyo,2021-02-17,39,4195,4,1841,35,2354,0,0,9,1537,30,1328,9,2865,California
Inyo,2021-02-18,120,4315,5,1846,115,2469,0,0,80,1577,40,1368,80,2945,California
Inyo,2021-02-19,51,4366,4,1850,47,2516,0,0,9,1544,42,1410,9,2954,California
Inyo,2021-02-20,509,4875,503,2353,6,2522,0,0,506,2048,2,1412,506,3460,California
Inyo,2021-02-21,442,5317,442,2795,0,2522,0,0,441,2489,0,1412,441,3901,California
Inyo,2021-02-22,60,5377,17,2812,43,2565,0,0,25,2479,35,1447,25,3926,California
Inyo,2021-02-23,198,5575,17,2829,181,2746,0,0,91,2465,105,1552,91,4017,California
Inyo,2021-02-24,117,5692,0,2829,117,2863,0,0,57,2462,60,1612,57,4074,California
Inyo,2021-02-25,127,5819,2,2831,125,2988,0,0,62,2459,65,1677,62,4136,California
Inyo,2021-02-26,97,5916,51,2882,46,3034,0,0,22,2406,75,1752,22,4158,California
Inyo,2021-02-27,15,5931,3,2885,12,3046,0,0,2,2395,13,1765,2,4160,California
Inyo,2021-02-28,2,5933,1,2886,1,3047,0,0,1,2395,1,1766,1,4161,California
Inyo,2021-03-01,19,5952,2,2888,17,3064,0,0,17,2410,2,1768,17,4178,California
Inyo,2021-03-02,197,6149,0,2888,197,3261,0,0,111,2435,86,1854,111,4289,California
Inyo,2021-03-03,86,6235,3,2891,83,3344,0,0,42,2434,43,1897,42,4331,California
Inyo,2021-03-04,125,6360,2,2893,123,3467,0,0,45,2400,79,1976,45,4376,California
Inyo,2021-03-05,142,6502,53,2946,89,3556,0,0,42,2342,100,2076,42,4418,California
Inyo,2021-03-06,20,6522,1,2947,19,3575,0,0,20,2362,0,2076,20,4438,California
Inyo,2021-03-07,6,6528,3,2950,3,3578,0,0,4,2364,2,2078,4,4442,California
Inyo,2021-03-08,167,6695,5,2955,162,3740,0,0,77,2351,90,2168,77,4519,California
Inyo,2021-03-09,190,6885,2,2957,188,3928,0,0,73,2307,117,2285,73,4592,California
Inyo,2021-03-10,71,6956,7,2964,63,3991,1,1,30,2297,41,2326,31,4623,California
Inyo,2021-03-11,209,7165,1,2965,203,4194,5,6,75,2243,134,2460,80,4703,California
Inyo,2021-03-12,176,7341,3,2968,167,4361,6,12,76,2226,99,2559,82,4785,California
Inyo,2021-03-13,569,7910,537,3505,23,4384,9,21,60,1788,507,3066,69,4854,California
Inyo,2021-03-14,439,8349,437,3942,2,4386,0,21,2,1354,436,3502,2,4856,California
Inyo,2021-03-15,51,8400,14,3956,35,4421,2,23,31,1367,20,3522,33,4889,California
Inyo,2021-03-16,161,8561,3,3959,152,4573,6,29,61,1337,98,3620,68,4957,California
Inyo,2021-03-17,107,8668,1,3960,99,4672,7,36,92,1421,15,3635,99,5056,California
Inyo,2021-03-18,184,8852,15,3975,163,4835,6,42,102,1447,82,3717,108,5164,California
Inyo,2021-03-19,46,8898,5,3980,37,4872,4,46,35,1476,10,3727,39,5203,California
Inyo,2021-03-20,19,8917,1,3981,9,4881,9,55,0,1466,19,3746,9,5212,California
Inyo,2021-03-22,59,8976,3,3984,51,4932,5,60,39,1490,20,3766,44,5256,California
Inyo,2021-03-23,193,9169,3,3987,186,5118,4,64,105,1511,88,3854,109,5365,California
Inyo,2021-03-24,141,9310,2,3989,134,5252,5,69,86,1548,55,3909,92,5457,California
Inyo,2021-03-25,331,9641,111,4100,217,5469,3,72,265,1750,66,3975,268,5725,California
Inyo,2021-03-26,92,9733,3,4103,85,5554,4,76,70,1802,22,3997,74,5799,California
Inyo,2021-03-27,46,9779,38,4141,5,5559,3,79,40,1839,6,4003,43,5842,California
Inyo,2021-03-28,2,9781,0,4141,2,5561,0,79,2,1841,0,4003,2,5844,California
Inyo,2021-03-29,107,9888,2,4143,100,5661,5,84,80,1900,26,4029,85,5929,California
Inyo,2021-03-30,220,10108,1,4144,214,5875,5,89,110,1905,110,4139,115,6044,California
Inyo,2021-03-31,148,10256,3,4147,139,6014,6,95,103,1970,45,4184,110,6154,California
Inyo,2021-04-01,166,10422,2,4149,163,6177,1,96,115,2036,50,4234,116,6270,California
Inyo,2021-04-02,82,10504,1,4150,79,6256,2,98,49,2054,33,4267,51,6321,California
Inyo,2021-04-03,72,10576,37,4187,22,6278,13,111,3,2002,67,4334,15,6336,California
Inyo,2021-04-04,5,10581,4,4191,0,6278,1,112,1,2000,4,4338,2,6338,California
Inyo,2021-04-05,100,10681,0,4191,97,6375,3,115,28,1959,72,4410,31,6369,California
Inyo,2021-04-06,234,10915,3,4194,167,6542,64,179,102,1993,132,4542,166,6535,California
Inyo,2021-04-07,204,11119,0,4194,76,6618,128,307,46,2009,158,4700,174,6709,California
Inyo,2021-04-08,181,11300,15,4209,150,6768,16,323,83,2010,98,4798,99,6808,California
Inyo,2021-04-09,122,11422,4,4213,95,6863,23,346,35,1982,86,4884,58,6866,California
Inyo,2021-04-10,42,11464,2,4215,23,6886,17,363,6,1968,36,4920,22,6888,California
Inyo,2021-04-11,1,11465,0,4215,1,6887,0,363,1,1969,0,4920,1,6889,California
Inyo,2021-04-12,80,11545,0,4215,75,6962,5,368,42,1978,38,4958,47,6936,California
Inyo,2021-04-13,123,11668,5,4220,115,7077,3,371,63,1986,58,5016,66,7002,California
Inyo,2021-04-14,130,11798,2,4222,128,7205,0,371,45,1946,85,5101,45,7047,California
Inyo,2021-04-15,268,12066,115,4337,153,7358,0,371,72,1822,196,5297,72,7119,California
Inyo,2021-04-16,45,12111,4,4341,41,7399,0,371,16,1810,28,5325,16,7135,California
Inyo,2021-04-17,2,12113,1,4342,1,7400,0,371,1,1810,1,5326,1,7136,California
Inyo,2021-04-19,123,12236,37,4379,86,7486,0,371,42,1772,80,5406,42,7178,California
Inyo,2021-04-20,165,12401,2,4381,163,7649,0,371,80,1768,85,5491,81,7259,California
Inyo,2021-04-21,113,12514,5,4386,108,7757,0,371,32,1719,81,5572,32,7291,California
Inyo,2021-04-22,199,12713,1,4387,198,7955,0,371,53,1626,146,5718,53,7344,California
Inyo,2021-04-23,95,12808,4,4391,91,8046,0,371,22,1575,73,5791,22,7366,California
Inyo,2021-04-24,313,13121,312,4703,1,8047,0,371,308,1879,5,5796,309,7675,California
Inyo,2021-04-25,140,13261,138,4841,2,8049,0,371,138,2015,2,5798,138,7813,California
Inyo,2021-04-26,93,13354,2,4843,90,8139,1,372,12,1948,80,5878,13,7826,California
Inyo,2021-04-27,182,13536,5,4848,173,8312,4,376,48,1866,134,6012,52,7878,California
Inyo,2021-04-28,121,13657,3,4851,116,8428,2,378,21,1790,99,6111,23,7901,California
Inyo,2021-04-29,172,13829,56,4907,116,8544,0,378,80,1778,92,6203,80,7981,California
Inyo,2021-04-30,81,13910,4,4911,76,8620,1,379,23,1744,58,6261,24,8005,California
Inyo,2021-05-01,10,13920,3,4914,7,8627,0,379,7,1748,3,6264,7,8012,California
Inyo,2021-05-02,6,13926,2,4916,2,8629,2,381,4,1752,2,6266,6,8018,California
Inyo,2021-05-03,38,13964,1,4917,33,8662,4,385,5,1728,33,6299,9,8027,California
Inyo,2021-05-04,119,14083,2,4919,114,8776,3,388,19,1650,100,6399,22,8049,California
Inyo,2021-05-05,37,14120,0,4919,35,8811,2,390,11,1637,26,6425,13,8062,California
Inyo,2021-05-06,95,14215,3,4922,84,8895,8,398,13,1576,82,6507,21,8083,California
Inyo,2021-05-07,48,14263,3,4925,37,8932,8,406,24,1586,22,6529,32,8115,California
Inyo,2021-05-08,13,14276,2,4927,6,8938,5,411,4,1586,9,6538,9,8124,California
Inyo,2021-05-09,1,14277,0,4927,1,8939,0,411,0,1585,1,6539,0,8124,California
Inyo,2021-05-10,70,14347,1,4928,67,9006,2,413,32,1581,39,6578,35,8159,California
Inyo,2021-05-11,89,14436,1,4929,85,9091,3,416,20,1535,69,6647,23,8182,California
Inyo,2021-05-12,43,14479,2,4931,39,9130,2,418,11,1516,32,6679,13,8195,California
Inyo,2021-05-13,77,14556,0,4931,76,9206,1,419,10,1460,67,6746,11,8206,California
Inyo,2021-05-14,27,14583,5,4936,17,9223,5,424,14,1466,13,6759,19,8225,California
Inyo,2021-05-15,377,14960,364,5300,10,9233,3,427,83,1260,292,7051,86,8311,California
Inyo,2021-05-16,202,15162,202,5502,0,9233,0,427,72,1203,129,7180,72,8383,California
Inyo,2021-05-17,61,15223,2,5504,55,9288,4,431,18,1182,43,7223,22,8405,California
Inyo,2021-05-18,86,15309,2,5506,83,9371,1,432,17,1132,68,7291,18,8423,California
Inyo,2021-05-19,46,15355,2,5508,39,9410,5,437,12,1115,34,7325,17,8440,California
Inyo,2021-05-20,146,15501,81,5589,63,9473,2,439,36,1042,111,7436,38,8478,California
Inyo,2021-05-21,48,15549,18,5607,25,9498,5,444,19,1037,29,7465,24,8502,California
Inyo,2021-05-22,24,15573,14,5621,7,9505,3,447,18,1052,6,7471,21,8523,California
Inyo,2021-05-23,2,15575,1,5622,0,9505,1,448,0,1051,2,7473,1,8524,California
Inyo,2021-05-24,33,15608,6,5628,24,9529,3,451,13,1047,20,7493,16,8540,California
Inyo,2021-05-25,81,15689,38,5666,41,9570,2,453,46,1060,35,7528,48,8588,California
Inyo,2021-05-26,46,15735,17,5683,27,9597,2,455,23,1063,22,7550,25,8613,California
Inyo,2021-05-27,39,15774,10,5693,21,9618,8,463,12,1057,26,7576,20,8633,California
Inyo,2021-05-28,26,15800,6,5699,15,9633,5,468,8,1052,18,7594,13,8646,California
Inyo,2021-05-29,14,15814,5,5704,9,9642,0,468,7,1052,7,7601,7,8653,California
Inyo,2021-05-30,2,15816,0,5704,2,9644,0,468,0,1050,2,7603,0,8653,California
Inyo,2021-06-01,54,15870,16,5720,32,9676,6,474,23,1048,31,7634,29,8682,California
Inyo,2021-06-02,12,15882,10,5730,1,9677,1,475,10,1057,2,7636,11,8693,California
Inyo,2021-06-03,26,15908,0,5730,18,9695,8,483,1,1041,25,7661,9,8702,California
Inyo,2021-06-04,32,15940,6,5736,22,9717,4,487,12,1037,20,7681,16,8718,California
Inyo,2021-06-05,16,15956,7,5743,8,9725,1,488,4,1030,12,7693,5,8723,California
Inyo,2021-06-07,51,16007,15,5758,33,9758,3,491,5,992,46,7739,8,8731,California
Inyo,2021-06-08,51,16058,23,5781,25,9783,3,494,24,992,27,7766,27,8758,California
Inyo,2021-06-09,111,16169,95,5876,14,9797,2,496,14,911,97,7863,16,8774,California
Inyo,2021-06-10,52,16221,38,5914,9,9806,5,501,13,891,38,7901,18,8792,California
Inyo,2021-06-11,41,16262,22,5936,17,9823,2,503,16,884,25,7926,18,8810,California
Inyo,2021-06-12,15,16277,8,5944,6,9829,1,504,5,880,10,7936,6,8816,California
Inyo,2021-06-13,1,16278,0,5944,1,9830,0,504,0,879,1,7937,0,8816,California
Inyo,2021-06-14,57,16335,27,5971,27,9857,3,507,7,839,50,7987,10,8826,California
Inyo,2021-06-15,50,16385,37,6008,9,9866,4,511,8,809,42,8029,12,8838,California
Inyo,2021-06-16,32,16417,19,6027,13,9879,0,511,6,789,26,8055,6,8844,California
Inyo,2021-06-17,23,16440,13,6040,6,9885,4,515,5,781,17,8072,9,8853,California
Inyo,2021-06-18,14,16454,5,6045,6,9891,3,518,2,774,12,8084,5,8858,California
Inyo,2021-06-19,21,16475,7,6052,13,9904,1,519,7,769,13,8097,8,8866,California
Inyo,2021-06-21,29,16504,8,6060,18,9922,3,522,13,769,16,8113,16,8882,California
Inyo,2021-06-22,51,16555,42,6102,7,9929,2,524,24,768,27,8140,26,8908,California
Inyo,2021-06-23,14,16569,6,6108,7,9936,1,525,1,757,13,8153,2,8910,California
Inyo,2021-06-24,6,16575,2,6110,3,9939,1,526,3,758,3,8156,4,8914,California
Inyo,2021-06-25,29,16604,13,6123,13,9952,3,529,15,762,14,8170,18,8932,California
Inyo,2021-06-26,12,16616,6,6129,4,9956,2,531,4,760,8,8178,6,8938,California
Inyo,2021-06-27,1,16617,1,6130,0,9956,0,531,1,761,0,8178,1,8939,California
Inyo,2021-06-28,14,16631,12,6142,2,9958,0,531,8,763,6,8184,8,8947,California
Inyo,2021-06-29,34,16665,29,6171,5,9963,0,531,14,757,20,8204,14,8961,California
Inyo,2021-06-30,21,16686,17,6188,4,9967,0,531,7,750,14,8218,7,8968,California
Inyo,2021-07-01,13,16699,8,6196,5,9972,0,531,7,751,6,8224,7,8975,California
Inyo,2021-07-02,21,16720,9,6205,12,9984,0,531,13,756,8,8232,13,8988,California
Inyo,2021-07-03,6,16726,6,6211,0,9984,0,531,5,760,1,8233,5,8993,California
Inyo,2021-07-05,4,16730,2,6213,2,9986,0,531,0,756,4,8237,0,8993,California
Inyo,2021-07-06,23,16753,14,6227,9,9995,0,531,15,763,8,8245,15,9008,California
Inyo,2021-07-07,17,16770,8,6235,7,10002,2,533,3,754,14,8259,5,9013,California
Inyo,2021-07-08,8,16778,6,6241,2,10004,0,533,7,760,1,8260,7,9020,California
Inyo,2021-07-09,7,16785,5,6246,1,10005,1,534,4,762,3,8263,5,9025,California
Inyo,2021-07-10,9,16794,7,6253,2,10007,0,534,4,761,5,8268,4,9029,California
Inyo,2021-07-11,2,16796,2,6255,0,10007,0,534,1,761,1,8269,1,9030,California
Inyo,2021-07-12,20,16816,7,6262,13,10020,0,534,11,763,9,8278,11,9041,California
Inyo,2021-07-13,19,16835,18,6280,1,10021,0,534,5,754,14,8292,5,9046,California
Inyo,2021-07-14,18,16853,16,6296,2,10023,0,534,14,766,2,8294,14,9060,California
Inyo,2021-07-15,11,16864,7,6303,4,10027,0,534,8,771,3,8297,8,9068,California
Inyo,2021-07-16,26,16890,16,6319,9,10036,1,535,17,780,9,8306,18,9086,California
Inyo,2021-07-17,13,16903,8,6327,5,10041,0,535,3,773,10,8316,3,9089,California
Inyo,2021-07-19,24,16927,5,6332,18,10059,1,536,15,780,9,8325,16,9105,California
Inyo,2021-07-20,24,16951,17,6349,7,10066,0,536,16,788,8,8333,16,9121,California
Inyo,2021-07-21,10,16961,4,6353,5,10071,1,537,6,791,4,8337,7,9128,California
Inyo,2021-07-22,14,16975,10,6363,4,10075,0,537,6,789,8,8345,6,9134,California
Inyo,2021-07-23,35,17010,18,6381,16,10091,1,538,16,787,19,8364,17,9151,California
Inyo,2021-07-24,15,17025,9,6390,6,10097,0,538,8,788,7,8371,8,9159,California
Inyo,2021-07-25,1,17026,0,6390,1,10098,0,538,1,789,0,8371,1,9160,California
Inyo,2021-07-26,12,17038,10,6400,2,10100,0,538,8,793,4,8375,8,9168,California
Inyo,2021-07-27,31,17069,21,6421,9,10109,1,539,19,801,12,8387,20,9188,California
Inyo,2021-07-28,15,17084,10,6431,4,10113,1,540,7,801,8,8395,8,9196,California
Inyo,2021-07-29,21,17105,7,6438,14,10127,0,540,15,810,6,8401,15,9211,California
Inyo,2021-07-30,14,17119,9,6447,5,10132,0,540,11,818,3,8404,11,9222,California
Inyo,2021-07-31,4,17123,4,6451,0,10132,0,540,1,816,3,8407,1,9223,California
Kern,2020-12-15,1,1,1,1,0,0,0,0,1,1,0,0,1,1,California
Kern,2020-12-16,19,20,19,20,0,0,0,0,19,20,0,0,19,20,California
Kern,2020-12-17,162,182,162,182,0,0,0,0,162,182,0,0,162,182,California
Kern,2020-12-18,326,508,326,508,0,0,0,0,326,508,0,0,326,508,California
Kern,2020-12-19,99,607,99,607,0,0,0,0,99,607,0,0,99,607,California
Kern,2020-12-20,62,669,62,669,0,0,0,0,62,669,0,0,62,669,California
Kern,2020-12-21,668,1337,667,1336,1,1,0,0,668,1337,0,0,668,1337,California
Kern,2020-12-22,534,1871,532,1868,2,3,0,0,534,1871,0,0,534,1871,California
Kern,2020-12-23,555,2426,417,2285,138,141,0,0,555,2426,0,0,555,2426,California
Kern,2020-12-24,123,2549,44,2329,79,220,0,0,123,2549,0,0,123,2549,California
Kern,2020-12-25,1,2550,1,2330,0,220,0,0,1,2550,0,0,1,2550,California
Kern,2020-12-26,35,2585,2,2332,33,253,0,0,35,2585,0,0,35,2585,California
Kern,2020-12-27,35,2620,3,2335,32,285,0,0,35,2620,0,0,35,2620,California
Kern,2020-12-28,828,3448,663,2998,165,450,0,0,828,3448,0,0,828,3448,California
Kern,2020-12-29,746,4194,451,3449,295,745,0,0,745,4192,1,1,745,4193,California
Kern,2020-12-30,1209,5403,918,4367,291,1036,0,0,1209,5401,0,1,1209,5402,California
Kern,2020-12-31,276,5679,99,4466,177,1213,0,0,276,5677,0,1,276,5678,California
Kern,2021-01-01,23,5702,10,4476,13,1226,0,0,23,5700,0,1,23,5701,California
Kern,2021-01-02,80,5782,18,4494,62,1288,0,0,80,5780,0,1,80,5781,California
Kern,2021-01-03,23,5805,4,4498,19,1307,0,0,23,5803,0,1,23,5804,California
Kern,2021-01-04,553,6358,362,4860,191,1498,0,0,553,6356,0,1,553,6357,California
Kern,2021-01-05,1131,7489,735,5595,396,1894,0,0,1119,7463,12,13,1119,7476,California
Kern,2021-01-06,1165,8654,450,6045,715,2609,0,0,1134,8566,31,44,1134,8610,California
Kern,2021-01-07,1413,10067,489,6534,924,3533,0,0,1245,9644,167,211,1245,9855,California
Kern,2021-01-08,1630,11697,771,7305,859,4392,0,0,1331,10675,300,511,1331,11186,California
Kern,2021-01-09,229,11926,79,7384,150,4542,0,0,193,10832,36,547,193,11379,California
Kern,2021-01-10,194,12120,149,7533,45,4587,0,0,153,10944,41,588,153,11532,California
Kern,2021-01-11,1560,13680,985,8518,575,5162,0,0,1004,11392,556,1144,1004,12536,California
Kern,2021-01-12,1886,15566,819,9337,1067,6229,0,0,1367,12241,519,1663,1368,13904,California
Kern,2021-01-13,1862,17428,879,10216,983,7212,0,0,1438,13255,424,2087,1438,15342,California
Kern,2021-01-14,2208,19636,655,10871,1553,8765,0,0,2161,15369,47,2134,2161,17503,California
Kern,2021-01-15,2729,22365,860,11731,1869,10634,0,0,2634,17910,94,2228,2635,20138,California
Kern,2021-01-16,678,23043,214,11945,464,11098,0,0,643,18518,35,2263,643,20781,California
Kern,2021-01-17,79,23122,8,11953,71,11169,0,0,77,18593,2,2265,77,20858,California
Kern,2021-01-18,1643,24765,655,12608,988,12157,0,0,1478,19906,165,2430,1478,22336,California
Kern,2021-01-19,1873,26638,1035,13643,838,12995,0,0,1408,20850,465,2895,1409,23745,California
Kern,2021-01-20,2739,29377,1793,15436,946,13941,0,0,1955,22028,779,3674,1957,25702,California
Kern,2021-01-21,2131,31508,872,16308,1259,15200,0,0,1934,23766,196,3870,1934,27636,California
Kern,2021-01-22,2728,34236,1314,17622,1414,16614,0,0,2445,25929,282,4152,2445,30081,California
Kern,2021-01-23,1258,35494,543,18165,715,17329,0,0,1208,27087,50,4202,1208,31289,California
Kern,2021-01-24,152,35646,10,18175,142,17471,0,0,146,27227,6,4208,146,31435,California
Kern,2021-01-25,2381,38027,1083,19258,1298,18769,0,0,1895,28639,484,4692,1896,33331,California
Kern,2021-01-26,2787,40814,1131,20389,1656,20425,0,0,1926,29705,860,5552,1926,35257,California
Kern,2021-01-27,3562,44376,1893,22282,1669,22094,0,0,2861,31868,698,6250,2861,38118,California
Kern,2021-01-28,2899,47275,1366,23648,1533,23627,0,0,2468,33912,426,6676,2470,40588,California
Kern,2021-01-29,3798,51073,1802,25450,1996,25623,0,0,3243,36603,552,7228,3243,43831,California
Kern,2021-01-30,1336,52409,502,25952,834,26457,0,0,1282,37833,52,7280,1282,45113,California
Kern,2021-01-31,395,52804,271,26223,124,26581,0,0,260,37958,135,7415,260,45373,California
Kern,2021-02-01,2585,55389,969,27192,1616,28197,0,0,1872,39122,710,8125,1874,47247,California
Kern,2021-02-02,2765,58154,802,27994,1963,30160,0,0,2056,40470,709,8834,2057,49304,California
Kern,2021-02-03,3702,61856,1554,29548,2148,32308,0,0,2716,42207,979,9813,2716,52020,California
Kern,2021-02-04,3818,65674,1449,30997,2369,34677,0,0,2577,43556,1228,11041,2577,54597,California
Kern,2021-02-05,4874,70548,1989,32986,2885,37562,0,0,3098,44897,1757,12798,3098,57695,California
Kern,2021-02-06,1748,72296,763,33749,985,38547,0,0,1511,46175,233,13031,1511,59206,California
Kern,2021-02-07,275,72571,142,33891,133,38680,0,0,256,46414,17,13048,256,59462,California
Kern,2021-02-08,2564,75135,779,34670,1785,40465,0,0,1251,46371,1295,14343,1252,60714,California
Kern,2021-02-09,3053,78188,979,35649,2074,42539,0,0,1467,46262,1576,15919,1467,62181,California
Kern,2021-02-10,3830,82018,1673,37322,2157,44696,0,0,1868,46186,1944,17863,1868,64049,California
Kern,2021-02-11,4295,86313,1539,38861,2756,47452,0,0,2227,46361,2055,19918,2230,66279,California
Kern,2021-02-12,5008,91321,1904,40765,3104,50556,0,0,2483,46334,2510,22428,2483,68762,California
Kern,2021-02-13,2015,93336,733,41498,1282,51838,0,0,1158,46637,855,23283,1158,69920,California
Kern,2021-02-14,358,93694,14,41512,344,52182,0,0,274,46828,83,23366,274,70194,California
Kern,2021-02-15,2769,96463,908,42420,1861,54043,0,0,1221,46510,1539,24905,1221,71415,California
Kern,2021-02-16,2978,99441,721,43141,2257,56300,0,0,1662,46866,1307,26212,1663,73078,California
Kern,2021-02-17,4125,103566,2099,45240,2026,58326,0,0,1948,46645,2170,28382,1949,75027,California
Kern,2021-02-18,3810,107376,1513,46753,2297,60623,0,0,1632,46112,2165,30547,1632,76659,California
Kern,2021-02-19,4266,111642,1945,48698,2321,62944,0,0,1775,45404,2483,33030,1775,78434,California
Kern,2021-02-20,2632,114274,983,49681,1649,64593,0,0,1369,45517,1256,34286,1369,79803,California
Kern,2021-02-21,268,114542,157,49838,111,64704,0,0,89,45430,177,34463,90,79893,California
Kern,2021-02-22,2811,117353,1235,51073,1576,66280,0,0,1508,45644,1294,35757,1508,81401,California
Kern,2021-02-23,3698,121051,1188,52261,2510,68790,0,0,2037,46025,1657,37414,2038,83439,California
Kern,2021-02-24,5432,126483,2384,54645,3048,71838,0,0,3209,47022,2212,39626,3209,86648,California
Kern,2021-02-25,5582,132065,2570,57215,3012,74850,0,0,3309,48081,2250,41876,3309,89957,California
Kern,2021-02-26,7195,139260,3662,60877,3533,78383,0,0,4529,49957,2655,44531,4531,94488,California
Kern,2021-02-27,4136,143396,2054,62931,2082,80465,0,0,2722,51276,1403,45934,2722,97210,California
Kern,2021-02-28,958,144354,525,63456,432,80897,1,1,717,51756,238,46172,718,97928,California
Kern,2021-03-01,4084,148438,1859,65315,2221,83118,4,5,2751,53190,1321,47493,2755,100683,California
Kern,2021-03-02,4603,153041,1424,66739,3175,86293,4,9,3012,54626,1578,49071,3014,103697,California
Kern,2021-03-03,6108,159149,2873,69612,3233,89526,2,11,3947,56430,2144,51215,3948,107645,California
Kern,2021-03-04,5791,164940,2292,71904,3494,93020,5,16,3757,58174,2016,53231,3760,111405,California
Kern,2021-03-05,6824,171764,2887,74791,3918,96938,19,35,4230,59843,2581,55812,4250,115655,California
Kern,2021-03-06,4807,176571,1927,76718,2770,99708,110,145,3504,62161,1296,57108,3614,119269,California
Kern,2021-03-07,2099,178670,1598,78316,427,100135,74,219,1880,63898,217,57325,1954,121223,California
Kern,2021-03-08,2933,181603,925,79241,1775,101910,233,452,1536,64269,1394,58719,1765,122988,California
Kern,2021-03-09,3753,185356,806,80047,2558,104468,389,841,2342,65593,1402,60121,2726,125714,California
Kern,2021-03-10,6204,191560,2584,82631,2535,107003,1085,1926,3621,67730,2566,62687,4703,130417,California
Kern,2021-03-11,6343,197903,2445,85076,2871,109874,1027,2953,3769,69960,2560,65247,4790,135207,California
Kern,2021-03-12,7887,205790,3090,88166,3438,113312,1359,4312,4333,72094,3542,68789,5676,140883,California
Kern,2021-03-13,4687,210477,2538,90704,1810,115122,339,4651,3259,74266,1420,70209,3592,144475,California
Kern,2021-03-14,2318,212795,1533,92237,538,115660,247,4898,1792,75773,524,70733,2031,146506,California
Kern,2021-03-15,4273,217068,1109,93346,2458,118118,706,5604,2174,76559,2086,72819,2872,149378,California
Kern,2021-03-16,4451,221519,1014,94360,2891,121009,546,6150,2403,77466,2035,74854,2942,152320,California
Kern,2021-03-17,7500,229019,4102,98462,2844,123853,554,6704,4458,79446,3028,77882,5008,157328,California
Kern,2021-03-18,7345,236364,3736,102198,3020,126873,589,7293,4404,81515,2919,80801,4988,162316,California
Kern,2021-03-19,9152,245516,5016,107214,3368,130241,768,8061,4647,82440,4482,85283,5407,167723,California
Kern,2021-03-20,6282,251798,3847,111061,2249,132490,186,8247,3944,84247,2325,87608,4132,171855,California
Kern,2021-03-21,3095,254893,1962,113023,247,132737,886,9133,1884,85811,1202,88810,2766,174621,California
Kern,2021-03-22,3992,258885,1563,114586,2074,134811,355,9488,1893,85982,2077,90887,2248,176869,California
Kern,2021-03-23,4767,263652,1679,116265,2889,137700,199,9687,2470,86384,2265,93152,2667,179536,California
Kern,2021-03-24,7215,270867,3698,119963,3039,140739,478,10165,3633,86930,3561,96713,4107,183643,California
Kern,2021-03-25,6828,277695,3024,122987,3471,144210,333,10498,3199,86851,3608,100321,3529,187172,California
Kern,2021-03-26,9924,287619,4442,127429,4224,148434,1258,11756,4660,87528,5240,105561,5917,193089,California
Kern,2021-03-27,5753,293372,4024,131453,1599,150033,130,11886,3449,88808,2297,107858,3577,196666,California
Kern,2021-03-28,4724,298096,4224,135677,486,150519,14,11900,2967,90036,1753,109611,2981,199647,California
Kern,2021-03-29,4274,302370,1689,137366,2309,152828,276,12176,2602,91254,1657,111268,2875,202522,California
Kern,2021-03-30,5617,307987,1883,139249,3345,156173,389,12565,3021,92074,2586,113854,3406,205928,California
Kern,2021-03-31,8495,316482,4590,143839,3245,159418,660,13225,4303,92862,4172,118026,4960,210888,California
Kern,2021-04-01,7953,324435,3899,147738,3741,163159,313,13538,4216,93685,3701,121727,4524,215412,California
Kern,2021-04-02,8475,332910,4468,152206,3396,166555,611,14149,4195,94219,4260,125987,4794,220206,California
Kern,2021-04-03,6018,338928,3681,155887,2156,168711,181,14330,2658,93705,3349,129336,2835,223041,California
Kern,2021-04-04,1341,340269,873,156760,382,169093,86,14416,467,93385,871,130207,551,223592,California
Kern,2021-04-05,5406,345675,2236,158996,2391,171484,779,15195,2910,94563,2480,132687,3658,227250,California
Kern,2021-04-06,7141,352816,2467,161463,3292,174776,1382,16577,3557,95932,3558,136245,4927,232177,California
Kern,2021-04-07,9407,362223,5486,166949,2955,177731,966,17543,4561,96633,4824,141069,5525,237702,California
Kern,2021-04-08,8691,370914,4811,171760,2965,180696,915,18458,3732,96342,4924,145993,4633,242335,California
Kern,2021-04-09,10376,381290,5159,176919,4221,184917,996,19454,4357,95702,5987,151980,5347,247682,California
Kern,2021-04-10,6629,387919,3488,180407,1889,186806,1252,20706,2152,94636,4463,156443,3397,251079,California
Kern,2021-04-11,4235,392154,2959,183366,373,187179,903,21609,1284,93875,2936,159379,2175,253254,California
Kern,2021-04-12,4439,396593,1001,184367,2464,189643,974,22583,1593,93619,2821,162200,2565,255819,California
Kern,2021-04-13,4320,400913,1421,185788,2873,192516,26,22609,2113,93569,2188,164388,2138,257957,California
Kern,2021-04-14,6146,407059,3034,188822,3090,195606,22,22631,3020,93503,3107,167495,3041,260998,California
Kern,2021-04-15,5307,412366,2479,191301,2825,198431,3,22634,2497,93210,2793,170288,2500,263498,California
Kern,2021-04-16,7368,419734,3476,194777,3891,202322,1,22635,2989,91856,4347,174635,2993,266491,California
Kern,2021-04-17,6014,425748,3946,198723,2068,204390,0,22635,2093,90049,3902,178537,2095,268586,California
Kern,2021-04-18,3911,429659,3663,202386,248,204638,0,22635,931,88012,2969,181506,932,269518,California
Kern,2021-04-19,3869,433528,1746,204132,2121,206759,2,22637,1435,87036,2411,183917,1435,270953,California
Kern,2021-04-20,4504,438032,1677,205809,2825,209584,2,22639,1712,85983,2767,186684,1714,272667,California
Kern,2021-04-21,6034,444066,3273,209082,2756,212340,5,22644,2207,84397,3796,190480,2210,274877,California
Kern,2021-04-22,4918,448984,2413,211495,2505,214845,0,22644,1742,82990,3150,193630,1743,276620,California
Kern,2021-04-23,6296,455280,3134,214629,3161,218006,1,22645,1963,80666,4291,197921,1967,278587,California
Kern,2021-04-24,4075,459355,2848,217477,1216,219222,11,22656,1463,79551,2590,200511,1475,280062,California
Kern,2021-04-25,1421,460776,1132,218609,289,219511,0,22656,841,79818,574,201085,841,280903,California
Kern,2021-04-26,3921,464697,1880,220489,1990,221501,51,22707,1079,78120,2831,203916,1133,282036,California
Kern,2021-04-27,4863,469560,2387,222876,2368,223869,108,22815,1504,76389,3340,207256,1609,283645,California
Kern,2021-04-28,6473,476033,3858,226734,2491,226360,124,22939,1880,73823,4569,211825,2003,285648,California
Kern,2021-04-29,5691,481724,3205,229939,2387,228747,99,23038,1717,71693,3947,215772,1817,287465,California
Kern,2021-04-30,5778,487502,3271,233210,2347,231094,160,23198,1701,69494,4059,219831,1860,289325,California
Kern,2021-05-01,2784,490286,1977,235187,748,231842,59,23257,1115,69016,1651,221482,1173,290498,California
Kern,2021-05-02,1891,492177,1604,236791,265,232107,22,23279,685,68524,1199,222681,707,291205,California
Kern,2021-05-03,2589,494766,1053,237844,1402,233509,134,23413,803,67693,1770,224451,939,292144,California
Kern,2021-05-04,3770,498536,1361,239205,2300,235809,109,23522,1326,66700,2426,226877,1433,293577,California
Kern,2021-05-05,4283,502819,2244,241449,1883,237692,156,23678,1429,65450,2833,229710,1583,295160,California
Kern,2021-05-06,3737,506556,1738,243187,1852,239544,147,23825,1168,64222,2540,232250,1312,296472,California
Kern,2021-05-07,4690,511246,2363,245550,2152,241696,175,24000,1324,62391,3329,235579,1498,297970,California
Kern,2021-05-08,2954,514200,1860,247410,977,242673,117,24117,922,61411,2017,237596,1037,299007,California
Kern,2021-05-09,1359,515559,1183,248593,146,242819,30,24147,442,60976,907,238503,472,299479,California
Kern,2021-05-10,2335,517894,921,249514,1310,244129,104,24251,681,60130,1630,240133,784,300263,California
Kern,2021-05-11,2775,520669,1014,250528,1636,245765,125,24376,1003,59500,1759,241892,1129,301392,California
Kern,2021-05-12,3683,524352,1491,252019,2039,247804,153,24529,1155,58294,2510,244402,1304,302696,California
Kern,2021-05-13,3561,527913,1875,253894,1531,249335,155,24684,1659,58217,1887,246289,1810,304506,California
Kern,2021-05-14,4350,532263,2583,256477,1542,250877,225,24909,1998,58108,2332,248621,2223,306729,California
Kern,2021-05-15,2950,535213,1923,258400,939,251816,88,24997,1569,58400,1364,249985,1656,308385,California
Kern,2021-05-16,1618,536831,1389,259789,189,252005,40,25037,935,58700,675,250660,975,309360,California
Kern,2021-05-17,2349,539180,1010,260799,1193,253198,146,25183,1184,58878,1151,251811,1329,310689,California
Kern,2021-05-18,3238,542418,1498,262297,1608,254806,132,25315,1631,59047,1592,253403,1761,312450,California
Kern,2021-05-19,3844,546262,2397,264694,1318,256124,129,25444,1783,58911,2045,255448,1909,314359,California
Kern,2021-05-20,3149,549411,1725,266419,1281,257405,143,25587,1418,58761,1709,257157,1559,315918,California
Kern,2021-05-21,3644,553055,2205,268624,1304,258709,135,25722,1805,58889,1814,258971,1942,317860,California
Kern,2021-05-22,2964,556019,2305,270929,610,259319,49,25771,1395,58774,1556,260527,1441,319301,California
Kern,2021-05-23,1311,557330,1114,272043,170,259489,27,25798,686,58869,617,261144,712,320013,California
Kern,2021-05-24,1911,559241,824,272867,973,260462,114,25912,898,58876,1004,262148,1011,321024,California
Kern,2021-05-25,2400,561641,1110,273977,1200,261662,90,26002,1101,58782,1284,263432,1190,322214,California
Kern,2021-05-26,2817,564458,1634,275611,1080,262742,103,26105,1210,58504,1589,265021,1311,323525,California
Kern,2021-05-27,2436,566894,1263,276874,1068,263810,105,26210,1280,58754,1133,266154,1383,324908,California
Kern,2021-05-28,2745,569639,1406,278280,1230,265040,109,26319,1270,58672,1459,267613,1377,326285,California
Kern,2021-05-29,1916,571555,1264,279544,603,265643,49,26368,935,58689,967,268580,984,327269,California
Kern,2021-05-30,872,572427,712,280256,140,265783,20,26388,439,58724,424,269004,459,327728,California
Kern,2021-05-31,148,572575,48,280304,89,265872,11,26399,55,58700,89,269093,65,327793,California
Kern,2021-06-01,2301,574876,956,281260,1273,267145,72,26471,970,58428,1312,270405,1040,328833,California
Kern,2021-06-02,2256,577132,1305,282565,847,267992,104,26575,946,58179,1299,271704,1050,329883,California
Kern,2021-06-03,2383,579515,1340,283905,887,268879,156,26731,860,57683,1511,273215,1015,330898,California
Kern,2021-06-04,2980,582495,1931,285836,936,269815,113,26844,873,56588,2080,275295,985,331883,California
Kern,2021-06-05,2539,585034,2047,287883,458,270273,34,26878,796,55684,1734,277029,830,332713,California
Kern,2021-06-06,1236,586270,1131,289014,82,270355,23,26901,409,55294,822,277851,432,333145,California
Kern,2021-06-07,1817,588087,1132,290146,589,270944,96,26997,681,54949,1120,278971,775,333920,California
Kern,2021-06-08,2120,590207,1236,291382,814,271758,70,27067,644,54207,1455,280426,713,334633,California
Kern,2021-06-09,2628,592835,1843,293225,696,272454,89,27156,823,53325,1793,282219,911,335544,California
Kern,2021-06-10,2250,595085,1387,294612,762,273216,101,27257,774,52736,1462,283681,873,336417,California
Kern,2021-06-11,2865,597950,1917,296529,858,274074,90,27347,1081,52141,1767,285448,1172,337589,California
Kern,2021-06-12,1791,599741,1328,297857,414,274488,49,27396,534,51471,1253,286701,583,338172,California
Kern,2021-06-13,944,600685,827,298684,110,274598,7,27403,278,51093,664,287365,286,338458,California
Kern,2021-06-14,1862,602547,1137,299821,631,275229,94,27497,649,50631,1204,288569,742,339200,California
Kern,2021-06-15,2125,604672,1189,301010,858,276087,78,27575,824,50241,1293,289862,903,340103,California
Kern,2021-06-16,2091,606763,1381,302391,633,276720,77,27652,817,49878,1256,291118,893,340996,California
Kern,2021-06-17,1982,608745,1270,303661,596,277316,116,27768,927,49880,1042,292160,1044,342040,California
Kern,2021-06-18,2256,611001,1422,305083,716,278032,118,27886,972,49703,1266,293426,1089,343129,California
Kern,2021-06-19,1241,612242,892,305975,314,278346,35,27921,528,49563,702,294128,562,343691,California
Kern,2021-06-20,739,612981,614,306589,105,278451,20,27941,291,49426,448,294576,311,344002,California
Kern,2021-06-21,1260,614241,672,307261,510,278961,78,28019,680,49612,570,295146,756,344758,California
Kern,2021-06-22,1665,615906,888,308149,701,279662,76,28095,679,49392,975,296121,755,345513,California
Kern,2021-06-23,1730,617636,1106,309255,546,280208,78,28173,766,49290,944,297065,842,346355,California
Kern,2021-06-24,1600,619236,986,310241,525,280733,89,28262,685,49156,908,297973,774,347129,California
Kern,2021-06-25,1819,621055,1141,311382,586,281319,92,28354,858,49155,949,298922,948,348077,California
Kern,2021-06-26,1331,622386,990,312372,309,281628,32,28386,572,49004,754,299676,603,348680,California
Kern,2021-06-27,614,623000,522,312894,77,281705,15,28401,267,48943,343,300019,282,348962,California
Kern,2021-06-28,1152,624152,765,313659,299,282004,88,28489,511,48912,627,300646,596,349558,California
Kern,2021-06-29,1404,625556,720,314379,593,282597,91,28580,610,48829,782,301428,699,350257,California
Kern,2021-06-30,1601,627157,1070,315449,446,283043,85,28665,818,48955,778,302206,904,351161,California
Kern,2021-07-01,1391,628548,890,316339,437,283480,64,28729,637,48906,750,302956,701,351862,California
Kern,2021-07-02,1764,630312,1179,317518,512,283992,73,28802,808,48845,940,303896,879,352741,California
Kern,2021-07-03,1010,631322,706,318224,263,284255,41,28843,497,48875,508,304404,538,353279,California
Kern,2021-07-04,133,631455,98,318322,35,284290,0,28843,64,48871,68,304472,64,353343,California
Kern,2021-07-05,660,632115,401,318723,234,284524,25,28868,293,48827,362,304834,318,353661,California
Kern,2021-07-06,1556,633671,912,319635,558,285082,86,28954,668,48704,877,305711,754,354415,California
Kern,2021-07-07,1510,635181,1025,320660,421,285503,64,29018,645,48556,855,306566,707,355122,California
Kern,2021-07-08,1465,636646,962,321622,436,285939,67,29085,569,48301,891,307457,636,355758,California
Kern,2021-07-09,1644,638290,1031,322653,537,286476,76,29161,751,48242,885,308342,826,356584,California
Kern,2021-07-10,908,639198,626,323279,255,286731,27,29188,448,48263,455,308797,476,357060,California
Kern,2021-07-11,542,639740,462,323741,75,286806,5,29193,236,48201,303,309100,241,357301,California
Kern,2021-07-12,1354,641094,921,324662,356,287162,77,29270,569,48068,779,309879,646,357947,California
Kern,2021-07-13,1307,642401,732,325394,524,287686,51,29321,619,48056,681,310560,669,358616,California
Kern,2021-07-14,1231,643632,768,326162,397,288083,66,29387,561,48022,658,311218,624,359240,California
Kern,2021-07-15,1304,644936,845,327007,419,288502,40,29427,643,48053,653,311871,684,359924,California
Kern,2021-07-16,1688,646624,1090,328097,538,289040,60,29487,890,48211,791,312662,949,360873,California
Kern,2021-07-17,1158,647782,821,328918,311,289351,26,29513,575,48237,574,313236,600,361473,California
Kern,2021-07-18,522,648304,395,329313,125,289476,2,29515,290,48301,228,313464,292,361765,California
Kern,2021-07-19,1369,649673,865,330178,446,289922,58,29573,718,48432,645,314109,776,362541,California
Kern,2021-07-20,1600,651273,895,331073,649,290571,56,29629,939,48776,650,314759,994,363535,California
Kern,2021-07-21,1600,652873,1054,332127,496,291067,50,29679,842,48923,743,315502,890,364425,California
Kern,2021-07-22,1538,654411,1008,333135,472,291539,58,29737,885,49216,648,316150,941,365366,California
Kern,2021-07-23,1790,656201,1079,334214,651,292190,60,29797,1018,49531,760,316910,1075,366441,California
Kern,2021-07-24,1009,657210,627,334841,361,292551,21,29818,601,49750,403,317313,622,367063,California
Kern,2021-07-25,564,657774,426,335267,132,292683,6,29824,396,49988,164,317477,402,367465,California
Kern,2021-07-26,1482,659256,921,336188,497,293180,64,29888,996,50566,482,317959,1060,368525,California
Kern,2021-07-27,1706,660962,1066,337254,583,293763,57,29945,1027,50982,669,318628,1085,369610,California
Kern,2021-07-28,1592,662554,995,338249,549,294312,48,29993,1034,51518,545,319173,1081,370691,California
Kern,2021-07-29,1619,664173,1026,339275,528,294840,65,30058,1004,51981,604,319777,1067,371758,California
Kern,2021-07-30,1890,666063,1184,340459,639,295479,67,30125,1149,52462,735,320512,1216,372974,California
Kern,2021-07-31,764,666827,533,340992,215,295694,16,30141,452,52626,305,320817,469,373443,California
Kings,2020-12-16,1,1,1,1,0,0,0,0,1,1,0,0,1,1,California
Kings,2020-12-17,8,9,8,9,0,0,0,0,8,9,0,0,8,9,California
Kings,2020-12-18,12,21,12,21,0,0,0,0,12,21,0,0,12,21,California
Kings,2020-12-19,12,33,12,33,0,0,0,0,12,33,0,0,12,33,California
Kings,2020-12-20,13,46,13,46,0,0,0,0,13,46,0,0,13,46,California
Kings,2020-12-21,159,205,159,205,0,0,0,0,268,314,0,0,268,314,California
Kings,2020-12-22,139,344,139,344,0,0,0,0,136,450,0,0,136,450,California
Kings,2020-12-23,137,481,122,466,15,15,0,0,138,588,0,0,138,588,California
Kings,2020-12-24,11,492,9,475,2,17,0,0,11,599,0,0,11,599,California
Kings,2020-12-26,7,499,4,479,3,20,0,0,7,606,0,0,7,606,California
Kings,2020-12-27,4,503,4,483,0,20,0,0,4,610,0,0,4,610,California
Kings,2020-12-28,131,634,103,586,28,48,0,0,132,742,0,0,132,742,California
Kings,2020-12-29,84,718,56,642,28,76,0,0,85,827,0,0,85,827,California
Kings,2020-12-30,150,868,109,751,41,117,0,0,150,977,0,0,150,977,California
Kings,2020-12-31,46,914,5,756,41,158,0,0,46,1023,0,0,46,1023,California
Kings,2021-01-01,1,915,0,756,1,159,0,0,1,1024,0,0,1,1024,California
Kings,2021-01-02,11,926,9,765,2,161,0,0,11,1035,0,0,11,1035,California
Kings,2021-01-03,1,927,1,766,0,161,0,0,1,1036,0,0,1,1036,California
Kings,2021-01-04,113,1040,41,807,72,233,0,0,113,1149,0,0,113,1149,California
Kings,2021-01-05,195,1235,40,847,155,388,0,0,195,1344,0,0,195,1344,California
Kings,2021-01-06,277,1512,180,1027,97,485,0,0,274,1615,3,3,274,1618,California
Kings,2021-01-07,181,1693,83,1110,98,583,0,0,173,1780,8,11,173,1791,California
Kings,2021-01-08,250,1943,57,1167,193,776,0,0,229,1988,21,32,229,2020,California
Kings,2021-01-09,62,2005,8,1175,54,830,0,0,54,2034,8,40,54,2074,California
Kings,2021-01-10,15,2020,3,1178,12,842,0,0,12,2043,3,43,12,2086,California
Kings,2021-01-11,514,2534,350,1528,164,1006,0,0,275,2080,239,282,276,2362,California
Kings,2021-01-12,347,2881,252,1780,95,1101,0,0,216,2168,128,410,216,2578,California
Kings,2021-01-13,418,3299,271,2051,147,1248,0,0,328,2406,90,500,328,2906,California
Kings,2021-01-14,211,3510,32,2083,179,1427,0,0,201,2587,21,521,202,3108,California
Kings,2021-01-15,421,3931,32,2115,389,1816,0,0,409,2984,12,533,409,3517,California
Kings,2021-01-16,28,3959,10,2125,18,1834,0,0,27,3010,1,534,27,3544,California
Kings,2021-01-17,14,3973,11,2136,3,1837,0,0,12,3020,2,536,12,3556,California
Kings,2021-01-18,174,4147,41,2177,133,1970,0,0,148,3142,26,562,148,3704,California
Kings,2021-01-19,381,4528,159,2336,222,2192,0,0,254,3269,127,689,254,3958,California
Kings,2021-01-20,256,4784,163,2499,93,2285,0,0,135,3288,116,805,135,4093,California
Kings,2021-01-21,209,4993,56,2555,153,2438,0,0,191,3460,19,824,191,4284,California
Kings,2021-01-22,110,5103,19,2574,91,2529,0,0,109,3564,5,829,109,4393,California
Kings,2021-01-23,26,5129,13,2587,13,2542,0,0,20,3578,6,835,20,4413,California
Kings,2021-01-24,4,5133,4,2591,0,2542,0,0,2,3578,2,837,2,4415,California
Kings,2021-01-25,160,5293,55,2646,105,2647,0,0,97,3612,63,900,97,4512,California
Kings,2021-01-26,173,5466,53,2699,120,2767,0,0,113,3665,60,960,113,4625,California
Kings,2021-01-27,361,5827,64,2763,297,3064,0,0,255,3815,105,1065,255,4880,California
Kings,2021-01-28,366,6193,75,2838,291,3355,0,0,279,4007,87,1152,279,5159,California
Kings,2021-01-29,114,6307,27,2865,87,3442,0,0,96,4085,18,1170,96,5255,California
Kings,2021-01-30,1574,7881,19,2884,1555,4997,0,0,1570,5653,4,1174,1572,6827,California
Kings,2021-01-31,1,7882,1,2885,0,4997,0,0,1,5654,0,1174,1,6828,California
Kings,2021-02-01,243,8125,86,2971,157,5154,0,0,93,5599,148,1322,93,6921,California
Kings,2021-02-02,344,8469,112,3083,232,5386,0,0,99,5454,244,1566,99,7020,California
Kings,2021-02-03,481,8950,269,3352,212,5598,0,0,240,5454,240,1806,240,7260,California
Kings,2021-02-04,494,9444,158,3510,336,5934,0,0,230,5421,263,2069,230,7490,California
Kings,2021-02-05,417,9861,59,3569,358,6292,0,0,253,5514,160,2229,253,7743,California
Kings,2021-02-06,62,9923,11,3580,51,6343,0,0,28,5508,34,2263,28,7771,California
Kings,2021-02-07,6,9929,4,3584,2,6345,0,0,3,5508,3,2266,3,7774,California
Kings,2021-02-08,173,10102,29,3613,144,6489,0,0,66,5467,107,2373,66,7840,California
Kings,2021-02-09,259,10361,61,3674,198,6687,0,0,113,5436,144,2517,113,7953,California
Kings,2021-02-10,390,10751,112,3786,278,6965,0,0,264,5574,126,2643,264,8217,California
Kings,2021-02-11,560,11311,66,3852,494,7459,0,0,371,5758,187,2830,371,8588,California
Kings,2021-02-12,734,12045,36,3888,698,8157,0,0,354,5733,379,3209,354,8942,California
Kings,2021-02-13,247,12292,6,3894,241,8398,0,0,222,5930,25,3234,222,9164,California
Kings,2021-02-14,105,12397,4,3898,101,8499,0,0,97,6019,8,3242,97,9261,California
Kings,2021-02-15,254,12651,5,3903,249,8748,0,0,139,6044,114,3356,139,9400,California
Kings,2021-02-16,640,13291,36,3939,604,9352,0,0,363,6133,275,3631,364,9764,California
Kings,2021-02-17,447,13738,27,3966,420,9772,0,0,307,6301,140,3771,308,10072,California
Kings,2021-02-18,363,14101,22,3988,341,10113,0,0,223,6385,139,3910,223,10295,California
Kings,2021-02-19,230,14331,26,4014,204,10317,0,0,137,6432,90,4000,137,10432,California
Kings,2021-02-20,167,14498,32,4046,135,10452,0,0,138,6541,29,4029,138,10570,California
Kings,2021-02-21,4,14502,3,4049,1,10453,0,0,3,6543,1,4030,3,10573,California
Kings,2021-02-22,132,14634,20,4069,112,10565,0,0,58,6527,74,4104,58,10631,California
Kings,2021-02-23,449,15083,75,4144,374,10939,0,0,328,6734,121,4225,328,10959,California
Kings,2021-02-24,788,15871,169,4313,619,11558,0,0,548,7042,240,4465,548,11507,California
Kings,2021-02-25,868,16739,139,4452,729,12287,0,0,628,7432,238,4703,628,12135,California
Kings,2021-02-26,1022,17761,139,4591,883,13170,0,0,930,8270,92,4795,930,13065,California
Kings,2021-02-27,1579,19340,68,4659,1511,14681,0,0,618,7928,960,5755,618,13683,California
Kings,2021-02-28,1231,20571,614,5273,617,15298,0,0,694,8089,535,6290,696,14379,California
Kings,2021-03-01,306,20877,91,5364,215,15513,0,0,232,8247,74,6364,232,14611,California
Kings,2021-03-02,608,21485,264,5628,344,15857,0,0,533,8706,75,6439,534,15145,California
Kings,2021-03-03,782,22267,330,5958,451,16308,1,1,548,9024,232,6671,550,15695,California
Kings,2021-03-04,853,23120,359,6317,494,16802,0,1,710,9592,143,6814,711,16406,California
Kings,2021-03-05,1214,24334,369,6686,835,17637,10,11,987,10367,227,7041,1002,17408,California
Kings,2021-03-06,521,24855,189,6875,319,17956,13,24,490,10839,31,7072,503,17911,California
Kings,2021-03-07,468,25323,322,7197,138,18094,8,32,457,11293,11,7083,465,18376,California
Kings,2021-03-08,386,25709,98,7295,234,18328,54,86,269,11499,117,7200,323,18699,California
Kings,2021-03-09,711,26420,409,7704,248,18576,54,140,599,12042,111,7311,654,19353,California
Kings,2021-03-10,866,27286,270,7974,486,19062,110,250,581,12449,283,7594,690,20043,California
Kings,2021-03-11,1250,28536,457,8431,676,19738,117,367,780,12879,468,8062,898,20941,California
Kings,2021-03-12,1550,30086,463,8894,995,20733,92,459,1003,13433,543,8605,1097,22038,California
Kings,2021-03-13,674,30760,328,9222,305,21038,41,500,548,13898,126,8731,591,22629,California
Kings,2021-03-14,681,31441,105,9327,187,21225,389,889,206,14018,475,9206,595,23224,California
Kings,2021-03-15,716,32157,272,9599,326,21551,118,1007,475,14373,240,9446,595,23819,California
Kings,2021-03-16,1214,33371,487,10086,667,22218,60,1067,761,14744,452,9898,823,24642,California
Kings,2021-03-17,1184,34555,433,10519,690,22908,61,1128,786,15201,398,10296,855,25497,California
Kings,2021-03-18,1259,35814,485,11004,551,23459,223,1351,761,15692,496,10792,987,26484,California
Kings,2021-03-19,1012,36826,464,11468,456,23915,92,1443,725,16238,286,11078,832,27316,California
Kings,2021-03-20,649,37475,258,11726,360,24275,31,1474,468,16566,179,11257,507,27823,California
Kings,2021-03-21,1427,38902,1091,12817,323,24598,13,1487,853,16858,574,11831,866,28689,California
Kings,2021-03-22,450,39352,198,13015,165,24763,87,1574,261,17022,188,12019,352,29041,California
Kings,2021-03-23,1063,40415,514,13529,485,25248,64,1638,552,17132,509,12528,619,29660,California
Kings,2021-03-24,1114,41529,489,14018,601,25849,24,1662,498,17044,613,13141,525,30185,California
Kings,2021-03-25,1075,42604,477,14495,569,26418,29,1691,440,16879,633,13774,468,30653,California
Kings,2021-03-26,1430,44034,382,14877,959,27377,89,1780,393,16329,1032,14806,482,31135,California
Kings,2021-03-27,656,44690,266,15143,378,27755,12,1792,147,15981,507,15313,159,31294,California
Kings,2021-03-28,679,45369,607,15750,65,27820,7,1799,313,15948,366,15679,333,31627,California
Kings,2021-03-29,483,45852,220,15970,202,28022,61,1860,264,16055,217,15896,324,31951,California
Kings,2021-03-30,980,46832,553,16523,385,28407,42,1902,430,15977,549,16445,471,32422,California
Kings,2021-03-31,942,47774,490,17013,378,28785,74,1976,414,15944,520,16965,487,32909,California
Kings,2021-04-01,941,48715,509,17522,341,29126,91,2067,359,15819,575,17540,450,33359,California
Kings,2021-04-02,1137,49852,463,17985,546,29672,128,2195,390,15595,741,18281,517,33876,California
Kings,2021-04-03,491,50343,344,18329,138,29810,9,2204,172,15464,313,18594,182,34058,California
Kings,2021-04-04,160,50503,86,18415,68,29878,6,2210,41,15393,118,18712,47,34105,California
Kings,2021-04-05,1072,51575,335,18750,487,30365,250,2460,242,15053,830,19542,490,34595,California
Kings,2021-04-06,1269,52844,502,19252,457,30822,310,2770,282,14659,984,20526,590,35185,California
Kings,2021-04-07,1398,54242,665,19917,543,31365,190,2960,339,14132,1056,21582,529,35714,California
Kings,2021-04-08,1641,55883,643,20560,746,32111,252,3212,376,13504,1256,22838,628,36342,California
Kings,2021-04-09,1253,57136,593,21153,476,32587,184,3396,236,12906,1015,23853,417,36759,California
Kings,2021-04-10,604,57740,335,21488,163,32750,106,3502,176,12761,426,24279,281,37040,California
Kings,2021-04-11,356,58096,74,21562,275,33025,7,3509,195,12805,158,24437,202,37242,California
Kings,2021-04-12,707,58803,312,21874,191,33216,204,3713,192,12688,513,24950,396,37638,California
Kings,2021-04-13,915,59718,520,22394,395,33611,0,3713,283,12345,630,25580,287,37925,California
Kings,2021-04-14,1063,60781,583,22977,480,34091,0,3713,380,12044,682,26262,381,38306,California
Kings,2021-04-15,1060,61841,517,23494,542,34633,1,3714,439,11867,617,26879,440,38746,California
Kings,2021-04-16,803,62644,367,23861,436,35069,0,3714,261,11589,540,27419,262,39008,California
Kings,2021-04-17,474,63118,257,24118,217,35286,0,3714,193,11503,279,27698,193,39201,California
Kings,2021-04-18,575,63693,250,24368,325,35611,0,3714,39,11006,536,28234,39,39240,California
Kings,2021-04-19,629,64322,387,24755,242,35853,0,3714,292,10964,334,28568,292,39532,California
Kings,2021-04-20,768,65090,467,25222,301,36154,0,3714,243,10683,524,29092,243,39775,California
Kings,2021-04-21,699,65789,352,25574,347,36501,0,3714,244,10480,447,29539,244,40019,California
Kings,2021-04-22,577,66366,293,25867,284,36785,0,3714,212,10332,361,29900,213,40232,California
Kings,2021-04-23,697,67063,304,26171,393,37178,0,3714,336,10311,357,30257,336,40568,California
Kings,2021-04-24,250,67313,181,26352,68,37246,1,3715,120,10303,129,30386,121,40689,California
Kings,2021-04-25,206,67519,188,26540,18,37264,0,3715,169,10435,37,30423,169,40858,California
Kings,2021-04-26,322,67841,178,26718,141,37405,3,3718,198,10512,124,30547,201,41059,California
Kings,2021-04-27,440,68281,199,26917,222,37627,19,3737,188,10470,249,30796,207,41266,California
Kings,2021-04-28,534,68815,272,27189,242,37869,20,3757,278,10512,256,31052,298,41564,California
Kings,2021-04-29,311,69126,129,27318,169,38038,13,3770,143,10503,165,31217,156,41720,California
Kings,2021-04-30,377,69503,168,27486,192,38230,17,3787,157,10461,216,31433,174,41894,California
Kings,2021-05-01,234,69737,170,27656,54,38284,10,3797,75,10388,158,31591,85,41979,California
Kings,2021-05-02,171,69908,149,27805,22,38306,0,3797,127,10471,44,31635,127,42106,California
Kings,2021-05-03,480,70388,253,28058,213,38519,14,3811,125,10256,354,31989,139,42245,California
Kings,2021-05-04,537,70925,279,28337,238,38757,20,3831,166,10072,370,32359,186,42431,California
Kings,2021-05-05,566,71491,298,28635,248,39005,20,3851,142,9813,421,32780,162,42593,California
Kings,2021-05-06,584,72075,300,28935,260,39265,24,3875,134,9523,448,33228,158,42751,California
Kings,2021-05-07,369,72444,214,29149,139,39404,16,3891,148,9468,219,33447,164,42915,California
Kings,2021-05-08,246,72690,180,29329,54,39458,12,3903,84,9402,161,33608,95,43010,California
Kings,2021-05-09,191,72881,61,29390,130,39588,0,3903,41,9293,150,33758,41,43051,California
Kings,2021-05-10,344,73225,265,29655,68,39656,11,3914,114,9191,226,33984,124,43175,California
Kings,2021-05-11,386,73611,238,29893,118,39774,30,3944,116,9069,269,34253,147,43322,California
Kings,2021-05-12,405,74016,168,30061,223,39997,14,3958,165,9010,238,34491,179,43501,California
Kings,2021-05-13,422,74438,170,30231,244,40241,8,3966,172,8941,249,34740,180,43681,California
Kings,2021-05-14,467,74905,316,30547,118,40359,33,3999,241,8989,225,34965,273,43954,California
Kings,2021-05-15,359,75264,256,30803,84,40443,19,4018,198,9045,161,35126,217,44171,California
Kings,2021-05-16,250,75514,223,31026,26,40469,1,4019,74,8944,176,35302,75,44246,California
Kings,2021-05-17,404,75918,321,31347,66,40535,17,4036,208,8975,194,35496,225,44471,California
Kings,2021-05-18,403,76321,284,31631,106,40641,13,4049,226,9038,177,35673,240,44711,California
Kings,2021-05-19,582,76903,286,31917,271,40912,25,4074,229,8941,351,36024,254,44965,California
Kings,2021-05-20,451,77354,237,32154,187,41099,27,4101,261,9040,190,36214,289,45254,California
Kings,2021-05-21,521,77875,263,32417,247,41346,11,4112,263,9061,253,36467,274,45528,California
Kings,2021-05-22,304,78179,245,32662,47,41393,12,4124,216,9203,86,36553,228,45756,California
Kings,2021-05-23,232,78411,225,32887,7,41400,0,4124,106,9183,126,36679,106,45862,California
Kings,2021-05-24,265,78676,179,33066,72,41472,14,4138,127,9186,138,36817,141,46003,California
Kings,2021-05-25,407,79083,271,33337,103,41575,33,4171,235,9284,170,36987,268,46271,California
Kings,2021-05-26,307,79390,126,33463,164,41739,17,4188,122,9239,184,37171,139,46410,California
Kings,2021-05-27,327,79717,179,33642,130,41869,18,4206,177,9287,147,37318,195,46605,California
Kings,2021-05-28,289,80006,141,33783,129,41998,19,4225,130,9282,154,37472,149,46754,California
Kings,2021-05-29,174,80180,100,33883,63,42061,11,4236,86,9292,87,37559,97,46851,California
Kings,2021-05-30,132,80312,115,33998,15,42076,2,4238,70,9302,62,37621,72,46923,California
Kings,2021-05-31,41,80353,21,34019,17,42093,3,4241,15,9294,26,37647,18,46941,California
Kings,2021-06-01,316,80669,186,34205,114,42207,16,4257,119,9235,193,37840,134,47075,California
Kings,2021-06-02,273,80942,123,34328,143,42350,7,4264,81,9134,189,38029,88,47163,California
Kings,2021-06-03,225,81167,126,34454,88,42438,11,4275,69,9066,148,38177,80,47243,California
Kings,2021-06-04,427,81594,284,34738,129,42567,14,4289,152,8961,271,38448,166,47409,California
Kings,2021-06-05,257,81851,224,34962,26,42593,7,4296,62,8848,182,38630,69,47478,California
Kings,2021-06-06,162,82013,154,35116,3,42596,5,4301,81,8857,77,38707,86,47564,California
Kings,2021-06-07,293,82306,224,35340,55,42651,14,4315,96,8770,196,38903,109,47673,California
Kings,2021-06-08,313,82619,240,35580,53,42704,20,4335,78,8635,233,39136,98,47771,California
Kings,2021-06-09,402,83021,270,35850,123,42827,9,4344,116,8477,283,39419,125,47896,California
Kings,2021-06-10,341,83362,223,36073,105,42932,13,4357,82,8313,259,39678,95,47991,California
Kings,2021-06-11,377,83739,285,36358,89,43021,3,4360,146,8236,226,39904,149,48140,California
Kings,2021-06-12,267,84006,220,36578,43,43064,4,4364,67,8123,184,40088,71,48211,California
Kings,2021-06-13,128,84134,119,36697,8,43072,1,4365,34,8065,93,40181,35,48246,California
Kings,2021-06-14,242,84376,174,36871,46,43118,22,4387,96,8037,146,40327,118,48364,California
Kings,2021-06-15,254,84630,181,37052,62,43180,11,4398,88,7971,165,40492,99,48463,California
Kings,2021-06-16,254,84884,130,37182,116,43296,8,4406,89,7911,158,40650,98,48561,California
Kings,2021-06-17,209,85093,111,37293,88,43384,10,4416,81,7874,128,40778,91,48652,California
Kings,2021-06-18,253,85346,174,37467,70,43454,9,4425,117,7864,136,40914,126,48778,California
Kings,2021-06-19,102,85448,69,37536,28,43482,5,4430,41,7849,61,40975,46,48824,California
Kings,2021-06-20,84,85532,69,37605,9,43491,6,4436,28,7827,56,41031,34,48858,California
Kings,2021-06-21,180,85712,96,37701,53,43544,31,4467,96,7870,84,41115,127,48985,California
Kings,2021-06-22,199,85911,128,37829,63,43607,8,4475,83,7845,116,41231,91,49076,California
Kings,2021-06-23,196,86107,92,37921,89,43696,15,4490,87,7839,108,41339,102,49178,California
Kings,2021-06-24,146,86253,69,37990,72,43768,5,4495,57,7813,88,41427,62,49240,California
Kings,2021-06-25,315,86568,222,38212,84,43852,9,4504,158,7824,156,41583,167,49407,California
Kings,2021-06-26,122,86690,80,38292,38,43890,4,4508,51,7808,71,41654,55,49462,California
Kings,2021-06-27,119,86809,112,38404,6,43896,1,4509,39,7771,77,41731,40,49502,California
Kings,2021-06-28,198,87007,144,38548,37,43933,17,4526,86,7762,112,41843,103,49605,California
Kings,2021-06-29,179,87186,133,38681,36,43969,10,4536,88,7771,89,41932,98,49703,California
Kings,2021-06-30,197,87383,119,38800,70,44039,8,4544,91,7764,106,42038,99,49802,California
Kings,2021-07-01,136,87519,91,38891,38,44077,7,4551,66,7769,68,42106,73,49875,California
Kings,2021-07-02,184,87703,119,39010,56,44133,9,4560,91,7776,93,42199,100,49975,California
Kings,2021-07-03,103,87806,82,39092,20,44153,1,4561,52,7778,51,42250,53,50028,California
Kings,2021-07-04,4,87810,0,39092,4,44157,0,4561,3,7780,1,42251,3,50031,California
Kings,2021-07-05,96,87906,57,39149,27,44184,12,4573,49,7794,47,42298,61,50092,California
Kings,2021-07-06,221,88127,160,39309,49,44233,12,4585,86,7757,135,42433,98,50190,California
Kings,2021-07-07,233,88360,134,39443,88,44321,11,4596,119,7774,113,42546,130,50320,California
Kings,2021-07-08,205,88565,126,39569,71,44392,8,4604,85,7748,119,42665,93,50413,California
Kings,2021-07-09,213,88778,128,39697,82,44474,3,4607,108,7757,102,42767,111,50524,California
Kings,2021-07-10,98,88876,60,39757,33,44507,5,4612,54,7772,44,42811,59,50583,California
Kings,2021-07-11,86,88962,74,39831,8,44515,4,4616,43,7776,43,42854,47,50630,California
Kings,2021-07-12,212,89174,143,39974,59,44574,10,4626,87,7748,125,42979,97,50727,California
Kings,2021-07-13,131,89305,95,40069,35,44609,1,4627,67,7752,64,43043,68,50795,California
Kings,2021-07-14,171,89476,98,40167,67,44676,6,4633,91,7769,80,43123,97,50892,California
Kings,2021-07-15,140,89616,78,40245,59,44735,3,4636,77,7786,63,43186,80,50972,California
Kings,2021-07-16,194,89810,134,40379,54,44789,6,4642,74,7748,118,43304,80,51052,California
Kings,2021-07-17,89,89899,65,40444,20,44809,4,4646,45,7753,44,43348,49,51101,California
Kings,2021-07-18,93,89992,86,40530,5,44814,2,4648,49,7761,43,43391,51,51152,California
Kings,2021-07-19,167,90159,111,40641,37,44851,19,4667,68,7749,99,43490,87,51239,California
Kings,2021-07-20,212,90371,147,40788,62,44913,3,4670,125,7790,87,43577,128,51367,California
Kings,2021-07-21,276,90647,183,40971,81,44994,12,4682,176,7878,100,43677,188,51555,California
Kings,2021-07-22,296,90943,194,41165,85,45079,17,4699,170,7941,123,43800,186,51741,California
Kings,2021-07-23,229,91172,137,41302,88,45167,4,4703,146,8011,80,43880,150,51891,California
Kings,2021-07-24,106,91278,79,41381,21,45188,6,4709,60,8033,44,43924,66,51957,California
Kings,2021-07-25,95,91373,78,41459,17,45205,0,4709,77,8092,18,43942,77,52034,California
Kings,2021-07-26,178,91551,109,41568,67,45272,2,4711,130,8177,47,43989,132,52166,California
Kings,2021-07-27,197,91748,135,41703,56,45328,6,4717,123,8232,74,44063,129,52295,California
Kings,2021-07-28,286,92034,162,41865,112,45440,12,4729,176,8310,110,44173,188,52483,California
Kings,2021-07-29,250,92284,150,42015,80,45520,20,4749,161,8403,88,44261,181,52664,California
Kings,2021-07-30,258,92542,154,42169,101,45621,3,4752,188,8528,66,44327,191,52855,California
Kings,2021-07-31,54,92596,35,42204,18,45639,1,4753,41,8557,13,44340,42,52897,California
Lake,2020-12-17,4,4,4,4,0,0,0,0,4,4,0,0,4,4,California
Lake,2020-12-18,49,53,49,53,0,0,0,0,49,53,0,0,49,53,California
Lake,2020-12-19,3,56,3,56,0,0,0,0,3,56,0,0,3,56,California
Lake,2020-12-20,6,62,6,62,0,0,0,0,6,62,0,0,6,62,California
Lake,2020-12-21,89,151,89,151,0,0,0,0,89,151,0,0,89,151,California
Lake,2020-12-22,62,213,59,210,3,3,0,0,62,213,0,0,62,213,California
Lake,2020-12-23,127,340,118,328,9,12,0,0,127,340,0,0,127,340,California
Lake,2020-12-24,2,342,0,328,2,14,0,0,2,342,0,0,2,342,California
Lake,2020-12-26,2,344,2,330,0,14,0,0,2,344,0,0,2,344,California
Lake,2020-12-27,2,346,2,332,0,14,0,0,2,346,0,0,2,346,California
Lake,2020-12-28,52,398,43,375,9,23,0,0,52,398,0,0,52,398,California
Lake,2020-12-29,53,451,48,423,5,28,0,0,53,451,0,0,53,451,California
Lake,2020-12-30,135,586,127,550,8,36,0,0,135,586,0,0,135,586,California
Lake,2020-12-31,67,653,64,614,3,39,0,0,67,653,0,0,67,653,California
Lake,2021-01-01,6,659,1,615,5,44,0,0,6,659,0,0,6,659,California
Lake,2021-01-02,2,661,1,616,1,45,0,0,2,661,0,0,2,661,California
Lake,2021-01-04,92,753,22,638,70,115,0,0,92,753,0,0,92,753,California
Lake,2021-01-05,120,873,59,697,61,176,0,0,118,869,2,2,118,871,California
Lake,2021-01-06,103,976,64,761,39,215,0,0,101,968,2,4,101,972,California
Lake,2021-01-07,110,1086,86,847,24,239,0,0,101,1060,9,13,101,1073,California
Lake,2021-01-08,155,1241,126,973,29,268,0,0,104,1113,51,64,104,1177,California
Lake,2021-01-09,64,1305,62,1035,2,270,0,0,60,1169,4,68,60,1237,California
Lake,2021-01-10,3,1308,3,1038,0,270,0,0,0,1166,3,71,0,1237,California
Lake,2021-01-11,187,1495,149,1187,38,308,0,0,108,1195,79,150,108,1345,California
Lake,2021-01-12,82,1577,49,1236,33,341,0,0,59,1231,23,173,59,1404,California
Lake,2021-01-13,177,1754,120,1356,57,398,0,0,113,1280,64,237,113,1517,California
Lake,2021-01-14,149,1903,48,1404,101,499,0,0,127,1385,22,259,127,1644,California
Lake,2021-01-15,220,2123,96,1500,124,623,0,0,191,1547,29,288,191,1835,California
Lake,2021-01-16,134,2257,84,1584,50,673,0,0,132,1677,2,290,132,1967,California
Lake,2021-01-17,13,2270,6,1590,7,680,0,0,7,1678,6,296,7,1974,California
Lake,2021-01-18,245,2515,229,1819,16,696,0,0,122,1677,123,419,122,2096,California
Lake,2021-01-19,321,2836,125,1944,196,892,0,0,272,1901,49,468,273,2369,California
Lake,2021-01-20,426,3262,82,2026,344,1236,0,0,361,2198,64,532,361,2730,California
Lake,2021-01-21,438,3700,46,2072,392,1628,0,0,402,2564,36,568,402,3132,California
Lake,2021-01-22,320,4020,49,2121,271,1899,0,0,282,2808,38,606,282,3414,California
Lake,2021-01-23,124,4144,6,2127,118,2017,0,0,123,2930,1,607,123,3537,California
Lake,2021-01-24,5,4149,2,2129,3,2020,0,0,5,2935,0,607,5,3542,California
Lake,2021-01-25,257,4406,94,2223,163,2183,0,0,174,3026,83,690,174,3716,California
Lake,2021-01-26,427,4833,32,2255,395,2578,0,0,403,3405,24,714,403,4119,California
Lake,2021-01-27,365,5198,39,2294,326,2904,0,0,337,3715,28,742,338,4457,California
Lake,2021-01-28,497,5695,161,2455,336,3240,0,0,363,3946,132,874,363,4820,California
Lake,2021-01-29,651,6346,99,2554,552,3792,0,0,576,4447,75,949,576,5396,California
Lake,2021-01-30,556,6902,40,2594,516,4308,0,0,550,4991,6,955,550,5946,California
Lake,2021-01-31,13,6915,8,2602,5,4313,0,0,11,5000,2,957,11,5957,California
Lake,2021-02-01,176,7091,16,2618,160,4473,0,0,161,5146,15,972,161,6118,California
Lake,2021-02-02,567,7658,156,2774,411,4884,0,0,399,5377,168,1140,399,6517,California
Lake,2021-02-03,446,8104,33,2807,413,5297,0,0,340,5611,106,1246,340,6857,California
Lake,2021-02-04,123,8227,71,2878,52,5349,0,0,71,5630,52,1298,71,6928,California
Lake,2021-02-05,385,8612,72,2950,313,5662,0,0,290,5827,93,1391,290,7218,California
Lake,2021-02-06,278,8890,38,2988,240,5902,0,0,266,6081,12,1403,266,7484,California
Lake,2021-02-07,3,8893,2,2990,1,5903,0,0,3,6084,0,1403,3,7487,California
Lake,2021-02-08,274,9167,206,3196,68,5971,0,0,155,6120,119,1522,155,7642,California
Lake,2021-02-09,348,9515,25,3221,323,6294,0,0,300,6373,47,1569,300,7942,California
Lake,2021-02-10,354,9869,50,3271,304,6598,0,0,273,6565,81,1650,273,8215,California
Lake,2021-02-11,179,10048,17,3288,162,6760,0,0,58,6502,121,1771,58,8273,California
Lake,2021-02-12,372,10420,28,3316,344,7104,0,0,286,6703,85,1856,286,8559,California
Lake,2021-02-13,253,10673,9,3325,244,7348,0,0,243,6936,10,1866,243,8802,California
Lake,2021-02-14,16,10689,4,3329,12,7360,0,0,7,6934,9,1875,7,8809,California
Lake,2021-02-15,166,10855,8,3337,158,7518,0,0,8,6785,157,2032,8,8817,California
Lake,2021-02-16,424,11279,20,3357,404,7922,0,0,175,6711,249,2281,175,8992,California
Lake,2021-02-17,354,11633,54,3411,300,8222,0,0,73,6504,280,2561,73,9065,California
Lake,2021-02-18,464,12097,72,3483,392,8614,0,0,117,6275,346,2907,117,9182,California
Lake,2021-02-19,430,12527,25,3508,405,9019,0,0,92,6030,337,3244,92,9274,California
Lake,2021-02-20,296,12823,59,3567,237,9256,0,0,251,6237,44,3288,251,9525,California
Lake,2021-02-21,7,12830,7,3574,0,9256,0,0,1,6232,6,3294,1,9526,California
Lake,2021-02-22,136,12966,16,3590,120,9376,0,0,39,6175,96,3390,39,9565,California
Lake,2021-02-23,228,13194,18,3608,210,9586,0,0,30,6008,197,3587,30,9595,California
Lake,2021-02-24,1028,14222,434,4042,594,10180,0,0,470,5920,558,4145,470,10065,California
Lake,2021-02-25,787,15009,505,4547,282,10462,0,0,510,6156,274,4419,510,10575,California
Lake,2021-02-26,1063,16072,320,4867,743,11205,0,0,362,5820,698,5117,362,10937,California
Lake,2021-02-27,413,16485,101,4968,312,11517,0,0,327,6062,85,5202,327,11264,California
Lake,2021-02-28,16,16501,8,4976,8,11525,0,0,11,6068,5,5207,11,11275,California
Lake,2021-03-01,619,17120,56,5032,563,12088,0,0,457,6363,162,5369,457,11732,California
Lake,2021-03-02,777,17897,18,5050,759,12847,0,0,291,6170,484,5853,291,12023,California
Lake,2021-03-03,379,18276,201,5251,178,13025,0,0,148,6088,230,6083,148,12171,California
Lake,2021-03-04,583,18859,508,5759,75,13100,0,0,566,6637,17,6100,566,12737,California
Lake,2021-03-05,1062,19921,53,5812,1009,14109,0,0,182,5943,876,6976,182,12919,California
Lake,2021-03-06,33,19954,9,5821,23,14132,1,1,20,5951,13,6989,21,12940,California
Lake,2021-03-07,8,19962,5,5826,2,14134,1,2,5,5954,3,6992,6,12946,California
Lake,2021-03-08,342,20304,268,6094,64,14198,10,12,301,6225,40,7032,311,13257,California
Lake,2021-03-09,929,21233,41,6135,870,15068,18,30,402,6123,523,7555,421,13678,California
Lake,2021-03-10,199,21432,55,6190,131,15199,13,43,132,6202,67,7622,146,13824,California
Lake,2021-03-11,590,22022,47,6237,67,15266,476,519,51,6187,539,8161,524,14348,California
Lake,2021-03-12,854,22876,202,6439,626,15892,26,545,362,6085,490,8651,388,14736,California
Lake,2021-03-13,277,23153,20,6459,21,15913,236,781,15,6074,261,8912,250,14986,California
Lake,2021-03-14,10,23163,2,6461,8,15921,0,781,6,6076,4,8916,6,14992,California
Lake,2021-03-15,640,23803,10,6471,612,16533,18,799,480,6414,160,9076,498,15490,California
Lake,2021-03-16,1122,24925,841,7312,264,16797,17,816,377,6066,741,9817,393,15883,California
Lake,2021-03-17,249,25174,124,7436,102,16899,23,839,87,6014,162,9979,110,15993,California
Lake,2021-03-18,751,25925,375,7811,340,17239,36,875,353,6012,390,10369,388,16381,California
Lake,2021-03-19,583,26508,311,8122,251,17490,21,896,480,6411,102,10471,501,16882,California
Lake,2021-03-20,248,26756,7,8129,238,17728,3,899,30,6228,216,10687,33,16915,California
Lake,2021-03-21,15,26771,9,8138,5,17733,1,900,11,6236,4,10691,12,16927,California
Lake,2021-03-22,336,27107,257,8395,65,17798,14,914,249,6412,87,10778,263,17190,California
Lake,2021-03-23,433,27540,19,8414,400,18198,14,928,366,6726,66,10844,380,17570,California
Lake,2021-03-24,420,27960,58,8472,354,18552,8,936,324,6965,94,10938,333,17903,California
Lake,2021-03-25,680,28640,491,8963,183,18735,6,942,165,6621,514,11452,170,18073,California
Lake,2021-03-26,67,28707,33,8996,32,18767,2,944,30,6617,36,11488,32,18105,California
Lake,2021-03-27,309,29016,7,9003,299,19066,3,947,16,6345,291,11779,19,18124,California
Lake,2021-03-28,14,29030,7,9010,7,19073,0,947,6,6343,8,11787,6,18130,California
Lake,2021-03-29,1014,30044,299,9309,713,19786,2,949,192,5717,820,12607,194,18324,California
Lake,2021-03-30,468,30512,317,9626,148,19934,3,952,369,5991,98,12705,372,18696,California
Lake,2021-03-31,623,31135,60,9686,563,20497,0,952,437,6252,176,12881,437,19133,California
Lake,2021-04-01,455,31590,240,9926,203,20700,12,964,183,6179,268,13149,195,19328,California
Lake,2021-04-02,223,31813,38,9964,157,20857,28,992,94,6172,129,13278,122,19450,California
Lake,2021-04-03,31,31844,4,9968,24,20881,3,995,12,6168,19,13297,15,19465,California
Lake,2021-04-04,20,31864,12,9980,7,20888,1,996,15,6179,5,13302,16,19481,California
Lake,2021-04-05,650,32514,72,10052,558,21446,20,1016,409,6369,238,13540,428,19909,California
Lake,2021-04-06,478,32992,19,10071,434,21880,25,1041,305,6528,171,13711,330,20239,California
Lake,2021-04-07,528,33520,57,10128,418,22298,53,1094,355,6765,171,13882,408,20647,California
Lake,2021-04-08,612,34132,497,10625,49,22347,66,1160,108,6438,501,14383,174,20821,California
Lake,2021-04-09,286,34418,46,10671,172,22519,68,1228,53,6329,229,14612,120,20941,California
Lake,2021-04-10,251,34669,12,10683,13,22532,226,1454,9,6322,242,14854,235,21176,California
Lake,2021-04-11,20,34689,15,10698,3,22535,2,1456,6,6316,14,14868,8,21184,California
Lake,2021-04-12,1083,35772,234,10932,816,23351,33,1489,245,5756,838,15706,278,21462,California
Lake,2021-04-13,177,35949,106,11038,71,23422,0,1489,52,5683,125,15831,52,21514,California
Lake,2021-04-14,616,36565,34,11072,582,24004,0,1489,554,6175,62,15893,554,22068,California
Lake,2021-04-15,644,37209,191,11263,453,24457,0,1489,329,6189,315,16208,329,22397,California
Lake,2021-04-16,268,37477,26,11289,242,24699,0,1489,71,6064,196,16404,71,22468,California
Lake,2021-04-17,40,37517,9,11298,31,24730,0,1489,29,6082,11,16415,29,22497,California
Lake,2021-04-18,8,37525,5,11303,3,24733,0,1489,0,6074,8,16423,0,22497,California
Lake,2021-04-19,300,37825,40,11343,260,24993,0,1489,250,6274,50,16473,250,22747,California
Lake,2021-04-20,701,38526,284,11627,417,25410,0,1489,91,5757,609,17082,92,22839,California
Lake,2021-04-21,534,39060,63,11690,471,25881,0,1489,197,5617,337,17419,197,23036,California
Lake,2021-04-22,464,39524,46,11736,418,26299,0,1489,320,5794,143,17562,320,23356,California
Lake,2021-04-23,122,39646,61,11797,61,26360,0,1489,73,5820,47,17609,73,23429,California
Lake,2021-04-24,53,39699,8,11805,45,26405,0,1489,39,5845,14,17623,39,23468,California
Lake,2021-04-25,37,39736,19,11824,18,26423,0,1489,25,5858,12,17635,25,23493,California
Lake,2021-04-26,296,40032,83,11907,212,26635,1,1490,92,5747,204,17839,93,23586,California
Lake,2021-04-27,249,40281,25,11932,206,26841,18,1508,86,5688,163,18002,104,23690,California
Lake,2021-04-28,521,40802,51,11983,455,27296,15,1523,94,5371,425,18427,108,23798,California
Lake,2021-04-29,218,41020,86,12069,116,27412,16,1539,115,5399,102,18529,130,23928,California
Lake,2021-04-30,291,41311,46,12115,214,27626,31,1570,144,5428,146,18675,175,24103,California
Lake,2021-05-01,51,41362,27,12142,22,27648,2,1572,33,5446,17,18692,35,24138,California
Lake,2021-05-02,18,41380,9,12151,8,27656,1,1573,10,5449,8,18700,11,24149,California
Lake,2021-05-03,421,41801,29,12180,356,28012,36,1609,66,5197,354,19054,102,24251,California
Lake,2021-05-04,408,42209,218,12398,140,28152,50,1659,125,5091,281,19335,175,24426,California
Lake,2021-05-05,631,42840,40,12438,580,28732,11,1670,84,4641,544,19879,94,24520,California
Lake,2021-05-06,142,42982,19,12457,94,28826,29,1699,72,4671,70,19949,100,24620,California
Lake,2021-05-07,162,43144,25,12482,117,28943,20,1719,104,4739,56,20005,124,24744,California
Lake,2021-05-08,41,43185,4,12486,37,28980,0,1719,36,4770,5,20010,36,24780,California
Lake,2021-05-09,17,43202,2,12488,10,28990,5,1724,10,4778,7,20017,15,24795,California
Lake,2021-05-10,246,43448,11,12499,209,29199,26,1750,60,4679,185,20202,86,24881,California
Lake,2021-05-11,199,43647,26,12525,156,29355,17,1767,119,4736,80,20282,137,25018,California
Lake,2021-05-12,544,44191,29,12554,495,29850,20,1787,54,4319,490,20772,73,25091,California
Lake,2021-05-13,318,44509,70,12624,234,30084,14,1801,73,4164,243,21015,88,25179,California
Lake,2021-05-14,269,44778,82,12706,169,30253,18,1819,163,4240,104,21119,180,25359,California
Lake,2021-05-15,45,44823,19,12725,23,30276,3,1822,29,4256,16,21135,32,25391,California
Lake,2021-05-16,32,44855,19,12744,12,30288,1,1823,18,4261,14,21149,19,25410,California
Lake,2021-05-17,315,45170,42,12786,258,30546,15,1838,83,4130,229,21378,98,25508,California
Lake,2021-05-18,297,45467,65,12851,213,30759,19,1857,171,4195,125,21503,190,25698,California
Lake,2021-05-19,314,45781,58,12909,241,31000,15,1872,88,4073,225,21728,103,25801,California
Lake,2021-05-20,240,46021,60,12969,169,31169,11,1883,94,4032,146,21874,105,25906,California
Lake,2021-05-21,274,46295,51,13020,200,31369,23,1906,112,4007,160,22034,135,26041,California
Lake,2021-05-22,97,46392,54,13074,40,31409,3,1909,48,4009,49,22083,51,26092,California
Lake,2021-05-23,58,46450,28,13102,29,31438,1,1910,29,4010,29,22112,30,26122,California
Lake,2021-05-24,159,46609,36,13138,109,31547,14,1924,72,4009,87,22199,86,26208,California
Lake,2021-05-25,203,46812,56,13194,135,31682,12,1936,73,3965,129,22328,85,26293,California
Lake,2021-05-26,151,46963,45,13239,95,31777,11,1947,56,3939,93,22421,67,26360,California
Lake,2021-05-27,176,47139,47,13286,115,31892,14,1961,61,3900,114,22535,75,26435,California
Lake,2021-05-28,224,47363,22,13308,164,32056,38,1999,50,3815,172,22707,87,26522,California
Lake,2021-05-29,37,47400,10,13318,21,32077,6,2005,14,3812,23,22730,20,26542,California
Lake,2021-05-30,22,47422,6,13324,14,32091,2,2007,12,3816,10,22740,14,26556,California
Lake,2021-05-31,64,47486,22,13346,40,32131,2,2009,54,3862,10,22750,56,26612,California
Lake,2021-06-01,195,47681,36,13382,150,32281,9,2018,68,3813,126,22876,77,26689,California
Lake,2021-06-02,133,47814,46,13428,75,32356,12,2030,54,3800,79,22955,66,26755,California
Lake,2021-06-03,182,47996,54,13482,109,32465,19,2049,79,3795,103,23058,98,26853,California
Lake,2021-06-04,183,48179,54,13536,113,32578,16,2065,46,3722,135,23193,62,26915,California
Lake,2021-06-05,94,48273,56,13592,30,32608,8,2073,55,3746,39,23232,63,26978,California
Lake,2021-06-06,69,48342,39,13631,30,32638,0,2073,24,3725,45,23277,24,27002,California
Lake,2021-06-07,90,48432,29,13660,53,32691,8,2081,32,3708,57,23334,40,27042,California
Lake,2021-06-08,180,48612,69,13729,99,32790,12,2093,67,3674,113,23447,79,27121,California
Lake,2021-06-09,173,48785,42,13771,127,32917,4,2097,37,3581,134,23581,41,27162,California
Lake,2021-06-10,126,48911,61,13832,52,32969,13,2110,49,3566,77,23658,62,27224,California
Lake,2021-06-11,210,49121,66,13898,120,33089,24,2134,48,3479,159,23817,72,27296,California
Lake,2021-06-12,66,49187,39,13937,21,33110,6,2140,34,3487,32,23849,40,27336,California
Lake,2021-06-13,27,49214,14,13951,13,33123,0,2140,12,3484,15,23864,12,27348,California
Lake,2021-06-14,177,49391,85,14036,79,33202,13,2153,49,3419,127,23991,62,27410,California
Lake,2021-06-15,246,49637,65,14101,163,33365,18,2171,78,3347,168,24159,96,27506,California
Lake,2021-06-16,163,49800,57,14158,91,33456,15,2186,54,3308,108,24267,69,27575,California
Lake,2021-06-17,181,49981,87,14245,84,33540,10,2196,80,3298,100,24367,90,27665,California
Lake,2021-06-18,143,50124,39,14284,94,33634,10,2206,58,3281,85,24452,68,27733,California
Lake,2021-06-19,68,50192,26,14310,42,33676,0,2206,35,3283,33,24485,35,27768,California
Lake,2021-06-20,21,50213,7,14317,12,33688,2,2208,10,3284,11,24496,12,27780,California
Lake,2021-06-21,69,50282,17,14334,44,33732,8,2216,30,3283,39,24535,38,27818,California
Lake,2021-06-22,133,50415,50,14384,73,33805,10,2226,61,3283,71,24606,71,27889,California
Lake,2021-06-23,149,50564,68,14452,57,33862,24,2250,81,3320,68,24674,105,27994,California
Lake,2021-06-24,140,50704,93,14545,34,33896,13,2263,49,3292,90,24764,62,28056,California
Lake,2021-06-25,130,50834,56,14601,64,33960,10,2273,65,3303,64,24828,75,28131,California
Lake,2021-06-26,48,50882,37,14638,11,33971,0,2273,6,3267,42,24870,6,28137,California
Lake,2021-06-27,42,50924,30,14668,12,33983,0,2273,23,3271,19,24889,23,28160,California
Lake,2021-06-28,66,50990,22,14690,22,34005,22,2295,28,3284,37,24926,50,28210,California
Lake,2021-06-29,122,51112,47,14737,71,34076,4,2299,65,3296,57,24983,69,28279,California
Lake,2021-06-30,122,51234,60,14797,53,34129,9,2308,60,3303,62,25045,69,28348,California
Lake,2021-07-01,118,51352,53,14850,58,34187,7,2315,40,3276,74,25119,47,28395,California
Lake,2021-07-02,111,51463,34,14884,64,34251,13,2328,54,3287,55,25174,66,28461,California
Lake,2021-07-03,74,51537,43,14927,31,34282,0,2328,34,3283,38,25212,34,28495,California
Lake,2021-07-04,14,51551,5,14932,9,34291,0,2328,9,3287,5,25217,9,28504,California
Lake,2021-07-05,46,51597,18,14950,28,34319,0,2328,32,3305,14,25231,32,28536,California
Lake,2021-07-06,157,51754,52,15002,98,34417,7,2335,61,3280,93,25324,68,28604,California
Lake,2021-07-07,92,51846,51,15053,38,34455,3,2338,55,3301,37,25361,58,28662,California
Lake,2021-07-08,93,51939,33,15086,49,34504,11,2349,41,3301,52,25413,52,28714,California
Lake,2021-07-09,155,52094,84,15170,64,34568,7,2356,65,3284,89,25502,72,28786,California
Lake,2021-07-10,41,52135,15,15185,26,34594,0,2356,24,3291,17,25519,24,28810,California
Lake,2021-07-11,15,52150,3,15188,11,34605,1,2357,6,3289,9,25528,7,28817,California
Lake,2021-07-12,88,52238,44,15232,35,34640,9,2366,41,3293,46,25574,50,28867,California
Lake,2021-07-13,121,52359,50,15282,69,34709,2,2368,51,3276,70,25644,53,28920,California
Lake,2021-07-14,136,52495,79,15361,32,34741,25,2393,51,3268,84,25728,76,28996,California
Lake,2021-07-15,109,52604,61,15422,40,34781,8,2401,50,3269,57,25785,58,29054,California
Lake,2021-07-16,149,52753,63,15485,77,34858,9,2410,79,3287,70,25855,88,29142,California
Lake,2021-07-17,74,52827,26,15511,41,34899,7,2417,39,3297,35,25890,45,29187,California
Lake,2021-07-18,20,52847,9,15520,11,34910,0,2417,9,3295,11,25901,9,29196,California
Lake,2021-07-19,85,52932,36,15556,37,34947,12,2429,41,3304,44,25945,53,29249,California
Lake,2021-07-20,109,53041,50,15606,50,34997,9,2438,52,3308,57,26002,61,29310,California
Lake,2021-07-21,173,53214,112,15718,52,35049,9,2447,109,3363,63,26065,118,29428,California
Lake,2021-07-22,148,53362,69,15787,64,35113,15,2462,92,3415,55,26120,107,29535,California
Lake,2021-07-23,173,53535,83,15870,74,35187,16,2478,99,3456,74,26194,115,29650,California
Lake,2021-07-24,94,53629,49,15919,41,35228,4,2482,68,3503,25,26219,72,29722,California
Lake,2021-07-25,40,53669,21,15940,19,35247,0,2482,27,3519,11,26230,27,29749,California
Lake,2021-07-26,102,53771,33,15973,52,35299,17,2499,52,3539,49,26279,69,29818,California
Lake,2021-07-27,173,53944,54,16027,103,35402,16,2515,98,3578,75,26354,114,29932,California
Lake,2021-07-28,135,54079,79,16106,52,35454,4,2519,92,3631,43,26397,96,30028,California
Lake,2021-07-29,154,54233,71,16177,72,35526,11,2530,102,3692,52,26449,113,30141,California
Lake,2021-07-30,182,54415,63,16240,100,35626,19,2549,114,3757,68,26517,133,30274,California
Lake,2021-07-31,28,54443,13,16253,13,35639,2,2551,18,3767,10,26527,20,30294,California
Lassen,2020-12-16,3,3,3,3,0,0,0,0,3,3,0,0,3,3,California
Lassen,2020-12-17,1,4,1,4,0,0,0,0,1,4,0,0,1,4,California
Lassen,2020-12-18,1,5,1,5,0,0,0,0,1,5,0,0,1,5,California
Lassen,2020-12-19,6,11,6,11,0,0,0,0,6,11,0,0,6,11,California
Lassen,2020-12-20,2,13,2,13,0,0,0,0,2,13,0,0,2,13,California
Lassen,2020-12-21,10,23,10,23,0,0,0,0,10,23,0,0,10,23,California
Lassen,2020-12-22,18,41,18,41,0,0,0,0,18,41,0,0,18,41,California
Lassen,2020-12-23,4,45,4,45,0,0,0,0,4,45,0,0,4,45,California
Lassen,2020-12-24,3,48,3,48,0,0,0,0,3,48,0,0,3,48,California
Lassen,2020-12-28,2,50,1,49,1,1,0,0,2,50,0,0,2,50,California
Lassen,2020-12-29,34,84,34,83,0,1,0,0,34,84,0,0,34,84,California
Lassen,2020-12-30,25,109,24,107,1,2,0,0,25,109,0,0,25,109,California
Lassen,2020-12-31,50,159,42,149,8,10,0,0,50,159,0,0,50,159,California
Lassen,2021-01-02,1,160,0,149,1,11,0,0,1,160,0,0,1,160,California
Lassen,2021-01-04,14,174,2,151,12,23,0,0,14,174,0,0,14,174,California
Lassen,2021-01-05,190,364,52,203,138,161,0,0,190,364,0,0,190,364,California
Lassen,2021-01-06,88,452,35,238,53,214,0,0,84,445,4,4,85,449,California
Lassen,2021-01-07,38,490,2,240,36,250,0,0,37,481,1,5,37,486,California
Lassen,2021-01-08,50,540,2,242,48,298,0,0,50,531,0,5,50,536,California
Lassen,2021-01-09,12,552,6,248,6,304,0,0,12,543,0,5,12,548,California
Lassen,2021-01-11,25,577,5,253,20,324,0,0,25,568,0,5,25,573,California
Lassen,2021-01-12,45,622,25,278,20,344,0,0,29,581,16,21,29,602,California
Lassen,2021-01-13,155,777,14,292,141,485,0,0,144,714,11,32,144,746,California
Lassen,2021-01-14,151,928,11,303,140,625,0,0,146,855,5,37,146,892,California
Lassen,2021-01-15,18,946,1,304,17,642,0,0,18,873,0,37,18,910,California
Lassen,2021-01-16,34,980,33,337,1,643,0,0,34,907,0,37,34,944,California
Lassen,2021-01-17,1,981,0,337,1,644,0,0,1,908,0,37,1,945,California
Lassen,2021-01-18,3,984,2,339,1,645,0,0,2,909,1,38,2,947,California
Lassen,2021-01-19,181,1165,33,372,148,793,0,0,154,1036,27,65,154,1101,California
Lassen,2021-01-20,149,1314,87,459,62,855,0,0,77,1056,57,122,77,1178,California
Lassen,2021-01-21,129,1443,86,545,43,898,0,0,105,1143,18,140,105,1283,California
Lassen,2021-01-22,28,1471,15,560,13,911,0,0,18,1151,10,150,18,1301,California
Lassen,2021-01-24,1,1472,0,560,1,912,0,0,1,1152,0,150,1,1302,California
Lassen,2021-01-25,10,1482,1,561,9,921,0,0,9,1160,1,151,9,1311,California
Lassen,2021-01-26,107,1589,3,564,104,1025,0,0,104,1261,3,154,104,1415,California
Lassen,2021-01-27,53,1642,13,577,40,1065,0,0,38,1284,15,169,38,1453,California
Lassen,2021-01-28,72,1714,6,583,66,1131,0,0,71,1354,1,170,71,1524,California
Lassen,2021-01-29,14,1728,5,588,9,1140,0,0,12,1364,2,172,12,1536,California
Lassen,2021-02-01,46,1774,3,591,43,1183,0,0,23,1364,23,195,23,1559,California
Lassen,2021-02-02,165,1939,6,597,159,1342,0,0,34,1267,131,326,34,1593,California
Lassen,2021-02-03,89,2028,15,612,74,1416,0,0,42,1262,47,373,42,1635,California
Lassen,2021-02-04,102,2130,9,621,93,1509,0,0,53,1266,49,422,53,1688,California
Lassen,2021-02-05,48,2178,3,624,45,1554,0,0,12,1242,36,458,12,1700,California
Lassen,2021-02-06,68,2246,33,657,35,1589,0,0,35,1245,32,490,35,1735,California
Lassen,2021-02-07,1,2247,1,658,0,1589,0,0,1,1246,0,490,1,1736,California
Lassen,2021-02-08,37,2284,3,661,34,1623,0,0,12,1233,25,515,12,1748,California
Lassen,2021-02-09,116,2400,2,663,114,1737,0,0,42,1201,74,589,42,1790,California
Lassen,2021-02-10,146,2546,11,674,135,1872,0,0,42,1139,104,693,42,1832,California
Lassen,2021-02-11,149,2695,7,681,142,2014,0,0,55,1101,93,786,55,1887,California
Lassen,2021-02-12,26,2721,6,687,20,2034,0,0,11,1097,15,801,11,1898,California
Lassen,2021-02-13,8,2729,1,688,7,2041,0,0,6,1101,2,803,6,1904,California
Lassen,2021-02-14,13,2742,0,688,13,2054,0,0,12,1112,1,804,12,1916,California
Lassen,2021-02-15,19,2761,2,690,17,2071,0,0,16,1126,2,806,16,1932,California
Lassen,2021-02-16,182,2943,3,693,179,2250,0,0,21,988,159,965,21,1953,California
Lassen,2021-02-17,135,3078,72,765,63,2313,0,0,6,865,129,1094,6,1959,California
Lassen,2021-02-18,58,3136,8,773,50,2363,0,0,14,835,44,1138,14,1973,California
Lassen,2021-02-19,67,3203,52,825,15,2378,0,0,12,792,55,1193,12,1985,California
Lassen,2021-02-20,8,3211,1,826,7,2385,0,0,7,798,1,1194,7,1992,California
Lassen,2021-02-21,20,3231,0,826,20,2405,0,0,17,812,3,1197,17,2009,California
Lassen,2021-02-22,24,3255,13,839,11,2416,0,0,8,804,16,1213,8,2017,California
Lassen,2021-02-23,143,3398,6,845,137,2553,0,0,43,747,100,1313,43,2060,California
Lassen,2021-02-24,128,3526,8,853,120,2673,0,0,85,790,42,1355,85,2145,California
Lassen,2021-02-25,136,3662,14,867,122,2795,0,0,85,824,51,1406,85,2230,California
Lassen,2021-02-26,61,3723,11,878,50,2845,0,0,33,829,28,1434,33,2263,California
Lassen,2021-02-27,7,3730,7,885,0,2845,0,0,3,828,4,1438,3,2266,California
Lassen,2021-02-28,4,3734,1,886,3,2848,0,0,1,826,3,1441,1,2267,California
Lassen,2021-03-01,26,3760,1,887,25,2873,0,0,8,817,17,1458,8,2275,California
Lassen,2021-03-02,103,3863,6,893,97,2970,0,0,80,875,22,1480,80,2355,California
Lassen,2021-03-03,130,3993,7,900,123,3093,0,0,81,907,49,1529,81,2436,California
Lassen,2021-03-04,144,4137,13,913,131,3224,0,0,94,952,49,1578,94,2530,California
Lassen,2021-03-05,38,4175,1,914,13,3237,24,24,6,950,32,1610,30,2560,California
Lassen,2021-03-06,53,4228,2,916,29,3266,22,46,5,929,48,1658,27,2587,California
Lassen,2021-03-07,56,4284,0,916,1,3267,55,101,1,930,55,1713,56,2643,California
Lassen,2021-03-08,84,4368,2,918,4,3271,78,179,1,926,83,1796,79,2722,California
Lassen,2021-03-09,127,4495,4,922,106,3377,17,196,82,980,45,1841,99,2821,California
Lassen,2021-03-10,119,4614,4,926,114,3491,1,197,72,1007,46,1887,73,2894,California
Lassen,2021-03-11,160,4774,8,934,146,3637,6,203,93,1042,64,1951,99,2993,California
Lassen,2021-03-12,16,4790,7,941,6,3643,3,206,3,1035,13,1964,6,2999,California
Lassen,2021-03-13,48,4838,0,941,2,3645,46,252,1,1034,47,2011,46,3045,California
Lassen,2021-03-14,11,4849,0,941,10,3655,1,253,0,1024,11,2022,1,3046,California
Lassen,2021-03-15,29,4878,4,945,24,3679,1,254,11,1018,18,2040,12,3058,California
Lassen,2021-03-16,87,4965,2,947,81,3760,4,258,71,1077,16,2056,75,3133,California
Lassen,2021-03-17,1076,6041,8,955,1064,4824,4,262,1057,2119,19,2075,1061,4194,California
Lassen,2021-03-18,83,6124,8,963,74,4898,1,263,75,2187,8,2083,76,4270,California
Lassen,2021-03-19,9,6133,3,966,4,4902,2,265,2,2184,7,2090,4,4274,California
Lassen,2021-03-20,15,6148,3,969,10,4912,2,267,9,2189,6,2096,11,4285,California
Lassen,2021-03-21,34,6182,1,970,33,4945,0,267,14,2184,19,2115,14,4299,California
Lassen,2021-03-22,37,6219,1,971,36,4981,0,267,34,2215,3,2118,34,4333,California
Lassen,2021-03-23,109,6328,5,976,103,5084,1,268,57,2221,52,2170,58,4391,California
Lassen,2021-03-24,164,6492,4,980,159,5243,1,269,83,2226,79,2249,84,4475,California
Lassen,2021-03-25,139,6631,13,993,126,5369,0,269,60,2207,79,2328,60,4535,California
Lassen,2021-03-26,67,6698,5,998,26,5395,36,305,14,2204,52,2380,49,4584,California
Lassen,2021-03-27,18,6716,2,1000,1,5396,15,320,2,2205,16,2396,17,4601,California
Lassen,2021-03-28,13,6729,1,1001,1,5397,11,331,1,2205,12,2408,12,4613,California
Lassen,2021-03-29,53,6782,0,1001,28,5425,25,356,20,2218,32,2440,45,4658,California
Lassen,2021-03-30,160,6942,3,1004,133,5558,24,380,49,2180,111,2551,73,4731,California
Lassen,2021-03-31,133,7075,6,1010,107,5665,20,400,52,2172,80,2631,72,4803,California
Lassen,2021-04-01,148,7223,6,1016,123,5788,19,419,40,2124,107,2738,59,4862,California
Lassen,2021-04-02,25,7248,3,1019,2,5790,20,439,1,2121,24,2762,21,4883,California
Lassen,2021-04-03,12,7260,0,1019,2,5792,10,449,0,2119,12,2774,10,4893,California
Lassen,2021-04-04,5,7265,1,1020,0,5792,4,453,1,2120,4,2778,5,4898,California
Lassen,2021-04-05,15,7280,0,1020,9,5801,6,459,8,2127,7,2785,14,4912,California
Lassen,2021-04-06,161,7441,5,1025,127,5928,29,488,47,2089,114,2899,76,4988,California
Lassen,2021-04-07,119,7560,5,1030,86,6014,28,516,32,2064,87,2986,62,5050,California
Lassen,2021-04-08,155,7715,9,1039,97,6111,49,565,25,2013,125,3111,74,5124,California
Lassen,2021-04-09,41,7756,4,1043,4,6115,33,598,7,2019,33,3144,39,5163,California
Lassen,2021-04-10,8,7764,0,1043,2,6117,6,604,0,2018,7,3151,6,5169,California
Lassen,2021-04-11,4,7768,0,1043,1,6118,3,607,1,2019,3,3154,4,5173,California
Lassen,2021-04-12,29,7797,4,1047,12,6130,13,620,4,2011,25,3179,17,5190,California
Lassen,2021-04-13,113,7910,3,1050,110,6240,0,620,23,1945,89,3268,23,5213,California
Lassen,2021-04-14,971,8881,4,1054,967,7207,0,620,47,1071,921,4189,47,5260,California
Lassen,2021-04-15,132,9013,9,1063,123,7330,0,620,13,965,119,4308,13,5273,California
Lassen,2021-04-16,10,9023,2,1065,8,7338,0,620,5,965,5,4313,5,5278,California
Lassen,2021-04-17,10,9033,3,1068,7,7345,0,620,3,961,7,4320,3,5281,California
Lassen,2021-04-18,4,9037,1,1069,3,7348,0,620,1,959,3,4323,1,5282,California
Lassen,2021-04-19,31,9068,0,1069,31,7379,0,620,16,960,15,4338,16,5298,California
Lassen,2021-04-20,123,9191,5,1074,118,7497,0,620,43,923,80,4418,43,5341,California
Lassen,2021-04-21,128,9319,3,1077,124,7621,1,621,31,860,95,4513,32,5373,California
Lassen,2021-04-22,93,9412,12,1089,81,7702,0,621,25,817,68,4581,25,5398,California
Lassen,2021-04-23,23,9435,0,1089,23,7725,0,621,20,834,3,4584,20,5418,California
Lassen,2021-04-24,9,9444,5,1094,4,7729,0,621,3,831,6,4590,3,5421,California
Lassen,2021-04-25,5,9449,0,1094,4,7733,1,622,3,833,2,4592,4,5425,California
Lassen,2021-04-26,44,9493,1,1095,38,7771,5,627,10,815,33,4625,15,5440,California
Lassen,2021-04-27,103,9596,4,1099,96,7867,3,630,52,819,51,4676,55,5495,California
Lassen,2021-04-28,78,9674,6,1105,70,7937,2,632,27,797,51,4727,29,5524,California
Lassen,2021-04-29,58,9732,5,1110,50,7987,3,635,21,785,36,4763,24,5548,California
Lassen,2021-04-30,14,9746,7,1117,4,7991,3,638,5,784,9,4772,8,5556,California
Lassen,2021-05-01,5,9751,0,1117,4,7995,1,639,4,788,1,4773,5,5561,California
Lassen,2021-05-02,6,9757,2,1119,4,7999,0,639,4,790,2,4775,4,5565,California
Lassen,2021-05-03,16,9773,3,1122,8,8007,5,644,3,785,13,4788,8,5573,California
Lassen,2021-05-04,67,9840,2,1124,59,8066,6,650,20,764,47,4835,26,5599,California
Lassen,2021-05-05,76,9916,3,1127,61,8127,12,662,23,747,52,4887,35,5634,California
Lassen,2021-05-06,67,9983,17,1144,27,8154,23,685,18,739,49,4936,41,5675,California
Lassen,2021-05-07,49,10032,32,1176,11,8165,6,691,41,778,8,4944,47,5722,California
Lassen,2021-05-08,10,10042,0,1176,5,8170,5,696,4,781,6,4950,9,5731,California
Lassen,2021-05-09,1,10043,0,1176,0,8170,1,697,0,781,1,4951,1,5732,California
Lassen,2021-05-10,11,10054,1,1177,6,8176,4,701,4,782,7,4958,8,5740,California
Lassen,2021-05-11,56,10110,0,1177,46,8222,10,711,19,774,37,4995,29,5769,California
Lassen,2021-05-12,40,10150,2,1179,33,8255,5,716,14,767,26,5021,19,5788,California
Lassen,2021-05-13,27,10177,6,1185,16,8271,5,721,10,765,17,5038,15,5803,California
Lassen,2021-05-14,19,10196,2,1187,9,8280,8,729,10,774,9,5047,18,5821,California
Lassen,2021-05-15,15,10211,2,1189,4,8284,9,738,4,776,11,5058,13,5834,California
Lassen,2021-05-16,7,10218,2,1191,3,8287,2,740,2,776,4,5062,4,5838,California
Lassen,2021-05-17,34,10252,3,1194,19,8306,12,752,9,772,25,5087,21,5859,California
Lassen,2021-05-18,79,10331,5,1199,62,8368,12,764,23,751,56,5143,35,5894,California
Lassen,2021-05-19,50,10381,1,1200,41,8409,8,772,6,721,43,5186,13,5907,California
Lassen,2021-05-20,30,10411,6,1206,15,8424,9,781,8,716,22,5208,17,5924,California
Lassen,2021-05-21,65,10476,31,1237,20,8444,14,795,34,733,31,5239,48,5972,California
Lassen,2021-05-22,16,10492,1,1238,7,8451,8,803,6,737,10,5249,14,5986,California
Lassen,2021-05-23,4,10496,1,1239,1,8452,2,805,0,735,4,5253,2,5988,California
Lassen,2021-05-24,13,10509,1,1240,10,8462,2,807,5,735,7,5260,7,5995,California
Lassen,2021-05-25,85,10594,6,1246,70,8532,9,816,31,721,54,5314,40,6035,California
Lassen,2021-05-26,55,10649,0,1246,40,8572,15,831,11,703,44,5358,26,6061,California
Lassen,2021-05-27,40,10689,15,1261,19,8591,6,837,10,690,29,5387,16,6077,California
Lassen,2021-05-28,72,10761,46,1307,18,8609,8,845,29,684,43,5430,37,6114,California
Lassen,2021-05-29,15,10776,1,1308,12,8621,2,847,8,687,7,5437,10,6124,California
Lassen,2021-05-30,2,10778,0,1308,1,8622,1,848,1,688,1,5438,2,6126,California
Lassen,2021-05-31,7,10785,0,1308,6,8628,1,849,1,684,6,5444,2,6128,California
Lassen,2021-06-01,43,10828,1,1309,36,8664,6,855,15,677,28,5472,21,6149,California
Lassen,2021-06-02,47,10875,2,1311,32,8696,13,868,11,666,35,5507,24,6173,California
Lassen,2021-06-03,19,10894,1,1312,9,8705,9,877,5,666,14,5521,14,6187,California
Lassen,2021-06-04,35,10929,1,1313,22,8727,12,889,11,665,24,5545,23,6210,California
Lassen,2021-06-05,13,10942,3,1316,7,8734,3,892,4,663,9,5554,7,6217,California
Lassen,2021-06-06,4,10946,0,1316,1,8735,3,895,1,664,3,5557,4,6221,California
Lassen,2021-06-07,17,10963,0,1316,9,8744,8,903,3,661,14,5571,11,6232,California
Lassen,2021-06-08,34,10997,4,1320,26,8770,4,907,12,655,22,5593,16,6248,California
Lassen,2021-06-09,18,11015,1,1321,15,8785,2,909,7,654,10,5603,9,6257,California
Lassen,2021-06-10,16,11031,8,1329,5,8790,3,912,8,657,8,5611,11,6268,California
Lassen,2021-06-11,43,11074,29,1358,14,8804,0,912,12,639,31,5642,13,6281,California
Lassen,2021-06-12,5,11079,1,1359,4,8808,0,912,1,636,4,5646,1,6282,California
Lassen,2021-06-13,3,11082,2,1361,1,8809,0,912,1,635,2,5648,1,6283,California
Lassen,2021-06-14,10,11092,2,1363,6,8815,2,914,4,636,5,5653,6,6289,California
Lassen,2021-06-15,47,11139,5,1368,37,8852,5,919,15,624,32,5685,20,6309,California
Lassen,2021-06-16,11,11150,0,1368,6,8858,5,924,6,630,5,5690,11,6320,California
Lassen,2021-06-17,22,11172,10,1378,8,8866,4,928,11,634,11,5701,15,6335,California
Lassen,2021-06-18,44,11216,18,1396,18,8884,8,936,9,616,35,5736,17,6352,California
Lassen,2021-06-19,12,11228,1,1397,10,8894,1,937,5,615,7,5743,6,6358,California
Lassen,2021-06-20,5,11233,2,1399,3,8897,0,937,5,620,0,5743,5,6363,California
Lassen,2021-06-21,15,11248,0,1399,13,8910,2,939,5,617,10,5753,7,6370,California
Lassen,2021-06-22,33,11281,1,1400,31,8941,1,940,16,617,17,5770,17,6387,California
Lassen,2021-06-23,14,11295,2,1402,10,8951,2,942,3,611,11,5781,5,6392,California
Lassen,2021-06-24,26,11321,2,1404,16,8967,8,950,13,619,13,5794,21,6413,California
Lassen,2021-06-25,20,11341,2,1406,18,8985,0,950,11,621,9,5803,11,6424,California
Lassen,2021-06-26,6,11347,0,1406,6,8991,0,950,1,617,5,5808,1,6425,California
Lassen,2021-06-27,1,11348,0,1406,0,8991,1,951,0,617,1,5809,1,6426,California
Lassen,2021-06-28,13,11361,2,1408,9,9000,2,953,9,624,4,5813,11,6437,California
Lassen,2021-06-29,30,11391,1,1409,28,9028,1,954,8,611,22,5835,9,6446,California
Lassen,2021-06-30,28,11419,8,1417,14,9042,6,960,13,615,15,5850,19,6465,California
Lassen,2021-07-01,25,11444,13,1430,10,9052,2,962,16,624,8,5858,17,6482,California
Lassen,2021-07-02,25,11469,4,1434,17,9069,4,966,9,623,14,5872,13,6495,California
Lassen,2021-07-03,5,11474,0,1434,5,9074,0,966,3,624,2,5874,3,6498,California
Lassen,2021-07-04,1,11475,0,1434,1,9075,0,966,1,625,0,5874,1,6499,California
Lassen,2021-07-05,9,11484,0,1434,6,9081,3,969,2,623,7,5881,5,6504,California
Lassen,2021-07-06,25,11509,0,1434,25,9106,0,969,12,624,11,5892,12,6516,California
Lassen,2021-07-07,16,11525,2,1436,13,9119,1,970,6,621,10,5902,7,6523,California
Lassen,2021-07-08,29,11554,23,1459,6,9125,0,970,21,634,8,5910,21,6544,California
Lassen,2021-07-09,24,11578,3,1462,18,9143,3,973,14,641,10,5920,17,6561,California
Lassen,2021-07-10,1,11579,0,1462,1,9144,0,973,0,640,1,5921,0,6561,California
Lassen,2021-07-11,1,11580,1,1463,0,9144,0,973,0,639,1,5922,0,6561,California
Lassen,2021-07-12,7,11587,0,1463,6,9150,1,974,1,635,6,5928,2,6563,California
Lassen,2021-07-13,24,11611,0,1463,21,9171,3,977,12,638,12,5940,15,6578,California
Lassen,2021-07-14,18,11629,5,1468,9,9180,4,981,9,643,9,5949,14,6592,California
Lassen,2021-07-15,19,11648,5,1473,13,9193,1,982,10,645,9,5958,11,6603,California
Lassen,2021-07-16,22,11670,3,1476,16,9209,3,985,9,644,13,5971,12,6615,California
Lassen,2021-07-17,8,11678,1,1477,7,9216,0,985,3,642,5,5976,3,6618,California
Lassen,2021-07-18,9,11687,1,1478,7,9223,1,986,5,644,4,5980,6,6624,California
Lassen,2021-07-19,2,11689,1,1479,1,9224,0,986,0,642,2,5982,0,6624,California
Lassen,2021-07-20,17,11706,0,1479,13,9237,4,990,5,639,12,5994,9,6633,California
Lassen,2021-07-21,13,11719,8,1487,5,9242,0,990,4,634,9,6003,4,6637,California
Lassen,2021-07-22,31,11750,17,1504,14,9256,0,990,15,633,16,6019,15,6652,California
Lassen,2021-07-23,21,11771,4,1508,16,9272,1,991,11,635,10,6029,12,6664,California
Lassen,2021-07-24,7,11778,0,1508,7,9279,0,991,3,634,4,6033,3,6667,California
Lassen,2021-07-25,2,11780,0,1508,2,9281,0,991,1,634,1,6034,1,6668,California
Lassen,2021-07-26,23,11803,0,1508,22,9303,1,992,14,640,9,6043,15,6683,California
Lassen,2021-07-27,37,11840,2,1510,25,9328,10,1002,19,651,18,6061,29,6712,California
Lassen,2021-07-28,18,11858,2,1512,14,9342,2,1004,10,656,7,6068,12,6724,California
Lassen,2021-07-29,22,11880,1,1513,18,9360,3,1007,12,661,10,6078,15,6739,California
Lassen,2021-07-30,26,11906,3,1516,19,9379,4,1011,13,665,13,6091,17,6756,California
Lassen,2021-07-31,2,11908,0,1516,2,9381,0,1011,1,665,1,6092,1,6757,California
Los Angeles,2020-12-15,404,404,404,404,0,0,0,0,404,404,0,0,404,404,California
Los Angeles,2020-12-16,3617,4021,3617,4021,0,0,0,0,3617,4021,0,0,3617,4021,California
Los Angeles,2020-12-17,10461,14482,10461,14482,0,0,0,0,10462,14483,0,0,10462,14483,California
Los Angeles,2020-12-18,14876,29358,14848,29330,28,28,0,0,14876,29359,0,0,14876,29359,California
Los Angeles,2020-12-19,7333,36691,7324,36654,9,37,0,0,7336,36695,0,0,7336,36695,California
Los Angeles,2020-12-20,4695,41386,4682,41336,13,50,0,0,4697,41392,0,0,4697,41392,California
Los Angeles,2020-12-21,13849,55235,13823,55159,26,76,0,0,13850,55241,1,1,13850,55242,California
Los Angeles,2020-12-22,11663,66898,11267,66426,396,472,0,0,11662,66900,3,4,11662,66904,California
Los Angeles,2020-12-23,12087,78985,10296,76722,1791,2263,0,0,12088,78988,0,4,12088,78992,California
Los Angeles,2020-12-24,7096,86081,4294,81016,2802,5065,0,0,7099,86087,0,4,7099,86091,California
Los Angeles,2020-12-25,534,86615,426,81442,108,5173,0,0,535,86622,0,4,535,86626,California
Los Angeles,2020-12-26,2571,89186,2213,83655,358,5531,0,0,2570,89190,2,6,2570,89196,California
Los Angeles,2020-12-27,1797,90983,1055,84710,742,6273,0,0,1797,90987,0,6,1797,90993,California
Los Angeles,2020-12-28,10469,101452,6487,91197,3982,10255,0,0,10466,101452,1,7,10466,101459,California
Los Angeles,2020-12-29,11748,113200,6153,97350,5595,15850,0,0,11746,113197,1,8,11746,113205,California
Los Angeles,2020-12-30,15050,128250,8177,105527,6873,22723,0,0,15049,128246,0,8,15049,128254,California
Los Angeles,2020-12-31,8093,136343,2800,108327,5293,28016,0,0,8088,136329,5,13,8088,136342,California
Los Angeles,2021-01-01,1155,137498,356,108683,799,28815,0,0,1151,137477,3,16,1151,137493,California
Los Angeles,2021-01-02,4543,142041,1708,110391,2835,31650,0,0,4542,142019,0,16,4542,142035,California
Los Angeles,2021-01-03,985,143026,235,110626,750,32400,0,0,983,143000,2,18,983,143018,California
Los Angeles,2021-01-04,12855,155881,4916,115542,7939,40339,0,0,12838,155836,2,20,12838,155856,California
Los Angeles,2021-01-05,16215,172096,7162,122704,9053,49392,0,0,14255,168172,1929,1949,14265,170121,California
Los Angeles,2021-01-06,22943,195039,12201,134905,10742,60134,0,0,17184,179677,5690,7639,17195,187316,California
Los Angeles,2021-01-07,30001,225040,16210,151115,13791,73925,0,0,19041,187823,10912,18551,19058,206374,California
Los Angeles,2021-01-08,33766,258806,18323,169438,15443,89368,0,0,21193,196485,12543,31094,21205,227579,California
Los Angeles,2021-01-09,12648,271454,7251,176689,5397,94765,0,0,7670,199188,4975,36069,7678,235257,California
Los Angeles,2021-01-10,4800,276254,3726,180415,1074,95839,0,0,2009,198407,2791,38860,2010,237267,California
Los Angeles,2021-01-11,26179,302433,16476,196891,9703,105542,0,0,15118,202491,11049,49909,15133,252400,California
Los Angeles,2021-01-12,29675,332108,16319,213210,13356,118898,0,0,19425,211695,10236,60145,19440,271840,California
Los Angeles,2021-01-13,29784,361892,15950,229160,13834,132732,0,0,20722,223382,9042,69187,20729,292569,California
Los Angeles,2021-01-14,29595,391487,12804,241964,16791,149523,0,0,23985,241789,5591,74778,23998,316567,California
Los Angeles,2021-01-15,34320,425807,12478,254442,21842,171365,0,0,30672,268850,3624,78402,30685,347252,California
Los Angeles,2021-01-16,17990,443797,5081,259523,12909,184274,0,0,16159,283196,1820,80222,16166,363418,California
Los Angeles,2021-01-17,5298,449095,2361,261884,2937,187211,0,0,5034,287969,263,80485,5036,368454,California
Los Angeles,2021-01-18,15913,465008,10229,272113,5684,192895,0,0,11134,294341,4766,85251,11138,379592,California
Los Angeles,2021-01-19,39059,504067,20765,292878,18294,211189,0,0,31142,317624,7875,93126,31158,410750,California
Los Angeles,2021-01-20,47453,551520,24862,317740,22591,233780,0,0,39744,349709,7672,100798,39757,450507,California
Los Angeles,2021-01-21,49593,601113,22756,340496,26837,260617,0,0,45195,390599,4324,105122,45214,495721,California
Los Angeles,2021-01-22,48911,650024,22606,363102,26305,286922,0,0,45352,432459,3510,108632,45370,541091,California
Los Angeles,2021-01-23,34564,684588,15888,378990,18676,305598,0,0,32425,462795,2104,110736,32440,573531,California
Los Angeles,2021-01-24,15817,700405,12213,391203,3604,309202,0,0,15248,477488,559,111295,15252,588783,California
Los Angeles,2021-01-25,40079,740484,16970,408173,23109,332311,0,0,31279,500031,8753,120048,31296,620079,California
Los Angeles,2021-01-26,50478,790962,25175,433348,25303,357614,0,0,42032,533680,8405,128453,42054,662133,California
Los Angeles,2021-01-27,51770,842732,26383,459731,25387,383001,0,0,42141,566372,9478,137931,42170,704303,California
Los Angeles,2021-01-28,49927,892659,24055,483786,25872,408873,0,0,41262,599121,8531,146462,41280,745583,California
Los Angeles,2021-01-29,50662,943321,26190,509976,24472,433345,0,0,40230,629303,10066,156528,40248,785831,California
Los Angeles,2021-01-30,30893,974214,15991,525967,14902,448247,0,0,26465,651431,4343,160871,26471,812302,California
Los Angeles,2021-01-31,13449,987663,10612,536579,2837,451084,0,0,12509,663024,920,161791,12513,824815,California
Los Angeles,2021-02-01,39215,1026878,16681,553260,22534,473618,0,0,28261,680404,10892,172683,28272,853087,California
Los Angeles,2021-02-02,45516,1072394,18392,571652,27124,500742,0,0,32895,700748,12558,185241,32902,885989,California
Los Angeles,2021-02-03,53072,1125466,19829,591481,33243,533985,0,0,37806,723560,15011,200252,37823,923812,California
Los Angeles,2021-02-04,58019,1183485,20915,612396,37104,571089,0,0,39547,745000,18121,218373,39561,963373,California
Los Angeles,2021-02-05,62362,1245847,21180,633576,41182,612271,0,0,39804,762733,22086,240459,39819,1003192,California
Los Angeles,2021-02-06,36121,1281968,13610,647186,22511,634782,0,0,27428,781574,8610,249069,27451,1030643,California
Los Angeles,2021-02-07,11221,1293189,8683,655869,2538,637320,0,0,8769,787921,2431,251500,8778,1039421,California
Los Angeles,2021-02-08,48082,1341271,22424,678293,25658,662978,0,0,31447,802893,16482,267982,31454,1070875,California
Los Angeles,2021-02-09,56808,1398079,25015,703308,31793,694771,0,0,28674,803568,28010,295992,28685,1099560,California
Los Angeles,2021-02-10,68060,1466139,29819,733127,38241,733012,0,0,30717,797373,36932,332924,30737,1130297,California
Los Angeles,2021-02-11,59217,1525356,31632,764759,27585,760597,0,0,28381,795436,30330,363254,28393,1158690,California
Los Angeles,2021-02-12,61106,1586462,30294,795053,30812,791409,0,0,26630,788040,34050,397304,26654,1185344,California
Los Angeles,2021-02-13,34401,1620863,20072,815125,14329,805738,0,0,15602,785013,18684,415988,15657,1201001,California
Los Angeles,2021-02-14,22150,1643013,15081,830206,7069,812807,0,0,8879,780708,13199,429187,8894,1209895,California
Los Angeles,2021-02-15,33770,1676783,16408,846614,17362,830169,0,0,18375,783803,15301,444488,18396,1228291,California
Los Angeles,2021-02-16,65626,1742409,33541,880155,32085,862254,0,0,30112,778557,35383,479871,30137,1258428,California
Los Angeles,2021-02-17,66522,1808931,35619,915774,30903,893157,0,0,26725,765743,39556,519427,26742,1285170,California
Los Angeles,2021-02-18,70071,1879002,35863,951637,34208,927365,0,0,28838,753592,41010,560437,28859,1314029,California
Los Angeles,2021-02-19,60372,1939374,37274,988911,23098,950463,0,0,29155,751720,31048,591485,29176,1343205,California
Los Angeles,2021-02-20,34312,1973686,25058,1013969,9254,959717,0,0,16293,750109,17930,609415,16319,1359524,California
Los Angeles,2021-02-21,23470,1997156,21689,1035658,1781,961498,0,0,11505,749737,11883,621298,11511,1371035,California
Los Angeles,2021-02-22,37332,2034488,27302,1062960,10030,971528,0,0,18864,750310,18314,639612,18887,1389922,California
Los Angeles,2021-02-23,58881,2093369,25324,1088284,33557,1005085,0,0,22667,737041,35966,675578,22697,1412619,California
Los Angeles,2021-02-24,69180,2162549,30938,1119222,38242,1043327,0,0,29307,726808,39579,715157,29346,1441965,California
Los Angeles,2021-02-25,78568,2241117,36128,1155350,42440,1085767,0,0,39945,728431,38358,753515,39981,1481946,California
Los Angeles,2021-02-26,88390,2329507,40907,1196257,47483,1133250,0,0,49015,738443,39054,792569,49066,1531012,California
Los Angeles,2021-02-27,64246,2393753,28210,1224467,36027,1169277,9,9,32241,738953,31780,824349,32290,1563302,California
Los Angeles,2021-02-28,28456,2422209,19681,1244148,8772,1178049,3,12,19679,750025,8628,832977,19700,1583002,California
Los Angeles,2021-03-01,60078,2482287,34272,1278420,25747,1203796,59,71,35760,761839,24043,857020,35857,1618859,California
Los Angeles,2021-03-02,80949,2563236,38953,1317373,41987,1245783,9,80,50567,782285,30168,887188,50614,1669473,California
Los Angeles,2021-03-03,88631,2651867,45012,1362385,43598,1289381,21,101,55660,805257,32742,919930,55714,1725187,California
Los Angeles,2021-03-04,94169,2746036,47902,1410287,46249,1335630,18,119,59040,829469,34886,954816,59098,1784285,California
Los Angeles,2021-03-05,92457,2838493,45304,1455591,47117,1382747,36,155,61294,859972,30902,985718,61405,1845690,California
Los Angeles,2021-03-06,68513,2907006,34707,1490298,31944,1414691,1862,2017,43863,881227,24474,1010192,45729,1891419,California
Los Angeles,2021-03-07,28651,2935657,21030,1511328,5987,1420678,1634,3651,21561,897359,7044,1017236,23176,1914595,California
Los Angeles,2021-03-08,55089,2990746,29638,1540966,23343,1444021,2108,5759,41530,927568,13428,1030664,43637,1958232,California
Los Angeles,2021-03-09,82613,3073359,39341,1580307,39904,1483925,3368,9127,52496,953457,29940,1060604,55829,2014061,California
Los Angeles,2021-03-10,84069,3157428,41352,1621659,37808,1521733,4909,14036,53134,980730,30721,1091325,57994,2072055,California
Los Angeles,2021-03-11,94288,3251716,46283,1667942,41210,1562943,6795,20831,55180,1003760,38870,1130195,61900,2133955,California
Los Angeles,2021-03-12,100237,3351953,45462,1713404,40829,1603772,13946,34777,58453,1034477,41522,1171717,72239,2206194,California
Los Angeles,2021-03-13,76302,3428255,36050,1749454,28243,1632015,12009,46786,45425,1061042,30737,1202454,57302,2263496,California
Los Angeles,2021-03-14,39416,3467671,26444,1775898,10406,1642421,2566,49352,23999,1072249,15329,1217783,26536,2290032,California
Los Angeles,2021-03-15,76073,3543744,37397,1813295,33206,1675627,5470,54822,45681,1093208,30136,1247919,51095,2341127,California
Los Angeles,2021-03-16,101057,3644801,44461,1857756,50702,1726329,5894,60716,65078,1128363,35710,1283629,70865,2411992,California
Los Angeles,2021-03-17,98812,3743613,45163,1902919,45288,1771617,8361,69077,65933,1169818,32623,1316252,74078,2486070,California
Los Angeles,2021-03-18,104327,3847940,50092,1953011,48636,1820253,5599,74676,65360,1202113,38609,1354861,70904,2556974,California
Los Angeles,2021-03-19,110471,3958411,57751,2010762,47911,1868164,4809,79485,67332,1231365,42808,1397669,72060,2629034,California
Los Angeles,2021-03-20,77463,4035874,38184,2048946,34653,1902817,4626,84111,52152,1263025,25082,1422751,56742,2685776,California
Los Angeles,2021-03-21,35147,4071021,26133,2075079,8106,1910923,908,85019,22189,1273305,12810,1435561,23090,2708866,California
Los Angeles,2021-03-22,71863,4142884,42372,2117451,27302,1938225,2189,87208,49935,1303814,21600,1457161,52109,2760975,California
Los Angeles,2021-03-23,97869,4240753,53087,2170538,41523,1979748,3259,90467,58438,1326377,39112,1496273,61675,2822650,California
Los Angeles,2021-03-24,106407,4347160,56502,2227040,46711,2026459,3194,93661,60441,1344396,45584,1541857,63603,2886253,California
Los Angeles,2021-03-25,112348,4459508,60291,2287331,48120,2074579,3937,97598,62220,1360745,49765,1591622,66114,2952367,California
Los Angeles,2021-03-26,116758,4576266,63921,2351252,48589,2123168,4248,101846,63642,1375838,52752,1644374,67845,3020212,California
Los Angeles,2021-03-27,84538,4660804,44408,2395660,37979,2161147,2151,103997,42640,1379045,41579,1685953,44786,3064998,California
Los Angeles,2021-03-28,42675,4703479,28924,2424584,13162,2174309,589,104586,20102,1377317,22416,1708369,20688,3085686,California
Los Angeles,2021-03-29,84135,4787614,47367,2471951,34979,2209288,1789,106375,46063,1387385,37778,1746147,47846,3133532,California
Los Angeles,2021-03-30,110414,4898028,52864,2524815,51583,2260871,5967,112342,56915,1396997,53202,1799349,62814,3196346,California
Los Angeles,2021-03-31,123885,5021913,62686,2587501,52327,2313198,8872,121214,68348,1418964,55161,1854510,77128,3273474,California
Los Angeles,2021-04-01,135985,5157898,63865,2651366,56533,2369731,15587,136801,72260,1443385,63252,1917762,87673,3361147,California
Los Angeles,2021-04-02,133885,5291783,59970,2711336,58221,2427952,15694,152495,70551,1466610,62923,1980685,86148,3447295,California
Los Angeles,2021-04-03,99442,5391225,45553,2756889,40121,2468073,13768,166263,48809,1478649,50400,2031085,62439,3509734,California
Los Angeles,2021-04-04,39501,5430726,20688,2777577,12141,2480214,6672,172935,16421,1478718,22968,2054053,23037,3532771,California
Los Angeles,2021-04-05,95253,5525979,45029,2822606,39686,2519900,10538,183473,44596,1483338,50394,2104447,55014,3587785,California
Los Angeles,2021-04-06,123142,5649121,57769,2880375,44897,2564797,20476,203949,56393,1493592,66429,2170876,76683,3664468,California
Los Angeles,2021-04-07,121926,5771047,55542,2935917,44956,2609753,21428,225377,54699,1502600,66911,2237787,75919,3740387,California
Los Angeles,2021-04-08,134507,5905554,59346,2995263,50776,2660529,24385,249762,60173,1512969,73941,2311728,84310,3824697,California
Los Angeles,2021-04-09,134111,6039665,58174,3053437,51588,2712117,24349,274111,57335,1518018,76388,2388116,81437,3906134,California
Los Angeles,2021-04-10,102877,6142542,43375,3096812,35170,2747287,24332,298443,37816,1515188,64780,2452896,61950,3968084,California
Los Angeles,2021-04-11,42255,6184797,22805,3119617,10003,2757290,9447,307890,14595,1511589,27549,2480445,23950,3992034,California
Los Angeles,2021-04-12,80315,6265112,39193,3158810,34509,2791799,6613,314503,32719,1503498,47338,2527783,39247,4031281,California
Los Angeles,2021-04-13,120224,6385336,60584,3219394,59202,2851001,438,314941,63533,1511105,56374,2584157,63981,4095262,California
Los Angeles,2021-04-14,120763,6506099,60461,3279855,60160,2911161,142,315083,65102,1521035,55316,2639473,65246,4160508,California
Los Angeles,2021-04-15,131667,6637766,70924,3350779,60539,2971700,204,315287,74553,1538920,56744,2696217,74629,4235137,California
Los Angeles,2021-04-16,132614,6770380,69861,3420640,62607,3034307,146,315433,69502,1545814,62696,2758913,69590,4304727,California
Los Angeles,2021-04-17,100135,6870515,52310,3472950,47799,3082106,26,315459,56768,1559526,43078,2801991,56790,4361517,California
Los Angeles,2021-04-18,35969,6906484,24270,3497220,11697,3093803,2,315461,19594,1562857,16273,2818264,19604,4381121,California
Los Angeles,2021-04-19,77863,6984347,40700,3537920,37145,3130948,18,315479,34720,1554727,42881,2861145,34751,4415872,California
Los Angeles,2021-04-20,106193,7090540,52516,3590436,53647,3184595,30,315509,52097,1553095,53767,2914912,52135,4468007,California
Los Angeles,2021-04-21,115809,7206349,56697,3647133,58920,3243515,192,315701,51102,1540139,64262,2979174,51306,4519313,California
Los Angeles,2021-04-22,120025,7326374,62383,3709516,57606,3301121,36,315737,52624,1525861,66952,3046126,52674,4571987,California
Los Angeles,2021-04-23,119932,7446306,65840,3775356,54068,3355189,24,315761,57090,1520544,62444,3108570,57127,4629114,California
Los Angeles,2021-04-24,92073,7538379,58216,3833572,33815,3389004,42,315803,51025,1530880,40748,3149318,51084,4680198,California
Los Angeles,2021-04-25,38471,7576850,25478,3859050,12986,3401990,7,315810,20704,1533969,17623,3166941,20712,4700910,California
Los Angeles,2021-04-26,79982,7656832,41735,3900785,37734,3439724,513,316323,39367,1533520,40334,3207275,39885,4740795,California
Los Angeles,2021-04-27,96344,7753176,46357,3947142,47965,3487689,2022,318345,37246,1514023,58751,3266026,39254,4780049,California
Los Angeles,2021-04-28,88959,7842135,43128,3990270,43699,3531388,2132,320477,35119,1497832,53431,3319457,37240,4817289,California
Los Angeles,2021-04-29,95905,7938040,48019,4038289,45642,3577030,2244,322721,34510,1473681,60899,3380356,36748,4854037,California
Los Angeles,2021-04-30,103984,8042024,51513,4089802,49971,3627001,2500,325221,38123,1448970,65313,3445669,40602,4894639,California
Los Angeles,2021-05-01,76977,8119001,42930,4132732,32465,3659466,1582,326803,29134,1432241,47437,3493106,30708,4925347,California
Los Angeles,2021-05-02,28381,8147382,18214,4150946,9417,3668883,750,327553,10257,1425262,17986,3511092,11007,4936354,California
Los Angeles,2021-05-03,63596,8210978,31012,4181958,30319,3699202,2265,329818,23005,1410241,40274,3551366,25253,4961607,California
Los Angeles,2021-05-04,89630,8300608,49919,4231877,37369,3736571,2342,332160,27615,1378524,61652,3613018,29935,4991542,California
Los Angeles,2021-05-05,92760,8393368,54193,4286070,36146,3772717,2421,334581,25695,1339974,66655,3679673,28105,5019647,California
Los Angeles,2021-05-06,100520,8493888,61015,4347085,36952,3809669,2553,337134,23851,1290132,76226,3755899,26384,5046031,California
Los Angeles,2021-05-07,99615,8593503,58982,4406067,38236,3847905,2397,339531,27322,1247982,71848,3827747,29698,5075729,California
Los Angeles,2021-05-08,67734,8661237,44406,4450473,21526,3869431,1802,341333,18758,1219929,48605,3876352,20552,5096281,California
Los Angeles,2021-05-09,24593,8685830,18882,4469355,4960,3874391,751,342084,6193,1208574,18289,3894641,6934,5103215,California
Los Angeles,2021-05-10,51592,8737422,27349,4496704,22294,3896685,1949,344033,15733,1190682,35566,3930207,17674,5120889,California
Los Angeles,2021-05-11,72535,8809957,39620,4536324,30738,3927423,2177,346210,18848,1158317,53371,3983578,21006,5141895,California
Los Angeles,2021-05-12,73318,8883275,40082,4576406,30901,3958324,2335,348545,20662,1128982,52300,4035878,22965,5164860,California
Los Angeles,2021-05-13,79095,8962370,47690,4624096,29655,3987979,1750,350295,28188,1108430,50476,4086354,29924,5194784,California
Los Angeles,2021-05-14,90487,9052857,57569,4681665,31019,4018998,1899,352194,34048,1088323,56045,4142399,35938,5230722,California
Los Angeles,2021-05-15,77176,9130033,53984,4735649,21617,4040615,1575,353769,29995,1073031,46846,4189245,31554,5262276,California
Los Angeles,2021-05-16,31251,9161284,24772,4760421,5859,4046474,620,354389,12389,1067289,18746,4207991,13004,5275280,California
Los Angeles,2021-05-17,62506,9223790,40434,4800855,20276,4066750,1796,356185,25001,1056822,37236,4245227,26769,5302049,California
Los Angeles,2021-05-18,65697,9289487,38824,4839679,25024,4091774,1849,358034,25766,1044777,39629,4284856,27584,5329633,California
Los Angeles,2021-05-19,68017,9357504,40901,4880580,25234,4117008,1882,359916,28875,1036673,38844,4323700,30740,5360373,California
Los Angeles,2021-05-20,67551,9425055,37927,4918507,27504,4144512,2120,362036,25579,1022808,41549,4365249,27684,5388057,California
Los Angeles,2021-05-21,70569,9495624,42751,4961258,25719,4170231,2099,364135,27245,1009242,42902,4408151,29336,5417393,California
Los Angeles,2021-05-22,57835,9553459,37573,4998831,18591,4188822,1671,365806,23395,1000130,34167,4442318,25055,5442448,California
Los Angeles,2021-05-23,24450,9577909,17052,5015883,6553,4195375,845,366651,10792,998240,13523,4455841,11633,5454081,California
Los Angeles,2021-05-24,49438,9627347,27281,5043164,20281,4215656,1876,368527,18601,988132,30571,4486412,20463,5474544,California
Los Angeles,2021-05-25,50188,9677535,28978,5072142,19419,4235075,1791,370318,19255,978521,30651,4517063,21040,5495584,California
Los Angeles,2021-05-26,47570,9725105,26806,5098948,18902,4253977,1862,372180,19800,972731,27330,4544393,21540,5517124,California
Los Angeles,2021-05-27,45763,9770868,25541,5124489,18362,4272339,1860,374040,18823,966720,26675,4571068,20664,5537788,California
Los Angeles,2021-05-28,52629,9823497,29804,5154293,20914,4293253,1911,375951,23273,962881,29009,4600077,25170,5562958,California
Los Angeles,2021-05-29,30879,9854376,17899,5172192,11928,4305181,1052,377003,14386,962030,16278,4616355,15427,5578385,California
Los Angeles,2021-05-30,12613,9866989,8267,5180459,3608,4308789,738,377741,5844,961902,6706,4623061,6578,5584963,California
Los Angeles,2021-05-31,6108,9873097,3774,5184233,2024,4310813,310,378051,1733,959649,4293,4627354,2040,5587003,California
Los Angeles,2021-06-01,46624,9919721,26067,5210300,18957,4329770,1600,379651,17040,949058,29204,4656558,18613,5605616,California
Los Angeles,2021-06-02,38812,9958533,22419,5232719,14933,4344703,1460,381111,15141,942260,23373,4679931,16575,5622191,California
Los Angeles,2021-06-03,43123,10001656,28525,5261244,13011,4357714,1587,382698,14711,930431,28108,4708039,16279,5638470,California
Los Angeles,2021-06-04,52676,10054332,35557,5296801,15422,4373136,1697,384395,16615,913050,35677,4743716,18296,5656766,California
Los Angeles,2021-06-05,42824,10097156,30629,5327430,10797,4383933,1398,385793,12414,896632,30211,4773927,13793,5670559,California
Los Angeles,2021-06-06,14899,10112055,12287,5339717,1870,4385803,742,386535,4004,890552,10819,4784746,4739,5675298,California
Los Angeles,2021-06-07,37230,10149285,26541,5366258,9213,4395016,1476,388011,11860,878716,25153,4809899,13317,5688615,California
Los Angeles,2021-06-08,38680,10187965,26631,5392889,10437,4405453,1612,389623,12858,867668,25502,4835401,14454,5703069,California
Los Angeles,2021-06-09,40194,10228159,28333,5421222,10323,4415776,1538,391161,11824,852914,28086,4863487,13332,5716401,California
Los Angeles,2021-06-10,36933,10265092,25511,5446733,9794,4425570,1628,392789,11452,840740,25238,4888725,13064,5729465,California
Los Angeles,2021-06-11,41450,10306542,28372,5475105,11397,4436967,1681,394470,13458,828191,27672,4916397,15123,5744588,California
Los Angeles,2021-06-12,33633,10340175,24191,5499296,8206,4445173,1236,395706,10369,816698,23083,4939480,11590,5756178,California
Los Angeles,2021-06-13,11569,10351744,8279,5507575,2653,4447826,637,396343,2625,811080,8876,4948356,3258,5759436,California
Los Angeles,2021-06-14,32955,10384699,23688,5531263,7885,4455711,1382,397725,11576,802838,21175,4969531,12933,5772369,California
Los Angeles,2021-06-15,34187,10418886,22874,5554137,9589,4465300,1724,399449,11879,794483,21931,4991462,13576,5785945,California
Los Angeles,2021-06-16,32608,10451494,22507,5576644,8343,4473643,1758,401207,11439,786738,20928,5012390,13183,5799128,California
Los Angeles,2021-06-17,29928,10481422,20043,5596687,8142,4481785,1743,402950,10947,780701,18711,5031101,12674,5811802,California
Los Angeles,2021-06-18,35619,10517041,24474,5621161,9164,4490949,1981,404931,12592,772614,22639,5053740,14552,5826354,California
Los Angeles,2021-06-19,22745,10539786,15390,5636551,5973,4496922,1382,406313,8598,768664,13910,5067650,9960,5836314,California
Los Angeles,2021-06-20,8529,10548315,6006,5642557,2028,4498950,495,406808,3089,766877,5369,5073019,3582,5839896,California
Los Angeles,2021-06-21,19347,10567662,11866,5654423,6100,4505050,1381,408189,10395,769810,8830,5081849,11763,5851659,California
Los Angeles,2021-06-22,26533,10594195,17885,5672308,7109,4512159,1539,409728,10259,765515,16087,5097936,11792,5863451,California
Los Angeles,2021-06-23,25223,10619418,17319,5689627,6475,4518634,1429,411157,10115,762117,14914,5112850,11516,5874967,California
Los Angeles,2021-06-24,25110,10644528,17278,5706905,6187,4524821,1645,412802,9741,758324,15144,5127994,11351,5886318,California
Los Angeles,2021-06-25,29552,10674080,20573,5727478,7368,4532189,1611,414413,12093,754763,17243,5145237,13682,5900000,California
Los Angeles,2021-06-26,20128,10694208,14624,5742102,4479,4536668,1025,415438,8375,752508,11638,5156875,9383,5909383,California
Los Angeles,2021-06-27,8651,10702859,6291,5748393,1921,4538589,439,415877,3648,751656,4929,5161804,4077,5913460,California
Los Angeles,2021-06-28,20279,10723138,15596,5763989,3428,4542017,1255,417132,8844,750453,11289,5173093,10086,5923546,California
Los Angeles,2021-06-29,22652,10745790,15549,5779538,6019,4548036,1084,418216,9944,748930,12538,5185631,11015,5934561,California
Los Angeles,2021-06-30,22625,10768415,15943,5795481,5590,4553626,1092,419308,10282,748143,12144,5197775,11357,5945918,California
Los Angeles,2021-07-01,20235,10788650,14358,5809839,4858,4558484,1019,420327,9143,747327,10963,5208738,10147,5956065,California
Los Angeles,2021-07-02,23864,10812514,16859,5826698,5876,4564360,1129,421456,10798,746343,12893,5221631,11909,5967974,California
Los Angeles,2021-07-03,13813,10826327,9740,5836438,3557,4567917,516,421972,6297,745750,7398,5229029,6805,5974779,California
Los Angeles,2021-07-04,765,10827092,398,5836836,319,4568236,48,422020,356,745757,396,5229425,403,5975182,California
Los Angeles,2021-07-05,11242,10838334,8166,5845002,2796,4571032,280,422300,5226,745341,5924,5235349,5508,5980690,California
Los Angeles,2021-07-06,24232,10862566,17398,5862400,5648,4576680,1186,423486,9296,741051,14767,5250116,10477,5991167,California
Los Angeles,2021-07-07,20520,10883086,14548,5876948,4848,4581528,1124,424610,8628,739068,11719,5261835,9736,6000903,California
Los Angeles,2021-07-08,19223,10902309,13616,5890564,4539,4586067,1068,425678,8128,737293,10962,5272797,9187,6010090,California
Los Angeles,2021-07-09,23529,10925838,16634,5907198,5479,4591546,1416,427094,10156,735634,13204,5286001,11545,6021635,California
Los Angeles,2021-07-10,16769,10942607,12329,5919527,3659,4595205,781,427875,7220,734209,9419,5295420,7994,6029629,California
Los Angeles,2021-07-11,6590,10949197,4721,5924248,1566,4596771,303,428178,3206,734385,3331,5298751,3507,6033136,California
Los Angeles,2021-07-12,18480,10967677,13256,5937504,4128,4600899,1096,429274,7769,732649,10583,5309334,8847,6041983,California
Los Angeles,2021-07-13,18810,10986487,12730,5950234,5024,4605923,1056,430330,8677,732386,9984,5319318,9721,6051704,California
Los Angeles,2021-07-14,18825,11005312,13043,5963277,4759,4610682,1023,431353,8519,731743,10167,5329485,9524,6061228,California
Los Angeles,2021-07-15,18696,11024008,13262,5976539,4590,4615272,844,432197,8828,731675,9733,5339218,9665,6070893,California
Los Angeles,2021-07-16,23859,11047867,17155,5993694,5690,4620962,1014,433211,11729,732434,11973,5351191,12732,6083625,California
Los Angeles,2021-07-17,16845,11064712,11862,6005556,4127,4625089,856,434067,8201,732949,8536,5359727,9051,6092676,California
Los Angeles,2021-07-18,7465,11072177,5521,6011077,1669,4626758,275,434342,3854,733532,3546,5363273,4129,6096805,California
Los Angeles,2021-07-19,19203,11091380,14089,6025166,4274,4631032,840,435182,9446,734199,9606,5372879,10273,6107078,California
Los Angeles,2021-07-20,20604,11111984,14245,6039411,5600,4636632,759,435941,10555,735624,9875,5382754,11300,6118378,California
Los Angeles,2021-07-21,20957,11132941,14776,6054187,4951,4641583,1230,437171,10501,737039,10301,5393055,11716,6130094,California
Los Angeles,2021-07-22,20854,11153795,14852,6069039,4928,4646511,1074,438245,11081,739586,9588,5402643,12135,6142229,California
Los Angeles,2021-07-23,24607,11178402,17460,6086499,5969,4652480,1178,439423,13294,742922,11119,5413762,14455,6156684,California
Los Angeles,2021-07-24,16237,11194639,11374,6097873,4144,4656624,719,440142,9225,745994,6868,5420630,9940,6166624,California
Los Angeles,2021-07-25,6983,11201622,4975,6102848,1873,4658497,135,440277,5272,749748,1651,5422281,5405,6172029,California
Los Angeles,2021-07-26,18972,11220594,13260,6116108,4839,4663336,873,441150,11801,755394,7012,5429293,12658,6184687,California
Los Angeles,2021-07-27,21849,11242443,15659,6131767,5312,4668648,878,442028,12589,759770,9078,5438371,13454,6198141,California
Los Angeles,2021-07-28,22943,11265386,16286,6148053,5775,4674423,882,442910,13749,765403,8980,5447351,14613,6212754,California
Los Angeles,2021-07-29,21435,11286821,15400,6163453,5213,4679636,822,443732,13115,771235,8091,5455442,13923,6226677,California
Los Angeles,2021-07-30,23514,11310335,17087,6180540,5780,4685416,647,444379,13913,776419,9365,5464807,14549,6241226,California
Los Angeles,2021-07-31,11289,11321624,8078,6188618,2862,4688278,349,444728,6717,779022,4456,5469263,7059,6248285,California
Madera,2020-12-16,21,21,21,21,0,0,0,0,21,21,0,0,21,21,California
Madera,2020-12-17,12,33,12,33,0,0,0,0,12,33,0,0,12,33,California
Madera,2020-12-18,62,95,62,95,0,0,0,0,62,95,0,0,62,95,California
Madera,2020-12-19,5,100,5,100,0,0,0,0,5,100,0,0,5,100,California
Madera,2020-12-20,12,112,12,112,0,0,0,0,12,112,0,0,12,112,California
Madera,2020-12-21,59,171,59,171,0,0,0,0,59,171,0,0,59,171,California
Madera,2020-12-22,94,265,92,263,2,2,0,0,94,265,0,0,94,265,California
Madera,2020-12-23,67,332,67,330,0,2,0,0,67,332,0,0,67,332,California
Madera,2020-12-24,43,375,38,368,5,7,0,0,43,375,0,0,43,375,California
Madera,2020-12-26,27,402,26,394,1,8,0,0,27,402,0,0,27,402,California
Madera,2020-12-27,27,429,12,406,15,23,0,0,27,429,0,0,27,429,California
Madera,2020-12-28,107,536,36,442,71,94,0,0,107,536,0,0,107,536,California
Madera,2020-12-29,176,712,38,480,138,232,0,0,176,712,0,0,176,712,California
Madera,2020-12-30,227,939,89,569,138,370,0,0,227,939,0,0,227,939,California
Madera,2020-12-31,204,1143,81,650,123,493,0,0,204,1143,0,0,204,1143,California
Madera,2021-01-01,2,1145,1,651,1,494,0,0,2,1145,0,0,2,1145,California
Madera,2021-01-02,88,1233,32,683,56,550,0,0,88,1233,0,0,88,1233,California
Madera,2021-01-03,4,1237,4,687,0,550,0,0,4,1237,0,0,4,1237,California
Madera,2021-01-04,131,1368,67,754,64,614,0,0,131,1368,0,0,131,1368,California
Madera,2021-01-05,277,1645,142,896,135,749,0,0,273,1637,4,4,273,1641,California
Madera,2021-01-06,182,1827,26,922,156,905,0,0,163,1781,19,23,163,1804,California
Madera,2021-01-07,397,2224,116,1038,281,1186,0,0,374,2133,23,46,375,2179,California
Madera,2021-01-08,422,2646,72,1110,350,1536,0,0,367,2447,54,100,368,2547,California
Madera,2021-01-09,36,2682,14,1124,22,1558,0,0,27,2465,9,109,27,2574,California
Madera,2021-01-10,17,2699,14,1138,3,1561,0,0,5,2458,12,121,5,2579,California
Madera,2021-01-11,237,2936,190,1328,47,1608,0,0,195,2611,42,163,195,2774,California
Madera,2021-01-12,387,3323,155,1483,232,1840,0,0,285,2794,102,265,285,3059,California
Madera,2021-01-13,182,3505,90,1573,92,1932,0,0,129,2871,53,318,130,3189,California
Madera,2021-01-14,552,4057,81,1654,471,2403,0,0,520,3359,32,350,520,3709,California
Madera,2021-01-15,598,4655,156,1810,442,2845,0,0,576,3913,22,372,576,4285,California
Madera,2021-01-16,387,5042,49,1859,338,3183,0,0,358,4242,29,401,358,4643,California
Madera,2021-01-17,337,5379,15,1874,322,3505,0,0,333,4571,4,405,333,4976,California
Madera,2021-01-18,80,5459,64,1938,16,3521,0,0,61,4614,18,423,61,5037,California
Madera,2021-01-19,562,6021,128,2066,434,3955,0,0,536,5125,26,449,537,5574,California
Madera,2021-01-20,341,6362,184,2250,157,4112,0,0,245,5275,95,544,245,5819,California
Madera,2021-01-21,290,6652,180,2430,110,4222,0,0,226,5439,62,606,226,6045,California
Madera,2021-01-22,262,6914,82,2512,180,4402,0,0,245,5667,17,623,245,6290,California
Madera,2021-01-23,100,7014,54,2566,46,4448,0,0,76,5719,24,647,76,6366,California
Madera,2021-01-24,97,7111,81,2647,16,4464,0,0,78,5778,19,666,78,6444,California
Madera,2021-01-25,273,7384,125,2772,148,4612,0,0,148,5801,125,791,148,6592,California
Madera,2021-01-26,494,7878,189,2961,305,4917,0,0,303,5915,190,981,304,6896,California
Madera,2021-01-27,760,8638,75,3036,685,5602,0,0,621,6398,139,1120,622,7518,California
Madera,2021-01-28,556,9194,113,3149,443,6045,0,0,449,6741,107,1227,450,7968,California
Madera,2021-01-29,477,9671,95,3244,382,6427,0,0,421,7106,56,1283,421,8389,California
Madera,2021-01-30,506,10177,19,3263,487,6914,0,0,453,7506,53,1336,453,8842,California
Madera,2021-01-31,8,10185,4,3267,4,6918,0,0,7,7512,1,1337,7,8849,California
Madera,2021-02-01,334,10519,148,3415,186,7104,0,0,209,7596,125,1462,209,9058,California
Madera,2021-02-02,255,10774,93,3508,162,7266,0,0,164,7671,90,1552,165,9223,California
Madera,2021-02-03,599,11373,461,3969,138,7404,0,0,479,8033,118,1670,480,9703,California
Madera,2021-02-04,400,11773,128,4097,272,7676,0,0,120,7875,279,1949,121,9824,California
Madera,2021-02-05,984,12757,301,4398,683,8359,0,0,376,7650,602,2551,377,10201,California
Madera,2021-02-06,370,13127,334,4732,36,8395,0,0,330,7941,39,2590,330,10531,California
Madera,2021-02-07,34,13161,6,4738,28,8423,0,0,29,7965,5,2595,29,10560,California
Madera,2021-02-08,395,13556,318,5056,77,8500,0,0,276,8123,118,2713,276,10836,California
Madera,2021-02-09,488,14044,117,5173,371,8871,0,0,203,8046,282,2995,205,11041,California
Madera,2021-02-10,436,14480,150,5323,286,9157,0,0,284,8180,150,3145,284,11325,California
Madera,2021-02-11,935,15415,304,5627,631,9788,0,0,399,8046,534,3679,400,11725,California
Madera,2021-02-12,848,16263,117,5744,731,10519,0,0,316,7839,526,4205,319,12044,California
Madera,2021-02-13,489,16752,47,5791,442,10961,0,0,137,7628,351,4556,140,12184,California
Madera,2021-02-14,405,17157,74,5865,331,11292,0,0,138,7501,267,4823,140,12324,California
Madera,2021-02-15,248,17405,100,5965,148,11440,0,0,177,7609,69,4892,177,12501,California
Madera,2021-02-16,781,18186,180,6145,601,12041,0,0,231,7293,548,5440,232,12733,California
Madera,2021-02-17,633,18819,288,6433,345,12386,0,0,349,7367,277,5717,351,13084,California
Madera,2021-02-18,1309,20128,545,6978,764,13150,0,0,1122,8306,184,5901,1123,14207,California
Madera,2021-02-19,867,20995,547,7525,320,13470,0,0,718,8878,148,6049,720,14927,California
Madera,2021-02-20,1087,22082,996,8521,91,13561,0,0,1011,9815,75,6124,1012,15939,California
Madera,2021-02-21,1005,23087,864,9385,141,13702,0,0,997,10805,7,6131,997,16936,California
Madera,2021-02-22,973,24060,894,10279,79,13781,0,0,909,11651,63,6194,909,17845,California
Madera,2021-02-23,800,24860,510,10789,290,14071,0,0,558,11969,240,6434,558,18403,California
Madera,2021-02-24,945,25805,307,11096,638,14709,0,0,388,11800,557,6991,388,18791,California
Madera,2021-02-25,1074,26879,316,11412,758,15467,0,0,611,11951,460,7451,611,19402,California
Madera,2021-02-26,1117,27996,207,11619,910,16377,0,0,714,12264,401,7852,714,20116,California
Madera,2021-02-27,933,28929,276,11895,657,17034,0,0,491,12319,439,8291,494,20610,California
Madera,2021-02-28,194,29123,28,11923,166,17200,0,0,188,12501,6,8297,188,20798,California
Madera,2021-03-01,387,29510,122,12045,265,17465,0,0,200,12519,183,8480,201,20999,California
Madera,2021-03-02,780,30290,355,12400,424,17889,1,1,667,13076,111,8591,668,21667,California
Madera,2021-03-03,1386,31676,744,13144,642,18531,0,1,964,13650,419,9010,993,22660,California
Madera,2021-03-04,1216,32892,531,13675,685,19216,0,1,961,14360,256,9266,966,23626,California
Madera,2021-03-05,1377,34269,423,14098,941,20157,13,14,1086,15182,289,9555,1111,24737,California
Madera,2021-03-06,827,35096,644,14742,151,20308,32,46,504,15397,322,9877,537,25274,California
Madera,2021-03-07,160,35256,26,14768,109,20417,25,71,106,15474,54,9931,131,25405,California
Madera,2021-03-08,613,35869,342,15110,211,20628,60,131,309,15540,304,10235,370,25775,California
Madera,2021-03-09,611,36480,298,15408,280,20908,33,164,417,15804,192,10427,456,26231,California
Madera,2021-03-10,1199,37679,560,15968,561,21469,78,242,763,16215,431,10858,842,27073,California
Madera,2021-03-11,1693,39372,874,16842,492,21961,327,569,772,16409,917,11775,1111,28184,California
Madera,2021-03-12,1582,40954,818,17660,613,22574,151,720,800,16611,778,12553,980,29164,California
Madera,2021-03-13,1894,42848,1336,18996,362,22936,196,916,814,16565,1075,13628,1029,30193,California
Madera,2021-03-14,589,43437,450,19446,105,23041,34,950,285,16585,299,13927,319,30512,California
Madera,2021-03-15,755,44192,236,19682,474,23515,45,995,518,16953,233,14160,601,31113,California
Madera,2021-03-16,944,45136,531,20213,366,23881,47,1042,748,17573,193,14353,813,31926,California
Madera,2021-03-17,1478,46614,983,21196,432,24313,63,1105,911,18084,558,14911,1069,32995,California
Madera,2021-03-18,1964,48578,685,21881,1212,25525,67,1172,977,18242,978,15889,1136,34131,California
Madera,2021-03-19,1600,50178,587,22468,929,26454,84,1256,1038,18887,558,16447,1203,35334,California
Madera,2021-03-20,1185,51363,776,23244,359,26813,50,1306,589,18999,592,17039,704,36038,California
Madera,2021-03-21,1118,52481,912,24156,157,26970,49,1355,365,18667,748,17787,416,36454,California
Madera,2021-03-22,1366,53847,862,25018,439,27409,65,1420,655,18728,707,18494,768,37222,California
Madera,2021-03-23,1434,55281,877,25895,472,27881,85,1505,676,18819,756,19250,847,38069,California
Madera,2021-03-24,960,56241,514,26409,414,28295,32,1537,617,19133,339,19589,653,38722,California
Madera,2021-03-25,1189,57430,540,26949,624,28919,25,1562,649,19290,530,20119,687,39409,California
Madera,2021-03-26,1527,58957,581,27530,810,29729,136,1698,721,19347,804,20923,861,40270,California
Madera,2021-03-27,938,59895,609,28139,306,30035,23,1721,410,19257,524,21447,434,40704,California
Madera,2021-03-28,442,60337,151,28290,231,30266,60,1781,207,19386,234,21681,363,41067,California
Madera,2021-03-29,702,61039,188,28478,484,30750,30,1811,500,19722,198,21879,534,41601,California
Madera,2021-03-30,1083,62122,611,29089,442,31192,30,1841,469,19612,609,22488,499,42100,California
Madera,2021-03-31,1403,63525,543,29632,730,31922,130,1971,420,19185,977,23465,550,42650,California
Madera,2021-04-01,1410,64935,629,30261,731,32653,50,2021,486,18806,913,24378,534,43184,California
Madera,2021-04-02,1611,66546,461,30722,1091,33744,59,2080,475,18216,1125,25503,535,43719,California
Madera,2021-04-03,964,67510,766,31488,179,33923,19,2099,394,18072,568,26071,424,44143,California
Madera,2021-04-04,185,67695,64,31552,119,34042,2,2101,84,18058,101,26172,87,44230,California
Madera,2021-04-05,742,68437,255,31807,429,34471,58,2159,341,18072,399,26571,413,44643,California
Madera,2021-04-06,1712,70149,888,32695,467,34938,357,2516,530,17779,1180,27751,887,45530,California
Madera,2021-04-07,1241,71390,390,33085,703,35641,148,2664,428,17551,809,28560,581,46111,California
Madera,2021-04-08,1744,73134,670,33755,810,36451,264,2928,561,17206,1175,29735,830,46941,California
Madera,2021-04-09,1666,74800,704,34459,815,37266,147,3075,956,17608,705,30440,1107,48048,California
Madera,2021-04-10,991,75791,695,35154,227,37493,69,3144,722,18129,271,30711,792,48840,California
Madera,2021-04-11,821,76612,668,35822,73,37566,80,3224,288,17965,530,31241,366,49206,California
Madera,2021-04-12,821,77433,296,36118,448,38014,77,3301,313,17849,507,31748,391,49597,California
Madera,2021-04-13,1261,78694,620,36738,598,38612,43,3344,731,18108,524,32272,783,50380,California
Madera,2021-04-14,1410,80104,869,37607,541,39153,0,3344,581,17868,827,33099,587,50967,California
Madera,2021-04-15,1192,81296,516,38123,675,39828,1,3345,427,17545,753,33852,430,51397,California
Madera,2021-04-16,1374,82670,546,38669,828,40656,0,3345,378,16942,984,34836,381,51778,California
Madera,2021-04-17,1302,83972,1095,39764,207,40863,0,3345,774,17192,524,35360,774,52552,California
Madera,2021-04-18,258,84230,220,39984,38,40901,0,3345,89,17117,164,35524,89,52641,California
Madera,2021-04-19,823,85053,248,40232,574,41475,1,3346,284,16868,533,36057,284,52925,California
Madera,2021-04-20,910,85963,456,40688,454,41929,0,3346,231,16426,675,36732,233,53158,California
Madera,2021-04-21,908,86871,499,41187,409,42338,0,3346,305,16132,601,37333,307,53465,California
Madera,2021-04-22,1119,87990,546,41733,573,42911,0,3346,387,15792,728,38061,388,53853,California
Madera,2021-04-23,1000,88990,323,42056,677,43588,0,3346,349,15495,646,38707,349,54202,California
Madera,2021-04-24,727,89717,473,42529,254,43842,0,3346,254,15280,470,39177,255,54457,California
Madera,2021-04-25,273,89990,163,42692,107,43949,3,3349,121,15257,148,39325,125,54582,California
Madera,2021-04-26,568,90558,110,42802,452,44401,6,3355,134,14966,431,39756,140,54722,California
Madera,2021-04-27,641,91199,285,43087,331,44732,25,3380,321,14996,317,40073,347,55069,California
Madera,2021-04-28,522,91721,210,43297,293,45025,19,3399,253,15001,266,40339,271,55340,California
Madera,2021-04-29,574,92295,254,43551,290,45315,30,3429,271,15007,296,40635,302,55642,California
Madera,2021-04-30,955,93250,517,44068,420,45735,18,3447,274,14625,675,41310,293,55935,California
Madera,2021-05-01,991,94241,891,44959,86,45821,14,3461,395,14440,594,41904,409,56344,California
Madera,2021-05-02,401,94642,352,45311,44,45865,5,3466,144,14332,257,42161,149,56493,California
Madera,2021-05-03,502,95144,202,45513,260,46125,40,3506,104,14081,395,42556,144,56637,California
Madera,2021-05-04,922,96066,452,45965,426,46551,44,3550,222,13647,700,43256,266,56903,California
Madera,2021-05-05,1041,97107,506,46471,475,47026,60,3610,280,13230,758,44014,341,57244,California
Madera,2021-05-06,723,97830,263,46734,427,47453,33,3643,166,12876,553,44567,199,57443,California
Madera,2021-05-07,825,98655,294,47028,510,47963,21,3664,200,12477,619,45186,220,57663,California
Madera,2021-05-08,978,99633,766,47794,202,48165,10,3674,185,11879,793,45979,195,57858,California
Madera,2021-05-09,148,99781,21,47815,116,48281,11,3685,35,11814,111,46090,46,57904,California
Madera,2021-05-10,371,100152,78,47893,278,48559,15,3700,104,11668,265,46355,119,58023,California
Madera,2021-05-11,549,100701,194,48087,346,48905,9,3709,178,11486,369,46724,187,58210,California
Madera,2021-05-12,515,101216,234,48321,244,49149,37,3746,127,11265,385,47109,164,58374,California
Madera,2021-05-13,525,101741,317,48638,176,49325,32,3778,181,11137,341,47450,213,58587,California
Madera,2021-05-14,540,102281,274,48912,242,49567,24,3802,237,11098,300,47750,261,58848,California
Madera,2021-05-15,568,102849,482,49394,77,49644,9,3811,366,11274,198,47948,374,59222,California
Madera,2021-05-16,256,103105,189,49583,35,49679,32,3843,105,11260,151,48099,137,59359,California
Madera,2021-05-17,458,103563,192,49775,236,49915,30,3873,202,11239,253,48352,232,59591,California
Madera,2021-05-18,557,104120,373,50148,160,50075,24,3897,292,11296,259,48611,316,59907,California
Madera,2021-05-19,494,104614,228,50376,244,50319,22,3919,219,11264,273,48884,241,60148,California
Madera,2021-05-20,597,105211,271,50647,289,50608,37,3956,233,11177,357,49241,270,60418,California
Madera,2021-05-21,512,105723,196,50843,287,50895,29,3985,196,11091,311,49552,225,60643,California
Madera,2021-05-22,906,106629,822,51665,72,50967,12,3997,532,11262,373,49925,544,61187,California
Madera,2021-05-23,269,106898,242,51907,17,50984,10,4007,143,11290,125,50050,153,61340,California
Madera,2021-05-24,308,107206,140,52047,127,51111,41,4048,118,11260,189,50239,159,61499,California
Madera,2021-05-25,383,107589,169,52216,181,51292,33,4081,150,11212,231,50470,183,61682,California
Madera,2021-05-26,444,108033,258,52474,164,51456,22,4103,237,11266,205,50675,259,61941,California
Madera,2021-05-27,378,108411,137,52611,204,51660,37,4140,127,11183,247,50922,164,62105,California
Madera,2021-05-28,452,108863,174,52785,250,51910,28,4168,174,11109,276,51198,202,62307,California
Madera,2021-05-29,306,109169,215,53000,73,51983,18,4186,166,11153,140,51338,184,62491,California
Madera,2021-05-30,59,109228,27,53027,28,52011,4,4190,27,11153,31,51369,31,62522,California
Madera,2021-05-31,26,109254,9,53036,13,52024,4,4194,11,11153,15,51384,15,62537,California
Madera,2021-06-01,291,109545,146,53182,122,52146,23,4217,106,11099,183,51567,129,62666,California
Madera,2021-06-02,395,109940,125,53307,247,52393,23,4240,114,10956,280,51847,137,62803,California
Madera,2021-06-03,282,110222,150,53457,117,52510,15,4255,90,10869,192,52039,105,62908,California
Madera,2021-06-04,381,110603,245,53702,125,52635,11,4266,150,10800,230,52269,161,63069,California
Madera,2021-06-05,517,111120,392,54094,112,52747,13,4279,151,10604,360,52629,164,63233,California
Madera,2021-06-06,136,111256,116,54210,13,52760,7,4286,38,10551,98,52727,45,63278,California
Madera,2021-06-07,252,111508,157,54367,74,52834,21,4307,45,10411,206,52933,66,63344,California
Madera,2021-06-08,388,111896,274,54641,93,52927,21,4328,97,10238,291,53224,118,63462,California
Madera,2021-06-09,378,112274,240,54881,111,53038,27,4355,145,10179,231,53455,172,63634,California
Madera,2021-06-10,346,112620,199,55080,131,53169,16,4371,118,10087,226,53681,134,63768,California
Madera,2021-06-11,384,113004,221,55301,130,53299,33,4404,169,10073,214,53895,200,63968,California
Madera,2021-06-12,579,113583,509,55810,54,53353,16,4420,95,9700,484,54379,111,64079,California
Madera,2021-06-13,195,113778,162,55972,28,53381,5,4425,55,9621,139,54518,60,64139,California
Madera,2021-06-14,228,114006,161,56133,44,53425,23,4448,91,9600,134,54652,113,64252,California
Madera,2021-06-15,365,114371,252,56385,80,53505,33,4481,155,9582,206,54858,188,64440,California
Madera,2021-06-16,328,114699,251,56636,63,53568,14,4495,118,9508,206,55064,132,64572,California
Madera,2021-06-17,262,114961,130,56766,123,53691,9,4504,96,9448,165,55229,105,64677,California
Madera,2021-06-18,280,115241,177,56943,79,53770,24,4528,121,9434,158,55387,144,64821,California
Madera,2021-06-19,249,115490,201,57144,40,53810,8,4536,82,9357,167,55554,90,64911,California
Madera,2021-06-20,57,115547,46,57190,3,53813,8,4544,28,9364,29,55583,36,64947,California
Madera,2021-06-21,169,115716,83,57273,61,53874,25,4569,76,9373,92,55675,101,65048,California
Madera,2021-06-22,240,115956,159,57432,62,53936,19,4588,117,9388,121,55796,136,65184,California
Madera,2021-06-23,265,116221,191,57623,64,54000,10,4598,141,9415,124,55920,151,65335,California
Madera,2021-06-24,218,116439,101,57724,95,54095,22,4620,80,9380,137,56057,102,65437,California
Madera,2021-06-25,261,116700,168,57892,69,54164,24,4644,100,9346,158,56215,124,65561,California
Madera,2021-06-26,186,116886,138,58030,34,54198,14,4658,78,9330,108,56323,92,65653,California
Madera,2021-06-27,116,117002,91,58121,21,54219,4,4662,63,9344,53,56376,67,65720,California
Madera,2021-06-28,160,117162,97,58218,43,54262,20,4682,84,9373,75,56451,104,65824,California
Madera,2021-06-29,214,117376,152,58370,45,54307,17,4699,101,9379,112,56563,118,65942,California
Madera,2021-06-30,218,117594,145,58515,66,54373,7,4706,125,9421,91,56654,133,66075,California
Madera,2021-07-01,189,117783,119,58634,46,54419,24,4730,78,9413,110,56764,102,66177,California
Madera,2021-07-02,233,118016,174,58808,42,54461,17,4747,97,9391,136,56900,114,66291,California
Madera,2021-07-03,164,118180,114,58922,41,54502,9,4756,76,9391,85,56985,85,66376,California
Madera,2021-07-04,10,118190,0,58922,6,54508,4,4760,6,9397,4,56989,10,66386,California
Madera,2021-07-05,116,118306,98,59020,9,54517,9,4769,54,9399,61,57050,63,66449,California
Madera,2021-07-06,348,118654,250,59270,72,54589,26,4795,139,9355,208,57258,164,66613,California
Madera,2021-07-07,213,118867,150,59420,47,54636,16,4811,101,9360,112,57370,117,66730,California
Madera,2021-07-08,204,119071,128,59548,61,54697,15,4826,113,9398,90,57460,128,66858,California
Madera,2021-07-09,278,119349,204,59752,59,54756,15,4841,147,9430,129,57589,161,67019,California
Madera,2021-07-10,160,119509,121,59873,35,54791,4,4845,82,9440,77,57666,87,67106,California
Madera,2021-07-11,71,119580,54,59927,12,54803,5,4850,35,9444,36,57702,40,67146,California
Madera,2021-07-12,132,119712,98,60025,28,54831,6,4856,65,9448,67,57769,71,67217,California
Madera,2021-07-13,192,119904,150,60175,31,54862,11,4867,98,9464,93,57862,109,67326,California
Madera,2021-07-14,166,120070,123,60298,39,54901,4,4871,70,9443,95,57957,74,67400,California
Madera,2021-07-15,141,120211,87,60385,48,54949,6,4877,86,9480,55,58012,92,67492,California
Madera,2021-07-16,178,120389,135,60520,40,54989,3,4880,94,9494,83,58095,97,67589,California
Madera,2021-07-17,127,120516,98,60618,20,55009,9,4889,58,9493,69,58164,68,67657,California
Madera,2021-07-18,101,120617,87,60705,11,55020,3,4892,57,9509,44,58208,60,67717,California
Madera,2021-07-19,170,120787,133,60838,34,55054,3,4895,99,9541,70,58278,102,67819,California
Madera,2021-07-20,246,121033,178,61016,55,55109,13,4908,126,9562,118,58396,139,67958,California
Madera,2021-07-21,265,121298,175,61191,72,55181,18,4926,138,9593,125,58521,156,68114,California
Madera,2021-07-22,156,121454,110,61301,41,55222,5,4931,86,9616,68,58589,91,68205,California
Madera,2021-07-23,215,121669,164,61465,39,55261,12,4943,125,9663,90,58679,137,68342,California
Madera,2021-07-24,205,121874,156,61621,46,55307,3,4946,118,9699,85,58764,121,68463,California
Madera,2021-07-25,96,121970,75,61696,19,55326,2,4948,73,9751,23,58787,75,68538,California
Madera,2021-07-26,212,122182,141,61837,52,55378,19,4967,126,9810,86,58873,145,68683,California
Madera,2021-07-27,281,122463,214,62051,53,55431,14,4981,177,9897,103,58976,190,68873,California
Madera,2021-07-28,295,122758,189,62240,80,55511,26,5007,170,9969,124,59100,196,69069,California
Madera,2021-07-29,242,123000,183,62423,51,55562,8,5015,142,10020,99,59199,150,69219,California
Madera,2021-07-30,335,123335,254,62677,59,55621,22,5037,198,10105,135,59334,220,69439,California
Madera,2021-07-31,186,123521,137,62814,34,55655,15,5052,112,10158,74,59408,127,69566,California
Marin,2020-12-15,2,2,2,2,0,0,0,0,2,2,0,0,2,2,California
Marin,2020-12-16,110,112,110,112,0,0,0,0,110,112,0,0,110,112,California
Marin,2020-12-17,273,385,273,385,0,0,0,0,273,385,0,0,273,385,California
Marin,2020-12-18,389,774,389,774,0,0,0,0,389,774,0,0,389,774,California
Marin,2020-12-19,349,1123,348,1122,1,1,0,0,349,1123,0,0,349,1123,California
Marin,2020-12-20,164,1287,163,1285,1,2,0,0,164,1287,0,0,164,1287,California
Marin,2020-12-21,236,1523,233,1518,3,5,0,0,236,1523,0,0,236,1523,California
Marin,2020-12-22,515,2038,312,1830,203,208,0,0,515,2038,0,0,515,2038,California
Marin,2020-12-23,725,2763,312,2142,413,621,0,0,725,2763,0,0,725,2763,California
Marin,2020-12-24,358,3121,158,2300,200,821,0,0,358,3121,0,0,358,3121,California
Marin,2020-12-25,26,3147,0,2300,26,847,0,0,26,3147,0,0,26,3147,California
Marin,2020-12-26,144,3291,95,2395,49,896,0,0,144,3291,0,0,144,3291,California
Marin,2020-12-27,89,3380,53,2448,36,932,0,0,89,3380,0,0,89,3380,California
Marin,2020-12-28,404,3784,97,2545,307,1239,0,0,404,3784,0,0,404,3784,California
Marin,2020-12-29,400,4184,89,2634,311,1550,0,0,400,4184,0,0,400,4184,California
Marin,2020-12-30,628,4812,388,3022,240,1790,0,0,628,4812,0,0,628,4812,California
Marin,2020-12-31,202,5014,36,3058,166,1956,0,0,201,5012,1,1,201,5013,California
Marin,2021-01-01,33,5047,15,3073,18,1974,0,0,33,5045,0,1,33,5046,California
Marin,2021-01-02,111,5158,106,3179,5,1979,0,0,111,5156,0,1,111,5157,California
Marin,2021-01-03,48,5206,30,3209,18,1997,0,0,44,5200,0,1,44,5201,California
Marin,2021-01-04,298,5504,193,3402,105,2102,0,0,297,5496,1,2,297,5498,California
Marin,2021-01-05,371,5875,222,3624,149,2251,0,0,328,5781,43,45,328,5826,California
Marin,2021-01-06,818,6693,316,3940,502,2753,0,0,636,6235,182,227,636,6462,California
Marin,2021-01-07,879,7572,493,4433,386,3139,0,0,524,6405,355,582,525,6987,California
Marin,2021-01-08,972,8544,515,4948,457,3596,0,0,583,6600,388,970,583,7570,California
Marin,2021-01-09,624,9168,223,5171,401,3997,0,0,494,6964,130,1100,494,8064,California
Marin,2021-01-10,131,9299,102,5273,29,4026,0,0,57,6947,74,1174,57,8121,California
Marin,2021-01-11,472,9771,329,5602,143,4169,0,0,252,6981,220,1394,254,8375,California
Marin,2021-01-12,929,10700,535,6137,394,4563,0,0,568,7191,358,1752,568,8943,California
Marin,2021-01-13,1176,11876,503,6640,673,5236,0,0,942,7899,234,1986,942,9885,California
Marin,2021-01-14,1066,12942,315,6955,751,5987,0,0,918,8671,146,2132,918,10803,California
Marin,2021-01-15,1166,14108,352,7307,814,6801,0,0,1035,9578,130,2262,1037,11840,California
Marin,2021-01-16,1121,15229,912,8219,209,7010,0,0,1045,10547,76,2338,1045,12885,California
Marin,2021-01-17,1231,16460,1113,9332,118,7128,0,0,1201,11722,29,2367,1204,14089,California
Marin,2021-01-18,363,16823,160,9492,203,7331,0,0,315,11989,48,2415,315,14404,California
Marin,2021-01-19,1155,17978,906,10398,249,7580,0,0,983,12801,171,2586,983,15387,California
Marin,2021-01-20,1810,19788,1215,11613,595,8175,0,0,1077,13158,721,3307,1078,16465,California
Marin,2021-01-21,1687,21475,1068,12681,619,8794,0,0,1328,14133,356,3663,1331,17796,California
Marin,2021-01-22,1720,23195,1098,13779,622,9416,0,0,1547,15508,173,3836,1548,19344,California
Marin,2021-01-23,1861,25056,1355,15134,506,9922,0,0,1771,17189,90,3926,1771,21115,California
Marin,2021-01-24,620,25676,167,15301,453,10375,0,0,586,17741,34,3960,586,21701,California
Marin,2021-01-25,1123,26799,232,15533,891,11266,0,0,684,17987,439,4399,685,22386,California
Marin,2021-01-26,1517,28316,776,16309,741,12007,0,0,1135,18741,381,4780,1135,23521,California
Marin,2021-01-27,1720,30036,890,17199,830,12837,0,0,1351,19726,367,5147,1352,24873,California
Marin,2021-01-28,2075,32111,1069,18268,1006,13843,0,0,1811,21275,263,5410,1812,26685,California
Marin,2021-01-29,2215,34326,1437,19705,778,14621,0,0,2016,23106,186,5596,2017,28702,California
Marin,2021-01-30,1721,36047,915,20620,806,15427,0,0,1642,24669,79,5675,1642,30344,California
Marin,2021-01-31,455,36502,319,20939,136,15563,0,0,428,25070,27,5702,428,30772,California
Marin,2021-02-01,1100,37602,418,21357,682,16245,0,0,898,25769,200,5902,899,31671,California
Marin,2021-02-02,1426,39028,494,21851,932,17177,0,0,757,25868,658,6560,757,32428,California
Marin,2021-02-03,1809,40837,436,22287,1373,18550,0,0,1288,26637,519,7079,1288,33716,California
Marin,2021-02-04,1598,42435,507,22794,1091,19641,0,0,990,27022,605,7684,990,34706,California
Marin,2021-02-05,2177,44612,671,23465,1506,21147,0,0,1337,27523,836,8520,1337,36043,California
Marin,2021-02-06,1428,46040,839,24304,589,21736,0,0,600,27298,825,9345,600,36643,California
Marin,2021-02-07,1306,47346,1020,25324,286,22022,0,0,496,26985,809,10154,496,37139,California
Marin,2021-02-08,1554,48900,769,26093,785,22807,0,0,738,26910,813,10967,738,37877,California
Marin,2021-02-09,1790,50690,1123,27216,667,23474,0,0,843,26807,946,11913,843,38720,California
Marin,2021-02-10,2354,53044,1500,28716,854,24328,0,0,1223,26902,1129,13042,1224,39944,California
Marin,2021-02-11,2885,55929,1651,30367,1234,25562,0,0,1456,26938,1424,14466,1460,41404,California
Marin,2021-02-12,3090,59019,1549,31916,1541,27103,0,0,1561,26975,1525,15991,1562,42966,California
Marin,2021-02-13,2341,61360,1248,33164,1093,28196,0,0,1124,26884,1215,17206,1124,44090,California
Marin,2021-02-14,831,62191,311,33475,520,28716,0,0,737,27528,94,17300,738,44828,California
Marin,2021-02-15,1236,63427,368,33843,868,29584,0,0,847,27989,387,17687,848,45676,California
Marin,2021-02-16,2494,65921,1063,34906,1431,31015,0,0,1517,28530,976,18663,1517,47193,California
Marin,2021-02-17,2123,68044,946,35852,1177,32192,0,0,1103,28616,1017,19680,1103,48296,California
Marin,2021-02-18,2431,70475,1599,37451,832,33024,0,0,1066,28324,1358,21038,1066,49362,California
Marin,2021-02-19,2815,73290,2195,39646,620,33644,0,0,1251,28028,1548,22586,1252,50614,California
Marin,2021-02-20,2676,75966,2193,41839,483,34127,0,0,1260,27881,1409,23995,1262,51876,California
Marin,2021-02-21,1363,77329,1155,42994,208,34335,0,0,958,28439,400,24395,958,52834,California
Marin,2021-02-22,1904,79233,1466,44460,438,34773,0,0,1252,29043,648,25043,1252,54086,California
Marin,2021-02-23,2984,82217,1708,46168,1276,36049,0,0,2001,30078,967,26010,2002,56088,California
Marin,2021-02-24,3657,85874,1686,47854,1971,38020,0,0,2344,31122,1301,27311,2345,58433,California
Marin,2021-02-25,4212,90086,1975,49829,2237,40257,0,0,2969,32864,1229,28540,2971,61404,California
Marin,2021-02-26,3804,93890,2071,51900,1733,41990,0,0,2741,34555,1051,29591,2742,64146,California
Marin,2021-02-27,2770,96660,1633,53533,1137,43127,0,0,1917,35627,847,30438,1919,66065,California
Marin,2021-02-28,1698,98358,961,54494,737,43864,0,0,1336,36606,357,30795,1336,67401,California
Marin,2021-03-01,2753,101111,1704,56198,1048,44912,1,1,1841,37553,896,31691,1843,69244,California
Marin,2021-03-02,2590,103701,1726,57924,864,45776,0,1,1759,38488,825,32516,1760,71004,California
Marin,2021-03-03,4484,108185,2485,60409,1995,47771,4,5,2907,39827,1572,34088,2911,73915,California
Marin,2021-03-04,3457,111642,1705,62114,1751,49522,1,6,2349,41079,1101,35189,2353,76268,California
Marin,2021-03-05,3105,114747,1184,63298,1908,51430,13,19,1807,41606,1293,36482,1820,78088,California
Marin,2021-03-06,3260,118007,2338,65636,844,52274,78,97,2671,43773,582,37064,2749,80837,California
Marin,2021-03-07,1442,119449,1186,66822,206,52480,50,147,1003,44391,434,37498,1052,81889,California
Marin,2021-03-08,1914,121363,1394,68216,394,52874,126,273,1417,45439,493,37991,1541,83430,California
Marin,2021-03-09,2247,123610,1346,69562,787,53661,114,387,1551,46406,692,38683,1659,85089,California
Marin,2021-03-10,4491,128101,2521,72083,1673,55334,297,684,3234,48683,1251,39934,3528,88617,California
Marin,2021-03-11,4606,132707,1896,73979,2576,57910,134,818,3300,50819,1297,41231,3433,92050,California
Marin,2021-03-12,3989,136696,1553,75532,2084,59994,352,1170,1552,50300,2420,43651,1901,93951,California
Marin,2021-03-13,4109,140805,2875,78407,1163,61157,71,1241,2387,51036,1713,45364,2449,96400,California
Marin,2021-03-14,2299,143104,1110,79517,1074,62231,115,1356,708,50266,1589,46953,819,97219,California
Marin,2021-03-15,3245,146349,1773,81290,1426,63657,46,1402,1185,49458,2041,48994,1233,98452,California
Marin,2021-03-16,4289,150638,2315,83605,1607,65264,367,1769,1429,48395,2855,51849,1792,100244,California
Marin,2021-03-17,4219,154857,2296,85901,1874,67138,49,1818,2022,48283,2182,54031,2070,102314,California
Marin,2021-03-18,4502,159359,2277,88178,2150,69288,75,1893,2102,48075,2382,56413,2174,104488,California
Marin,2021-03-19,4489,163848,2299,90477,1970,71258,220,2113,2299,48410,2178,58591,2513,107001,California
Marin,2021-03-20,3596,167444,1998,92475,1490,72748,108,2221,1926,48784,1657,60248,2031,109032,California
Marin,2021-03-21,1549,168993,1154,93629,373,73121,22,2243,785,48829,761,61009,806,109838,California
Marin,2021-03-22,2503,171496,2165,95794,170,73291,168,2411,899,48298,1596,62605,1065,110903,California
Marin,2021-03-23,4326,175822,2269,98063,1929,75220,128,2539,1883,47875,2434,65039,2011,112914,California
Marin,2021-03-24,4501,180323,2925,100988,1465,76685,111,2650,1774,47046,2712,67751,1883,114797,California
Marin,2021-03-25,4679,185002,2848,103836,1758,78443,73,2723,2204,46862,2458,70209,2274,117071,California
Marin,2021-03-26,4339,189341,2366,106202,1760,80203,213,2936,2387,47528,1934,72143,2600,119671,California
Marin,2021-03-27,3714,193055,2671,108873,1026,81229,17,2953,1128,46097,2575,74718,1144,120815,California
Marin,2021-03-28,2398,195453,1725,110598,667,81896,6,2959,835,45383,1555,76273,841,121656,California
Marin,2021-03-29,2712,198165,2113,112711,574,82470,25,2984,1142,44985,1565,77838,1167,122823,California
Marin,2021-03-30,4680,202845,3660,116371,987,83457,33,3017,2955,46251,1723,79561,2989,125812,California
Marin,2021-03-31,5873,208718,4162,120533,1660,85117,51,3068,2528,45496,3333,82894,2578,128390,California
Marin,2021-04-01,4480,213198,2298,122831,1928,87045,254,3322,2120,45519,2344,85238,2367,130757,California
Marin,2021-04-02,3740,216938,1855,124686,1514,88559,371,3693,1993,46132,1739,86977,2352,133109,California
Marin,2021-04-03,3864,220802,2516,127202,969,89528,379,4072,1461,45576,2391,89368,1835,134944,California
Marin,2021-04-04,1643,222445,1242,128444,201,89729,200,4272,1202,46535,439,89807,1398,136342,California
Marin,2021-04-05,2226,224671,1543,129987,304,90033,379,4651,1287,47263,934,90741,1662,138004,California
Marin,2021-04-06,4006,228677,2120,132107,1321,91354,565,5216,2219,48264,1778,92519,2779,140783,California
Marin,2021-04-07,3969,232646,1995,134102,1328,92682,646,5862,1432,47809,2528,95047,2073,142856,California
Marin,2021-04-08,5065,237711,1974,136076,2481,95163,610,6472,2308,47970,2744,97791,2905,145761,California
Marin,2021-04-09,4025,241736,1573,137649,1711,96874,741,7213,1334,47352,2684,100475,2066,147827,California
Marin,2021-04-10,3228,244964,1488,139137,1301,98175,439,7652,1453,47479,1759,102234,1886,149713,California
Marin,2021-04-11,1069,246033,816,139953,91,98266,162,7814,477,47527,589,102823,637,150350,California
Marin,2021-04-12,1741,247774,1239,141192,342,98608,160,7974,921,47790,818,103641,1081,151431,California
Marin,2021-04-13,3791,251565,2331,143523,1453,100061,7,7981,1373,46765,2405,106046,1380,152811,California
Marin,2021-04-14,4248,255813,2554,146077,1691,101752,3,7984,1735,46013,2488,108534,1736,154547,California
Marin,2021-04-15,5651,261464,3994,150071,1657,103409,0,7984,3227,46834,2407,110941,3228,157775,California
Marin,2021-04-16,4314,265778,2256,152327,2055,105464,3,7987,2093,46726,2205,113146,2097,159872,California
Marin,2021-04-17,3595,269373,2185,154512,1410,106874,0,7987,1791,46722,1797,114943,1793,161665,California
Marin,2021-04-18,3238,272611,3147,157659,91,106965,0,7987,2558,48603,677,115620,2558,164223,California
Marin,2021-04-19,2055,274666,1882,159541,172,107137,1,7988,1127,48813,920,116540,1130,165353,California
Marin,2021-04-20,3783,278449,2628,162169,1155,108292,0,7988,1464,47971,2308,118848,1466,166819,California
Marin,2021-04-21,4154,282603,3064,165233,1087,109379,3,7991,1382,46601,2753,121601,1383,168202,California
Marin,2021-04-22,4332,286935,3308,168541,1024,110403,0,7991,1503,45293,2815,124416,1507,169709,California
Marin,2021-04-23,3349,290284,1896,170437,1453,111856,0,7991,1267,44494,2067,126483,1268,170977,California
Marin,2021-04-24,2543,292827,1700,172137,843,112699,0,7991,921,43808,1608,128091,922,171899,California
Marin,2021-04-25,1399,294226,1280,173417,119,112818,0,7991,302,43022,1088,129179,302,172201,California
Marin,2021-04-26,1678,295904,1440,174857,235,113053,3,7994,401,42155,1273,130452,406,172607,California
Marin,2021-04-27,3107,299011,2242,177099,815,113868,50,8044,1015,41133,2082,132534,1060,173667,California
Marin,2021-04-28,2378,301389,1635,178734,689,114557,54,8098,743,40298,1631,134165,796,174463,California
Marin,2021-04-29,2952,304341,2024,180758,865,115422,63,8161,819,39060,2122,136287,884,175347,California
Marin,2021-04-30,2007,306348,1305,182063,615,116037,87,8248,708,38567,1289,137576,796,176143,California
Marin,2021-05-01,1870,308218,1036,183099,810,116847,24,8272,554,37838,1306,138882,577,176720,California
Marin,2021-05-02,739,308957,594,183693,115,116962,30,8302,200,37535,532,139414,229,176949,California
Marin,2021-05-03,1235,310192,1004,184697,173,117135,58,8360,256,36872,976,140390,313,177262,California
Marin,2021-05-04,3004,313196,2020,186717,890,118025,94,8454,482,34936,2512,142902,576,177838,California
Marin,2021-05-05,2819,316015,2051,188768,642,118667,126,8580,457,33165,2353,145255,582,178420,California
Marin,2021-05-06,3318,319333,2574,191342,655,119322,89,8669,432,30808,2875,148130,518,178938,California
Marin,2021-05-07,2062,321395,1550,192892,426,119748,86,8755,382,29600,1674,149804,466,179404,California
Marin,2021-05-08,2522,323917,1900,194792,500,120248,122,8877,350,27910,2163,151967,473,179877,California
Marin,2021-05-09,993,324910,902,195694,72,120320,19,8896,113,27166,877,152844,133,180010,California
Marin,2021-05-10,1439,326349,1178,196872,191,120511,70,8966,208,26217,1226,154070,277,180287,California
Marin,2021-05-11,2360,328709,1873,198745,430,120941,57,9023,307,24533,2047,156117,363,180650,California
Marin,2021-05-12,1860,330569,1466,200211,324,121265,70,9093,298,23343,1555,157672,365,181015,California
Marin,2021-05-13,2675,333244,2289,202500,331,121596,55,9148,1418,23568,1248,158920,1473,182488,California
Marin,2021-05-14,2238,335482,1464,203964,673,122269,101,9249,887,23212,1343,160263,987,183475,California
Marin,2021-05-15,2759,338241,2282,206246,396,122665,81,9330,1674,23884,1082,161345,1754,185229,California
Marin,2021-05-16,1736,339977,1675,207921,53,122718,8,9338,1407,24972,327,161672,1415,186644,California
Marin,2021-05-17,2146,342123,1997,209918,106,122824,43,9381,1710,26297,429,162101,1754,188398,California
Marin,2021-05-18,1536,343659,1191,211109,289,123113,56,9437,792,26406,737,162838,846,189244,California
Marin,2021-05-19,1564,345223,1241,212350,252,123365,71,9508,774,26465,784,163622,843,190087,California
Marin,2021-05-20,1841,347064,1498,213848,258,123623,85,9593,753,26229,1076,164698,840,190927,California
Marin,2021-05-21,1470,348534,846,214694,574,124197,50,9643,436,25689,1026,165724,486,191413,California
Marin,2021-05-22,1433,349967,1089,215783,287,124484,57,9700,965,26249,462,166186,1022,192435,California
Marin,2021-05-23,483,350450,429,216212,42,124526,12,9712,225,26231,256,166442,238,192673,California
Marin,2021-05-24,662,351112,494,216706,127,124653,41,9753,353,26319,305,166747,393,193066,California
Marin,2021-05-25,997,352109,621,217327,330,124983,46,9799,311,25997,676,167423,354,193420,California
Marin,2021-05-26,717,352826,485,217812,183,125166,49,9848,263,25860,449,167872,312,193732,California
Marin,2021-05-27,1029,353855,658,218470,290,125456,81,9929,337,25589,689,168561,418,194150,California
Marin,2021-05-28,1103,354958,715,219185,309,125765,79,10008,327,25222,772,169333,405,194555,California
Marin,2021-05-29,378,355336,219,219404,149,125914,10,10018,205,25264,173,169506,215,194770,California
Marin,2021-05-30,99,355435,58,219462,36,125950,5,10023,56,25283,42,169548,61,194831,California
Marin,2021-05-31,29,355464,14,219476,14,125964,1,10024,15,25285,14,169562,16,194847,California
Marin,2021-06-01,755,356219,549,220025,161,126125,45,10069,317,25213,434,169996,362,195209,California
Marin,2021-06-02,631,356850,481,220506,98,126223,52,10121,218,25072,409,170405,268,195477,California
Marin,2021-06-03,1501,358351,1329,221835,114,126337,58,10179,234,24099,1265,171670,292,195769,California
Marin,2021-06-04,1037,359388,863,222698,139,126476,35,10214,182,23465,849,172519,215,195984,California
Marin,2021-06-05,1931,361319,1713,224411,170,126646,48,10262,318,22226,1605,174124,366,196350,California
Marin,2021-06-06,1419,362738,1372,225783,13,126659,34,10296,152,21146,1266,175390,186,196536,California
Marin,2021-06-07,1943,364681,1827,227610,66,126725,50,10346,240,19740,1696,177086,290,196826,California
Marin,2021-06-08,978,365659,867,228477,70,126795,41,10387,229,19268,742,177828,270,197096,California
Marin,2021-06-09,744,366403,670,229147,65,126860,9,10396,139,18810,605,178433,147,197243,California
Marin,2021-06-10,891,367294,777,229924,63,126923,51,10447,178,18330,709,179142,229,197472,California
Marin,2021-06-11,699,367993,584,230508,83,127006,32,10479,147,17959,550,179692,179,197651,California
Marin,2021-06-12,924,368917,793,231301,88,127094,43,10522,152,17383,771,180463,195,197846,California
Marin,2021-06-13,418,369335,385,231686,21,127115,12,10534,65,17111,349,180812,77,197923,California
Marin,2021-06-14,878,370213,748,232434,82,127197,48,10582,217,16717,656,181468,262,198185,California
Marin,2021-06-15,557,370770,443,232877,88,127285,26,10608,178,16544,377,181845,204,198389,California
Marin,2021-06-16,497,371267,404,233281,45,127330,48,10656,162,16424,328,182173,208,198597,California
Marin,2021-06-17,556,371823,477,233758,48,127378,31,10687,192,16286,360,182533,222,198819,California
Marin,2021-06-18,497,372320,384,234142,76,127454,37,10724,172,16177,317,182850,208,199027,California
Marin,2021-06-19,366,372686,294,234436,36,127490,36,10760,143,16132,222,183072,177,199204,California
Marin,2021-06-20,114,372800,88,234524,15,127505,11,10771,48,16125,66,183138,59,199263,California
Marin,2021-06-21,349,373149,247,234771,47,127552,55,10826,139,16110,209,183347,194,199457,California
Marin,2021-06-22,452,373601,352,235123,69,127621,31,10857,141,15975,307,183654,172,199629,California
Marin,2021-06-23,361,373962,297,235420,32,127653,32,10889,123,15892,237,183891,154,199783,California
Marin,2021-06-24,398,374360,304,235724,44,127697,50,10939,132,15810,262,184153,180,199963,California
Marin,2021-06-25,382,374742,277,236001,60,127757,45,10984,173,15821,207,184360,218,200181,California
Marin,2021-06-26,324,375066,272,236273,20,127777,32,11016,118,15766,205,184565,150,200331,California
Marin,2021-06-27,212,375278,163,236436,23,127800,26,11042,70,15721,140,184705,95,200426,California
Marin,2021-06-28,398,375676,338,236774,32,127832,28,11070,137,15627,259,184964,165,200591,California
Marin,2021-06-29,441,376117,345,237119,57,127889,39,11109,155,15538,283,185247,194,200785,California
Marin,2021-06-30,272,376389,231,237350,26,127915,15,11124,115,15513,155,185402,130,200915,California
Marin,2021-07-01,273,376662,205,237555,48,127963,20,11144,107,15476,164,185566,127,201042,California
Marin,2021-07-02,374,377036,293,237848,44,128007,37,11181,148,15438,222,185788,184,201226,California
Marin,2021-07-03,272,377308,221,238069,21,128028,30,11211,114,15424,158,185946,144,201370,California
Marin,2021-07-05,117,377425,90,238159,11,128039,16,11227,41,15405,75,186021,56,201426,California
Marin,2021-07-06,449,377874,351,238510,56,128095,42,11269,159,15320,284,186305,199,201625,California
Marin,2021-07-07,230,378104,188,238698,28,128123,14,11283,93,15291,134,186439,105,201730,California
Marin,2021-07-08,284,378388,226,238924,37,128160,21,11304,101,15234,179,186618,122,201852,California
Marin,2021-07-09,340,378728,273,239197,33,128193,34,11338,140,15209,198,186816,173,202025,California
Marin,2021-07-10,295,379023,236,239433,24,128217,35,11373,117,15183,178,186994,152,202177,California
Marin,2021-07-11,100,379123,78,239511,8,128225,14,11387,32,15160,68,187062,45,202222,California
Marin,2021-07-12,396,379519,293,239804,46,128271,57,11444,130,15086,262,187324,188,202410,California
Marin,2021-07-13,254,379773,194,239998,31,128302,29,11473,98,15061,151,187475,126,202536,California
Marin,2021-07-14,172,379945,128,240126,31,128333,13,11486,68,15042,99,187574,80,202616,California
Marin,2021-07-15,297,380242,229,240355,37,128370,31,11517,134,15049,157,187731,164,202780,California
Marin,2021-07-16,324,380566,244,240599,56,128426,24,11541,128,15008,192,187923,151,202931,California
Marin,2021-07-17,207,380773,168,240767,22,128448,17,11558,86,14990,121,188044,103,203034,California
Marin,2021-07-18,125,380898,91,240858,12,128460,22,11580,57,15002,67,188111,79,203113,California
Marin,2021-07-19,309,381207,256,241114,36,128496,17,11597,140,14998,160,188271,156,203269,California
Marin,2021-07-20,362,381569,277,241391,54,128550,31,11628,163,15002,190,188461,194,203463,California
Marin,2021-07-21,234,381803,187,241578,36,128586,11,11639,122,15027,107,188568,132,203595,California
Marin,2021-07-22,302,382105,215,241793,51,128637,36,11675,146,15059,150,188718,182,203777,California
Marin,2021-07-23,303,382408,236,242029,52,128689,15,11690,148,15071,151,188869,163,203940,California
Marin,2021-07-24,235,382643,205,242234,16,128705,14,11704,100,15056,129,188998,114,204054,California
Marin,2021-07-25,66,382709,47,242281,12,128717,7,11711,41,15080,22,189020,46,204100,California
Marin,2021-07-26,242,382951,167,242448,48,128765,27,11738,148,15163,91,189111,174,204274,California
Marin,2021-07-27,303,383254,236,242684,43,128808,24,11762,158,15203,142,189253,182,204456,California
Marin,2021-07-28,225,383479,179,242863,26,128834,20,11782,123,15247,99,189352,143,204599,California
Marin,2021-07-29,266,383745,197,243060,46,128880,23,11805,122,15253,137,189489,143,204742,California
Marin,2021-07-30,325,384070,242,243302,54,128934,29,11834,172,15309,144,189633,200,204942,California
Marin,2021-07-31,213,384283,173,243475,14,128948,26,11860,92,15307,118,189751,116,205058,California
Mariposa,2020-12-17,39,39,39,39,0,0,0,0,41,41,0,0,41,41,California
Mariposa,2020-12-18,55,94,55,94,0,0,0,0,56,97,0,0,56,97,California
Mariposa,2020-12-20,2,96,2,96,0,0,0,0,2,99,0,0,2,99,California
Mariposa,2020-12-21,49,145,49,145,0,0,0,0,53,152,0,0,53,152,California
Mariposa,2020-12-22,6,151,6,151,0,0,0,0,6,158,0,0,6,158,California
Mariposa,2020-12-23,17,168,17,168,0,0,0,0,17,175,0,0,17,175,California
Mariposa,2020-12-24,1,169,0,168,1,1,0,0,0,175,1,1,1,176,California
Mariposa,2020-12-26,1,170,1,169,0,1,0,0,1,176,0,1,1,177,California
Mariposa,2020-12-27,1,171,0,169,1,2,0,0,1,177,0,1,1,178,California
Mariposa,2020-12-28,6,177,3,172,3,5,0,0,6,183,0,1,6,184,California
Mariposa,2020-12-29,34,211,3,175,31,36,0,0,34,217,0,1,34,218,California
Mariposa,2020-12-30,26,237,4,179,22,58,0,0,26,243,0,1,26,244,California
Mariposa,2020-12-31,17,254,0,179,17,75,0,0,17,260,0,1,17,261,California
Mariposa,2021-01-01,1,255,0,179,1,76,0,0,1,261,0,1,1,262,California
Mariposa,2021-01-02,1,256,1,180,0,76,0,0,1,262,0,1,1,263,California
Mariposa,2021-01-04,11,267,2,182,9,85,0,0,11,273,0,1,11,274,California
Mariposa,2021-01-05,25,292,15,197,10,95,0,0,15,278,10,11,15,289,California
Mariposa,2021-01-06,8,300,5,202,3,98,0,0,5,280,3,14,5,294,California
Mariposa,2021-01-07,51,351,46,248,5,103,0,0,5,239,46,60,5,299,California
Mariposa,2021-01-08,111,462,80,328,31,134,0,0,35,198,76,136,35,334,California
Mariposa,2021-01-11,33,495,11,339,22,156,0,0,25,215,8,144,25,359,California
Mariposa,2021-01-12,19,514,4,343,15,171,0,0,15,226,4,148,15,374,California
Mariposa,2021-01-13,23,537,5,348,18,189,0,0,19,241,4,152,19,393,California
Mariposa,2021-01-14,76,613,7,355,69,258,0,0,70,305,6,158,70,463,California
Mariposa,2021-01-15,68,681,27,382,41,299,0,0,58,353,10,168,58,521,California
Mariposa,2021-01-16,14,695,2,384,12,311,0,0,13,365,1,169,13,534,California
Mariposa,2021-01-17,6,701,1,385,5,316,0,0,5,369,1,170,5,539,California
Mariposa,2021-01-18,5,706,4,389,1,317,0,0,3,370,2,172,3,542,California
Mariposa,2021-01-19,8,714,5,394,3,320,0,0,5,373,2,174,5,547,California
Mariposa,2021-01-20,24,738,1,395,23,343,0,0,23,395,1,175,23,570,California
Mariposa,2021-01-21,66,804,8,403,58,401,0,0,62,453,4,179,62,632,California
Mariposa,2021-01-22,58,862,5,408,53,454,0,0,58,511,0,179,58,690,California
Mariposa,2021-01-23,116,978,2,410,114,568,0,0,114,623,2,181,114,804,California
Mariposa,2021-01-24,2,980,2,412,0,568,0,0,2,625,0,181,2,806,California
Mariposa,2021-01-25,4,984,1,413,3,571,0,0,0,621,4,185,0,806,California
Mariposa,2021-01-26,41,1025,4,417,37,608,0,0,5,595,36,221,10,816,California
Mariposa,2021-01-27,27,1052,3,420,24,632,0,0,12,593,14,235,12,828,California
Mariposa,2021-01-28,127,1179,3,423,124,756,0,0,114,695,12,247,114,942,California
Mariposa,2021-01-29,93,1272,22,445,71,827,0,0,92,786,1,248,92,1034,California
Mariposa,2021-01-30,10,1282,1,446,9,836,0,0,9,794,1,249,9,1043,California
Mariposa,2021-02-01,96,1378,33,479,63,899,0,0,73,844,23,272,73,1116,California
Mariposa,2021-02-02,14,1392,3,482,11,910,0,0,8,846,6,278,8,1124,California
Mariposa,2021-02-03,22,1414,1,483,21,931,0,0,13,851,8,286,13,1137,California
Mariposa,2021-02-04,99,1513,8,491,91,1022,0,0,94,942,4,290,95,1232,California
Mariposa,2021-02-05,194,1707,7,498,187,1209,0,0,167,1082,27,317,167,1399,California
Mariposa,2021-02-06,11,1718,4,502,7,1216,0,0,10,1091,1,318,10,1409,California
Mariposa,2021-02-07,1,1719,0,502,1,1217,0,0,1,1092,0,318,1,1410,California
Mariposa,2021-02-08,42,1761,3,505,39,1256,0,0,22,1094,20,338,22,1432,California
Mariposa,2021-02-09,45,1806,26,531,19,1275,0,0,38,1125,7,345,38,1470,California
Mariposa,2021-02-10,32,1838,4,535,28,1303,0,0,19,1139,12,357,26,1496,California
Mariposa,2021-02-11,389,2227,7,542,382,1685,0,0,371,1495,18,375,374,1870,California
Mariposa,2021-02-12,193,2420,10,552,183,1868,0,0,146,1594,47,422,146,2016,California
Mariposa,2021-02-13,12,2432,3,555,9,1877,0,0,10,1602,2,424,10,2026,California
Mariposa,2021-02-14,12,2444,4,559,8,1885,0,0,6,1602,6,430,6,2032,California
Mariposa,2021-02-15,11,2455,4,563,7,1892,0,0,9,1609,2,432,9,2041,California
Mariposa,2021-02-16,60,2515,36,599,24,1916,0,0,36,1622,24,456,37,2078,California
Mariposa,2021-02-17,37,2552,9,608,28,1944,0,0,29,1645,7,463,30,2108,California
Mariposa,2021-02-18,60,2612,7,615,53,1997,0,0,23,1631,37,500,23,2131,California
Mariposa,2021-02-19,84,2696,4,619,80,2077,0,0,75,1698,9,509,76,2207,California
Mariposa,2021-02-20,265,2961,6,625,259,2336,0,0,232,1899,31,540,232,2439,California
Mariposa,2021-02-21,252,3213,5,630,247,2583,0,0,249,2146,2,542,249,2688,California
Mariposa,2021-02-22,27,3240,11,641,16,2599,0,0,22,2164,4,546,22,2710,California
Mariposa,2021-02-23,45,3285,38,679,7,2606,0,0,26,2171,19,565,26,2736,California
Mariposa,2021-02-24,22,3307,3,682,19,2625,0,0,9,2168,12,577,9,2745,California
Mariposa,2021-02-25,19,3326,9,691,10,2635,0,0,12,2173,7,584,12,2757,California
Mariposa,2021-02-26,440,3766,7,698,433,3068,0,0,373,2480,67,651,374,3131,California
Mariposa,2021-02-27,187,3953,6,704,181,3249,0,0,175,2643,12,663,175,3306,California
Mariposa,2021-02-28,1,3954,1,705,0,3249,0,0,0,2642,1,664,0,3306,California
Mariposa,2021-03-01,88,4042,26,731,62,3311,0,0,18,2592,68,732,18,3324,California
Mariposa,2021-03-02,20,4062,13,744,7,3318,0,0,11,2595,8,740,11,3335,California
Mariposa,2021-03-03,71,4133,5,749,66,3384,0,0,64,2654,6,746,65,3400,California
Mariposa,2021-03-04,44,4177,10,759,34,3418,0,0,21,2654,23,769,23,3423,California
Mariposa,2021-03-05,65,4242,10,769,55,3473,0,0,39,2676,26,795,48,3471,California
Mariposa,2021-03-06,19,4261,9,778,10,3483,0,0,9,2676,10,805,10,3481,California
Mariposa,2021-03-07,1,4262,1,779,0,3483,0,0,0,2675,1,806,0,3481,California
Mariposa,2021-03-08,42,4304,4,783,27,3510,11,11,12,2668,30,836,23,3504,California
Mariposa,2021-03-09,45,4349,17,800,18,3528,10,21,15,2663,30,866,25,3529,California
Mariposa,2021-03-10,37,4386,12,812,15,3543,10,31,10,2657,26,892,20,3549,California
Mariposa,2021-03-11,476,4862,8,820,447,3990,21,52,220,2646,255,1147,244,3793,California
Mariposa,2021-03-12,262,5124,8,828,226,4216,28,80,115,2641,147,1294,142,3935,California
Mariposa,2021-03-13,37,5161,8,836,14,4230,15,95,12,2642,25,1319,26,3961,California
Mariposa,2021-03-14,18,5179,2,838,5,4235,11,106,2,2640,15,1334,13,3974,California
Mariposa,2021-03-15,80,5259,10,848,31,4266,39,145,33,2663,47,1381,70,4044,California
Mariposa,2021-03-16,84,5343,35,883,15,4281,34,179,25,2663,59,1440,59,4103,California
Mariposa,2021-03-17,74,5417,11,894,55,4336,8,187,53,2703,21,1461,61,4164,California
Mariposa,2021-03-18,68,5485,15,909,44,4380,9,196,41,2726,27,1488,50,4214,California
Mariposa,2021-03-19,344,5829,14,923,323,4703,7,203,304,2998,40,1528,312,4526,California
Mariposa,2021-03-20,435,6264,6,929,427,5130,2,205,35,2639,399,1927,40,4566,California
Mariposa,2021-03-21,16,6280,8,937,7,5137,1,206,9,2643,6,1933,10,4576,California
Mariposa,2021-03-22,42,6322,10,947,24,5161,8,214,29,2669,13,1946,39,4615,California
Mariposa,2021-03-23,57,6379,37,984,10,5171,10,224,36,2694,21,1967,46,4661,California
Mariposa,2021-03-24,58,6437,6,990,50,5221,2,226,52,2742,6,1973,54,4715,California
Mariposa,2021-03-25,76,6513,15,1005,53,5274,8,234,53,2782,21,1994,61,4776,California
Mariposa,2021-03-26,498,7011,10,1015,487,5761,1,235,244,2773,254,2248,245,5021,California
Mariposa,2021-03-27,238,7249,9,1024,229,5990,0,235,87,2711,151,2399,89,5110,California
Mariposa,2021-03-28,5,7254,0,1024,2,5992,3,238,1,2711,4,2403,4,5114,California
Mariposa,2021-03-29,19,7273,5,1029,14,6006,0,238,11,2714,8,2411,11,5125,California
Mariposa,2021-03-30,38,7311,13,1042,9,6015,16,254,15,2722,23,2434,31,5156,California
Mariposa,2021-03-31,93,7404,15,1057,69,6084,9,263,69,2776,24,2458,78,5234,California
Mariposa,2021-04-01,57,7461,12,1069,36,6120,9,272,35,2798,22,2480,44,5278,California
Mariposa,2021-04-02,355,7816,15,1084,336,6456,4,276,310,3068,44,2524,314,5592,California
Mariposa,2021-04-03,11,7827,8,1092,3,6459,0,276,6,3069,5,2529,6,5598,California
Mariposa,2021-04-04,2,7829,1,1093,0,6459,1,277,0,3068,2,2531,1,5599,California
Mariposa,2021-04-05,36,7865,23,1116,9,6468,4,281,16,3068,20,2551,20,5619,California
Mariposa,2021-04-06,45,7910,20,1136,9,6477,16,297,14,3068,30,2581,30,5649,California
Mariposa,2021-04-07,100,8010,8,1144,73,6550,19,316,29,3045,71,2652,48,5697,California
Mariposa,2021-04-08,285,8295,16,1160,250,6800,19,335,148,3078,135,2787,168,5865,California
Mariposa,2021-04-09,38,8333,8,1168,15,6815,15,350,9,3073,29,2816,24,5889,California
Mariposa,2021-04-10,205,8538,7,1175,189,7004,9,359,190,3259,13,2829,199,6088,California
Mariposa,2021-04-11,123,8661,3,1178,118,7122,2,361,58,3255,65,2894,61,6149,California
Mariposa,2021-04-12,43,8704,14,1192,27,7149,2,363,13,3241,29,2923,15,6164,California
Mariposa,2021-04-13,57,8761,49,1241,8,7157,0,363,34,3252,23,2946,34,6198,California
Mariposa,2021-04-14,114,8875,9,1250,105,7262,0,363,58,3255,55,3001,58,6256,California
Mariposa,2021-04-15,64,8939,20,1270,44,7306,0,363,45,3284,16,3017,45,6301,California
Mariposa,2021-04-16,384,9323,15,1285,369,7675,0,363,106,3113,277,3294,106,6407,California
Mariposa,2021-04-17,9,9332,5,1290,4,7679,0,363,7,3118,2,3296,7,6414,California
Mariposa,2021-04-18,8,9340,0,1290,8,7687,0,363,3,3116,5,3301,3,6417,California
Mariposa,2021-04-19,60,9400,27,1317,33,7720,0,363,32,3122,26,3327,32,6449,California
Mariposa,2021-04-20,62,9462,48,1365,14,7734,0,363,37,3136,23,3350,37,6486,California
Mariposa,2021-04-21,94,9556,15,1380,79,7813,0,363,42,3127,51,3401,42,6528,California
Mariposa,2021-04-22,51,9607,11,1391,40,7853,0,363,38,3153,12,3413,38,6566,California
Mariposa,2021-04-23,318,9925,73,1464,245,8098,0,363,145,3127,173,3586,147,6713,California
Mariposa,2021-04-24,110,10035,10,1474,100,8198,0,363,42,3102,67,3653,42,6755,California
Mariposa,2021-04-26,17,10052,12,1486,5,8203,0,363,6,3097,11,3664,6,6761,California
Mariposa,2021-04-27,34,10086,17,1503,15,8218,2,365,15,3098,16,3680,17,6778,California
Mariposa,2021-04-28,75,10161,13,1516,55,8273,7,372,27,3084,48,3728,34,6812,California
Mariposa,2021-04-29,83,10244,12,1528,70,8343,1,373,78,3158,5,3733,79,6891,California
Mariposa,2021-04-30,213,10457,5,1533,203,8546,5,378,62,3074,151,3884,67,6958,California
Mariposa,2021-05-01,6,10463,4,1537,2,8548,0,378,1,3070,5,3889,1,6959,California
Mariposa,2021-05-02,4,10467,2,1539,1,8549,1,379,0,3067,4,3893,1,6960,California
Mariposa,2021-05-03,16,10483,12,1551,3,8552,1,380,7,3066,9,3902,8,6968,California
Mariposa,2021-05-04,52,10535,31,1582,17,8569,4,384,37,3093,14,3916,41,7009,California
Mariposa,2021-05-05,57,10592,9,1591,46,8615,2,386,18,3074,39,3955,20,7029,California
Mariposa,2021-05-06,60,10652,38,1629,17,8632,5,391,41,3101,19,3974,46,7075,California
Mariposa,2021-05-07,28,10680,8,1637,17,8649,3,394,13,3102,15,3989,16,7091,California
Mariposa,2021-05-08,284,10964,7,1644,277,8926,0,394,32,2884,252,4241,34,7125,California
Mariposa,2021-05-09,3,10967,1,1645,2,8928,0,394,0,2881,3,4244,0,7125,California
Mariposa,2021-05-10,21,10988,10,1655,9,8937,2,396,4,2871,16,4260,6,7131,California
Mariposa,2021-05-11,29,11017,17,1672,11,8948,1,397,21,2886,7,4267,22,7153,California
Mariposa,2021-05-12,68,11085,4,1676,58,9006,6,403,6,2836,62,4329,12,7165,California
Mariposa,2021-05-13,49,11134,8,1684,39,9045,2,405,13,2815,36,4365,15,7180,California
Mariposa,2021-05-14,250,11384,122,1806,121,9166,7,412,118,2808,132,4497,125,7305,California
Mariposa,2021-05-15,19,11403,9,1815,8,9174,2,414,11,2814,6,4503,12,7317,California
Mariposa,2021-05-16,3,11406,1,1816,1,9175,1,415,1,2814,2,4505,2,7319,California
Mariposa,2021-05-17,18,11424,7,1823,7,9182,4,419,7,2813,11,4516,10,7329,California
Mariposa,2021-05-18,63,11487,43,1866,15,9197,5,424,46,2848,16,4532,51,7380,California
Mariposa,2021-05-19,71,11558,32,1898,38,9235,1,425,52,2883,18,4550,53,7433,California
Mariposa,2021-05-20,34,11592,18,1916,14,9249,2,427,13,2877,21,4571,15,7448,California
Mariposa,2021-05-21,94,11686,9,1925,83,9332,2,429,43,2873,49,4620,45,7493,California
Mariposa,2021-05-22,48,11734,7,1932,40,9372,1,430,18,2862,30,4650,19,7512,California
Mariposa,2021-05-23,3,11737,2,1934,0,9372,1,431,2,2864,1,4651,3,7515,California
Mariposa,2021-05-24,14,11751,8,1942,4,9376,2,433,8,2868,6,4657,10,7525,California
Mariposa,2021-05-25,26,11777,16,1958,10,9386,0,433,18,2878,8,4665,18,7543,California
Mariposa,2021-05-26,35,11812,4,1962,27,9413,4,437,28,2903,7,4672,32,7575,California
Mariposa,2021-05-27,120,11932,64,2026,55,9468,1,438,62,2908,58,4730,63,7638,California
Mariposa,2021-05-28,64,11996,4,2030,56,9524,4,442,23,2894,41,4771,27,7665,California
Mariposa,2021-05-29,7,12003,1,2031,5,9529,1,443,3,2896,2,4773,4,7669,California
Mariposa,2021-05-30,1,12004,0,2031,0,9529,1,444,0,2896,1,4774,1,7670,California
Mariposa,2021-05-31,2,12006,0,2031,1,9530,1,445,0,2895,2,4776,1,7671,California
Mariposa,2021-06-01,14,12020,3,2034,11,9541,0,445,5,2891,9,4785,5,7676,California
Mariposa,2021-06-02,27,12047,14,2048,8,9549,5,450,7,2884,19,4804,12,7688,California
Mariposa,2021-06-03,20,12067,10,2058,7,9556,3,453,7,2881,13,4817,10,7698,California
Mariposa,2021-06-04,91,12158,80,2138,9,9565,2,455,27,2847,62,4879,28,7726,California
Mariposa,2021-06-05,29,12187,3,2141,24,9589,2,457,7,2834,22,4901,9,7735,California
Mariposa,2021-06-06,4,12191,3,2144,0,9589,1,458,1,2833,3,4904,2,7737,California
Mariposa,2021-06-07,9,12200,4,2148,5,9594,0,458,3,2831,5,4909,3,7740,California
Mariposa,2021-06-08,48,12248,34,2182,12,9606,2,460,16,2817,32,4941,18,7758,California
Mariposa,2021-06-09,28,12276,21,2203,2,9608,5,465,6,2806,22,4963,11,7769,California
Mariposa,2021-06-10,16,12292,8,2211,5,9613,3,468,6,2806,10,4973,10,7779,California
Mariposa,2021-06-11,44,12336,13,2224,23,9636,8,476,10,2790,34,5007,18,7797,California
Mariposa,2021-06-12,17,12353,11,2235,5,9641,1,477,3,2779,14,5021,3,7800,California
Mariposa,2021-06-13,1,12354,0,2235,0,9641,1,478,0,2779,1,5022,1,7801,California
Mariposa,2021-06-14,13,12367,4,2239,8,9649,1,479,5,2777,8,5030,6,7807,California
Mariposa,2021-06-15,24,12391,12,2251,11,9660,1,480,7,2768,17,5047,8,7815,California
Mariposa,2021-06-16,29,12420,13,2264,15,9675,1,481,8,2756,21,5068,9,7824,California
Mariposa,2021-06-17,12,12432,6,2270,6,9681,0,481,4,2752,8,5076,4,7828,California
Mariposa,2021-06-18,68,12500,49,2319,16,9697,3,484,33,2753,34,5110,35,7863,California
Mariposa,2021-06-19,18,12518,5,2324,13,9710,0,484,6,2747,12,5122,6,7869,California
Mariposa,2021-06-21,11,12529,4,2328,7,9717,0,484,7,2751,3,5125,7,7876,California
Mariposa,2021-06-22,24,12553,10,2338,11,9728,3,487,14,2758,10,5135,17,7893,California
Mariposa,2021-06-23,9,12562,3,2341,3,9731,3,490,5,2762,4,5139,8,7901,California
Mariposa,2021-06-24,12,12574,5,2346,7,9738,0,490,6,2762,6,5145,6,7907,California
Mariposa,2021-06-25,51,12625,23,2369,27,9765,1,491,18,2749,32,5177,19,7926,California
Mariposa,2021-06-26,1,12626,1,2370,0,9765,0,491,0,2748,1,5178,0,7926,California
Mariposa,2021-06-27,1,12627,0,2370,0,9765,1,492,0,2748,1,5179,1,7927,California
Mariposa,2021-06-28,3,12630,3,2373,0,9765,0,492,3,2751,0,5179,3,7930,California
Mariposa,2021-06-29,7,12637,3,2376,3,9768,1,493,3,2751,4,5183,4,7934,California
Mariposa,2021-06-30,2,12639,0,2376,1,9769,1,494,0,2750,2,5185,1,7935,California
Mariposa,2021-07-01,22,12661,17,2393,3,9772,2,496,9,2748,13,5198,11,7946,California
Mariposa,2021-07-02,4,12665,4,2397,0,9772,0,496,2,2749,1,5199,2,7948,California
Mariposa,2021-07-05,4,12669,1,2398,2,9774,1,497,1,2748,3,5202,2,7950,California
Mariposa,2021-07-06,12,12681,3,2401,3,9777,6,503,2,2746,10,5212,8,7958,California
Mariposa,2021-07-07,14,12695,12,2413,1,9778,1,504,8,2749,6,5218,9,7967,California
Mariposa,2021-07-08,30,12725,19,2432,9,9787,2,506,13,2747,17,5235,15,7982,California
Mariposa,2021-07-09,5,12730,3,2435,0,9787,2,508,1,2746,4,5239,3,7985,California
Mariposa,2021-07-10,1,12731,0,2435,0,9787,1,509,0,2746,1,5240,1,7986,California
Mariposa,2021-07-12,12,12743,8,2443,4,9791,0,509,6,2746,6,5246,6,7992,California
Mariposa,2021-07-13,3,12746,3,2446,0,9791,0,509,2,2747,1,5247,2,7994,California
Mariposa,2021-07-14,11,12757,4,2450,6,9797,1,510,4,2745,7,5254,5,7999,California
Mariposa,2021-07-15,24,12781,12,2462,10,9807,2,512,7,2737,17,5271,9,8008,California
Mariposa,2021-07-16,4,12785,2,2464,2,9809,0,512,3,2739,1,5272,3,8011,California
Mariposa,2021-07-17,3,12788,2,2466,1,9810,0,512,2,2740,1,5273,2,8013,California
Mariposa,2021-07-18,4,12792,4,2470,0,9810,0,512,3,2742,1,5274,3,8016,California
Mariposa,2021-07-19,9,12801,2,2472,7,9817,0,512,5,2743,4,5278,5,8021,California
Mariposa,2021-07-20,9,12810,4,2476,5,9822,0,512,4,2743,4,5282,4,8025,California
Mariposa,2021-07-21,11,12821,3,2479,6,9828,2,514,7,2748,4,5286,9,8034,California
Mariposa,2021-07-22,22,12843,13,2492,8,9836,1,515,13,2753,9,5295,14,8048,California
Mariposa,2021-07-23,5,12848,4,2496,1,9837,0,515,2,2752,3,5298,2,8050,California
Mariposa,2021-07-24,2,12850,1,2497,1,9838,0,515,2,2754,0,5298,2,8052,California
Mariposa,2021-07-26,5,12855,2,2499,2,9840,1,516,3,2756,2,5300,4,8056,California
Mariposa,2021-07-27,15,12870,11,2510,3,9843,1,517,12,2766,3,5303,13,8069,California
Mariposa,2021-07-28,8,12878,5,2515,3,9846,0,517,4,2766,4,5307,4,8073,California
Mariposa,2021-07-29,39,12917,26,2541,11,9857,2,519,31,2793,5,5312,32,8105,California
Mariposa,2021-07-30,6,12923,4,2545,2,9859,0,519,5,2797,1,5313,5,8110,California
Mariposa,2021-07-31,2,12925,1,2546,0,9859,1,520,1,2798,1,5314,2,8112,California
Mendocino,2020-12-17,70,70,70,70,0,0,0,0,70,70,0,0,70,70,California
Mendocino,2020-12-18,84,154,83,153,1,1,0,0,83,153,0,0,83,153,California
Mendocino,2020-12-19,3,157,3,156,0,1,0,0,3,156,0,0,3,156,California
Mendocino,2020-12-20,8,165,8,164,0,1,0,0,8,164,0,0,8,164,California
Mendocino,2020-12-21,235,400,235,399,0,1,0,0,77,241,0,0,77,241,California
Mendocino,2020-12-22,256,656,195,594,61,62,0,0,256,497,0,0,256,497,California
Mendocino,2020-12-23,271,927,47,641,224,286,0,0,270,767,0,0,270,767,California
Mendocino,2020-12-24,48,975,8,649,40,326,0,0,48,815,0,0,48,815,California
Mendocino,2020-12-25,1,976,0,649,1,327,0,0,1,816,0,0,1,816,California
Mendocino,2020-12-26,2,978,2,651,0,327,0,0,2,818,0,0,2,818,California
Mendocino,2020-12-27,1,979,0,651,1,328,0,0,1,819,0,0,1,819,California
Mendocino,2020-12-28,74,1053,9,660,65,393,0,0,74,893,0,0,74,893,California
Mendocino,2020-12-29,122,1175,62,722,60,453,0,0,122,1015,0,0,122,1015,California
Mendocino,2020-12-30,122,1297,68,790,54,507,0,0,122,1137,0,0,122,1137,California
Mendocino,2020-12-31,132,1429,97,887,35,542,0,0,132,1269,0,0,132,1269,California
Mendocino,2021-01-01,13,1442,8,895,5,547,0,0,13,1282,0,0,13,1282,California
Mendocino,2021-01-02,1,1443,1,896,0,547,0,0,1,1283,0,0,1,1283,California
Mendocino,2021-01-04,838,2281,18,914,820,1367,0,0,838,2121,0,0,838,2121,California
Mendocino,2021-01-05,73,2354,37,951,36,1403,0,0,60,2168,13,13,60,2181,California
Mendocino,2021-01-06,156,2510,134,1085,22,1425,0,0,147,2306,9,22,147,2328,California
Mendocino,2021-01-07,376,2886,242,1327,134,1559,0,0,313,2556,63,85,313,2641,California
Mendocino,2021-01-08,95,2981,81,1408,14,1573,0,0,42,2546,53,138,43,2684,California
Mendocino,2021-01-09,10,2991,6,1414,4,1577,0,0,8,2552,2,140,8,2692,California
Mendocino,2021-01-10,9,3000,8,1422,1,1578,0,0,2,2547,7,147,2,2694,California
Mendocino,2021-01-11,108,3108,94,1516,14,1592,0,0,50,2540,57,204,50,2744,California
Mendocino,2021-01-12,394,3502,384,1900,10,1602,0,0,274,2694,120,324,274,3018,California
Mendocino,2021-01-13,497,3999,151,2051,346,1948,0,0,450,3100,45,369,451,3469,California
Mendocino,2021-01-14,671,4670,25,2076,646,2594,0,0,658,3745,13,382,658,4127,California
Mendocino,2021-01-15,1885,6555,873,2949,1012,3606,0,0,1879,5620,5,387,1880,6007,California
Mendocino,2021-01-16,788,7343,48,2997,740,4346,0,0,785,6402,3,390,785,6792,California
Mendocino,2021-01-17,557,7900,1,2998,556,4902,0,0,556,6957,1,391,556,7348,California
Mendocino,2021-01-18,486,8386,461,3459,25,4927,0,0,475,7421,11,402,475,7823,California
Mendocino,2021-01-19,334,8720,149,3608,185,5112,0,0,153,7393,181,583,153,7976,California
Mendocino,2021-01-20,560,9280,410,4018,150,5262,0,0,453,7742,105,688,454,8430,California
Mendocino,2021-01-21,536,9816,226,4244,310,5572,0,0,350,7907,185,873,350,8780,California
Mendocino,2021-01-22,155,9971,61,4305,94,5666,0,0,115,7982,40,913,115,8895,California
Mendocino,2021-01-23,155,10126,84,4389,71,5737,0,0,149,8125,6,919,149,9044,California
Mendocino,2021-01-24,4,10130,2,4391,2,5739,0,0,4,8129,0,919,4,9048,California
Mendocino,2021-01-25,210,10340,18,4409,192,5931,0,0,140,8199,70,989,140,9188,California
Mendocino,2021-01-26,155,10495,55,4464,100,6031,0,0,95,8234,60,1049,95,9283,California
Mendocino,2021-01-27,446,10941,373,4837,73,6104,0,0,176,8147,263,1312,176,9459,California
Mendocino,2021-01-28,603,11544,539,5376,64,6168,0,0,507,8559,95,1407,507,9966,California
Mendocino,2021-01-29,396,11940,352,5728,44,6212,0,0,367,8898,29,1436,368,10334,California
Mendocino,2021-01-30,50,11990,31,5759,19,6231,0,0,44,8936,6,1442,44,10378,California
Mendocino,2021-01-31,277,12267,2,5761,275,6506,0,0,4,8667,273,1715,4,10382,California
Mendocino,2021-02-01,385,12652,55,5816,330,6836,0,0,62,8406,323,2038,62,10444,California
Mendocino,2021-02-02,749,13401,528,6344,221,7057,0,0,386,8429,363,2401,386,10830,California
Mendocino,2021-02-03,401,13802,209,6553,192,7249,0,0,229,8488,170,2571,229,11059,California
Mendocino,2021-02-04,631,14433,535,7088,96,7345,0,0,502,8861,129,2700,502,11561,California
Mendocino,2021-02-05,1324,15757,1220,8308,104,7449,0,0,590,8719,732,3432,590,12151,California
Mendocino,2021-02-06,551,16308,153,8461,398,7847,0,0,536,9240,15,3447,536,12687,California
Mendocino,2021-02-07,33,16341,29,8490,4,7851,0,0,33,9273,0,3447,33,12720,California
Mendocino,2021-02-08,748,17089,716,9206,32,7883,0,0,283,9091,465,3912,283,13003,California
Mendocino,2021-02-09,142,17231,60,9266,82,7965,0,0,88,9125,54,3966,88,13091,California
Mendocino,2021-02-10,1490,18721,925,10191,565,8530,0,0,741,9125,741,4707,741,13832,California
Mendocino,2021-02-11,1228,19949,209,10400,1019,9549,0,0,300,8497,928,5635,300,14132,California
Mendocino,2021-02-12,1462,21411,160,10560,1302,10851,0,0,663,8362,798,6433,663,14795,California
Mendocino,2021-02-13,562,21973,16,10576,546,11397,0,0,159,8124,402,6835,164,14959,California
Mendocino,2021-02-14,702,22675,5,10581,697,12094,0,0,136,7694,566,7401,136,15095,California
Mendocino,2021-02-15,333,23008,41,10622,292,12386,0,0,174,7710,158,7559,174,15269,California
Mendocino,2021-02-16,199,23207,53,10675,146,12532,0,0,128,7767,71,7630,128,15397,California
Mendocino,2021-02-17,1380,24587,1214,11889,166,12698,0,0,887,8163,491,8121,887,16284,California
Mendocino,2021-02-18,1831,26418,691,12580,1140,13838,0,0,1235,8804,594,8715,1235,17519,California
Mendocino,2021-02-19,776,27194,154,12734,622,14460,0,0,629,9288,147,8862,631,18150,California
Mendocino,2021-02-20,619,27813,575,13309,44,14504,0,0,578,9827,39,8901,578,18728,California
Mendocino,2021-02-21,328,28141,9,13318,319,14823,0,0,315,10130,12,8913,315,19043,California
Mendocino,2021-02-22,205,28346,32,13350,173,14996,0,0,101,10129,102,9015,101,19144,California
Mendocino,2021-02-23,879,29225,865,14215,14,15010,0,0,662,10576,215,9230,662,19806,California
Mendocino,2021-02-24,1888,31113,1802,16017,86,15096,0,0,1452,11601,429,9659,1454,21260,California
Mendocino,2021-02-25,1733,32846,555,16572,1178,16274,0,0,1297,12465,433,10092,1297,22557,California
Mendocino,2021-02-26,1460,34306,778,17350,682,16956,0,0,1076,13160,381,10473,1076,23633,California
Mendocino,2021-02-27,201,34507,145,17495,56,17012,0,0,79,13118,121,10594,79,23712,California
Mendocino,2021-02-28,35,34542,13,17508,22,17034,0,0,24,13131,11,10605,24,23736,California
Mendocino,2021-03-01,604,35146,555,18063,49,17083,0,0,560,13650,41,10646,560,24296,California
Mendocino,2021-03-02,75,35221,27,18090,48,17131,0,0,40,13656,34,10680,40,24336,California
Mendocino,2021-03-03,2046,37267,1339,19429,707,17838,0,0,1388,14389,655,11335,1388,25724,California
Mendocino,2021-03-04,1875,39142,153,19582,1722,19560,0,0,1653,15825,219,11554,1655,27379,California
Mendocino,2021-03-05,477,39619,416,19998,52,19612,9,9,374,16109,99,11653,383,27762,California
Mendocino,2021-03-06,253,39872,27,20025,197,19809,29,38,206,16298,46,11699,235,27997,California
Mendocino,2021-03-07,529,40401,28,20053,479,20288,22,60,138,16066,390,12089,158,28155,California
Mendocino,2021-03-08,123,40524,28,20081,58,20346,37,97,64,16110,57,12146,101,28256,California
Mendocino,2021-03-09,939,41463,601,20682,298,20644,40,137,831,16873,108,12254,871,29127,California
Mendocino,2021-03-10,1149,42612,986,21668,99,20743,64,201,267,16331,876,13130,334,29461,California
Mendocino,2021-03-11,856,43468,636,22304,166,20909,54,255,396,16324,456,13586,449,29910,California
Mendocino,2021-03-12,2156,45624,1060,23364,982,21891,114,369,1289,16866,861,14447,1403,31313,California
Mendocino,2021-03-13,763,46387,572,23936,132,22023,59,428,130,16427,628,15075,189,31502,California
Mendocino,2021-03-14,106,46493,4,23940,95,22118,7,435,12,16356,90,15165,19,31521,California
Mendocino,2021-03-15,611,47104,51,23991,501,22619,59,494,216,16238,392,15557,274,31795,California
Mendocino,2021-03-16,583,47687,388,24379,149,22768,46,540,113,15929,468,16025,159,31954,California
Mendocino,2021-03-17,1592,49279,1391,25770,54,22822,147,687,205,14910,1378,17403,359,32313,California
Mendocino,2021-03-18,1306,50585,248,26018,1022,23844,36,723,269,14186,1029,18432,305,32618,California
Mendocino,2021-03-19,1856,52441,854,26872,943,24787,59,782,352,13103,1496,19928,413,33031,California
Mendocino,2021-03-20,71,52512,11,26883,40,24827,20,802,14,13081,57,19985,35,33066,California
Mendocino,2021-03-21,9,52521,1,26884,3,24830,5,807,4,13085,5,19990,9,33075,California
Mendocino,2021-03-22,661,53182,616,27500,16,24846,29,836,141,12739,515,20505,169,33244,California
Mendocino,2021-03-23,166,53348,36,27536,101,24947,29,865,115,12833,50,20555,144,33388,California
Mendocino,2021-03-24,915,54263,845,28381,22,24969,48,913,105,12178,808,21363,153,33541,California
Mendocino,2021-03-25,2031,56294,53,28434,1958,26927,20,933,166,10505,1857,23220,184,33725,California
Mendocino,2021-03-26,546,56840,395,28829,125,27052,26,959,109,10204,436,23656,135,33860,California
Mendocino,2021-03-27,166,57006,34,28863,120,27172,12,971,81,10212,84,23740,92,33952,California
Mendocino,2021-03-28,26,57032,5,28868,17,27189,4,975,3,10197,22,23762,7,33959,California
Mendocino,2021-03-29,191,57223,100,28968,47,27236,44,1019,96,10242,95,23857,140,34099,California
Mendocino,2021-03-30,719,57942,635,29603,47,27283,37,1056,104,9771,612,24469,141,34240,California
Mendocino,2021-03-31,924,58866,284,29887,579,27862,61,1117,154,9219,767,25236,215,34455,California
Mendocino,2021-04-01,1753,60619,423,30310,1250,29112,80,1197,378,8311,1365,26601,457,34912,California
Mendocino,2021-04-02,1311,61930,1079,31389,159,29271,73,1270,154,7384,1154,27755,227,35139,California
Mendocino,2021-04-03,714,62644,12,31401,681,29952,21,1291,70,6836,639,28394,91,35230,California
Mendocino,2021-04-04,71,62715,35,31436,30,29982,6,1297,54,6879,17,28411,60,35290,California
Mendocino,2021-04-05,209,62924,141,31577,44,30026,24,1321,124,6939,85,28496,145,35435,California
Mendocino,2021-04-06,396,63320,125,31702,177,30203,94,1415,109,6855,287,28783,203,35638,California
Mendocino,2021-04-07,492,63812,180,31882,65,30268,247,1662,116,6843,373,29156,361,35999,California
Mendocino,2021-04-08,1507,65319,929,32811,464,30732,114,1776,1015,7487,484,29640,1128,37127,California
Mendocino,2021-04-09,768,66087,432,33243,174,30906,162,1938,402,7685,366,30006,564,37691,California
Mendocino,2021-04-10,540,66627,94,33337,400,31306,46,1984,148,7487,392,30398,194,37885,California
Mendocino,2021-04-11,120,66747,47,33384,19,31325,54,2038,59,7539,61,30459,113,37998,California
Mendocino,2021-04-12,627,67374,520,33904,47,31372,60,2098,411,7795,215,30674,471,38469,California
Mendocino,2021-04-13,295,67669,233,34137,62,31434,0,2098,224,7948,71,30745,224,38693,California
Mendocino,2021-04-14,523,68192,435,34572,88,31522,0,2098,426,8277,97,30842,426,39119,California
Mendocino,2021-04-15,668,68860,332,34904,335,31857,1,2099,389,8393,273,31115,389,39508,California
Mendocino,2021-04-16,195,69055,53,34957,141,31998,1,2100,91,8381,103,31218,91,39599,California
Mendocino,2021-04-17,196,69251,12,34969,184,32182,0,2100,67,8321,127,31345,67,39666,California
Mendocino,2021-04-18,14,69265,6,34975,8,32190,0,2100,7,8323,5,31350,7,39673,California
Mendocino,2021-04-19,543,69808,517,35492,25,32215,1,2101,429,8641,112,31462,430,40103,California
Mendocino,2021-04-20,427,70235,294,35786,133,32348,0,2101,267,8750,158,31620,267,40370,California
Mendocino,2021-04-21,195,70430,137,35923,57,32405,1,2102,117,8791,76,31696,117,40487,California
Mendocino,2021-04-22,488,70918,318,36241,169,32574,1,2103,315,8938,168,31864,315,40802,California
Mendocino,2021-04-23,864,71782,706,36947,158,32732,0,2103,703,9484,157,32021,703,41505,California
Mendocino,2021-04-24,110,71892,15,36962,95,32827,0,2103,100,9574,10,32031,100,41605,California
Mendocino,2021-04-25,58,71950,35,36997,19,32846,4,2107,19,9559,38,32069,23,41628,California
Mendocino,2021-04-26,317,72267,244,37241,68,32914,5,2112,206,9661,109,32178,211,41839,California
Mendocino,2021-04-27,210,72477,93,37334,90,33004,27,2139,97,9672,112,32290,123,41962,California
Mendocino,2021-04-28,230,72707,152,37486,59,33063,19,2158,131,9725,98,32388,151,42113,California
Mendocino,2021-04-29,1163,73870,857,38343,290,33353,16,2174,104,8792,1052,33440,119,42232,California
Mendocino,2021-04-30,608,74478,384,38727,215,33568,9,2183,226,8647,380,33820,235,42467,California
Mendocino,2021-05-01,491,74969,442,39169,41,33609,8,2191,380,8927,108,33928,388,42855,California
Mendocino,2021-05-02,57,75026,47,39216,7,33616,3,2194,8,8891,47,33975,11,42866,California
Mendocino,2021-05-03,148,75174,88,39304,39,33655,21,2215,42,8851,103,34078,63,42929,California
Mendocino,2021-05-04,384,75558,258,39562,94,33749,32,2247,145,8790,238,34316,177,43106,California
Mendocino,2021-05-05,891,76449,803,40365,73,33822,15,2262,225,8364,664,34980,238,43344,California
Mendocino,2021-05-06,643,77092,390,40755,231,34053,22,2284,159,8063,482,35462,181,43525,California
Mendocino,2021-05-07,186,77278,33,40788,128,34181,25,2309,119,8140,66,35528,143,43668,California
Mendocino,2021-05-08,128,77406,6,40794,121,34302,1,2310,111,8237,15,35543,112,43780,California
Mendocino,2021-05-09,24,77430,8,40802,15,34317,1,2311,6,8227,17,35560,7,43787,California
Mendocino,2021-05-10,241,77671,160,40962,76,34393,5,2316,150,8291,91,35651,155,43942,California
Mendocino,2021-05-11,279,77950,143,41105,118,34511,18,2334,130,8290,147,35798,146,44088,California
Mendocino,2021-05-12,144,78094,82,41187,53,34564,9,2343,46,8249,96,35894,55,44143,California
Mendocino,2021-05-13,1246,79340,1128,42315,101,34665,17,2360,323,7667,922,36816,340,44483,California
Mendocino,2021-05-14,719,80059,489,42804,166,34831,64,2424,247,7511,467,37283,311,44794,California
Mendocino,2021-05-15,153,80212,28,42832,121,34952,4,2428,59,7482,92,37375,63,44857,California
Mendocino,2021-05-16,116,80328,103,42935,11,34963,2,2430,98,7566,17,37392,101,44958,California
Mendocino,2021-05-17,178,80506,87,43022,75,35038,16,2446,102,7608,76,37468,118,45076,California
Mendocino,2021-05-18,250,80756,120,43142,99,35137,31,2477,107,7603,142,37610,137,45213,California
Mendocino,2021-05-19,332,81088,192,43334,119,35256,21,2498,244,7783,85,37695,265,45478,California
Mendocino,2021-05-20,302,81390,117,43451,140,35396,45,2543,105,7740,193,37888,150,45628,California
Mendocino,2021-05-21,652,82042,472,43923,165,35561,15,2558,506,8116,145,38033,521,46149,California
Mendocino,2021-05-22,787,82829,677,44600,102,35663,8,2566,239,7817,546,38579,247,46396,California
Mendocino,2021-05-23,29,82858,12,44612,10,35673,7,2573,15,7825,13,38592,21,46417,California
Mendocino,2021-05-24,129,82987,45,44657,63,35736,21,2594,60,7838,68,38660,81,46498,California
Mendocino,2021-05-25,300,83287,179,44836,89,35825,32,2626,134,7839,164,38824,165,46663,California
Mendocino,2021-05-26,327,83614,247,45083,68,35893,12,2638,133,7791,193,39017,145,46808,California
Mendocino,2021-05-27,258,83872,112,45195,120,36013,26,2664,110,7780,146,39163,135,46943,California
Mendocino,2021-05-28,236,84108,96,45291,126,36139,14,2678,151,7863,83,39246,166,47109,California
Mendocino,2021-05-29,49,84157,16,45307,28,36167,5,2683,24,7868,24,39270,29,47138,California
Mendocino,2021-05-30,16,84173,2,45309,13,36180,1,2684,11,7875,5,39275,12,47150,California
Mendocino,2021-05-31,8,84181,1,45310,6,36186,1,2685,2,7875,3,39278,3,47153,California
Mendocino,2021-06-01,319,84500,104,45414,206,36392,9,2694,85,7735,234,39512,94,47247,California
Mendocino,2021-06-02,156,84656,58,45472,90,36482,8,2702,52,7695,101,39613,61,47308,California
Mendocino,2021-06-03,561,85217,456,45928,92,36574,13,2715,121,7396,433,40046,134,47442,California
Mendocino,2021-06-04,328,85545,192,46120,113,36687,23,2738,94,7280,233,40279,117,47559,California
Mendocino,2021-06-05,228,85773,95,46215,115,36802,18,2756,74,7220,152,40431,92,47651,California
Mendocino,2021-06-06,64,85837,58,46273,3,36805,3,2759,2,7163,62,40493,5,47656,California
Mendocino,2021-06-07,150,85987,73,46346,64,36869,13,2772,58,7142,92,40585,71,47727,California
Mendocino,2021-06-08,240,86227,139,46485,88,36957,13,2785,109,7138,126,40711,122,47849,California
Mendocino,2021-06-09,309,86536,249,46734,50,37007,10,2795,105,7050,203,40914,115,47964,California
Mendocino,2021-06-10,131,86667,70,46804,45,37052,16,2811,58,7051,73,40987,74,48038,California
Mendocino,2021-06-11,772,87439,587,47391,158,37210,27,2838,129,6568,639,41626,156,48194,California
Mendocino,2021-06-12,77,87516,53,47444,18,37228,6,2844,28,6554,48,41674,34,48228,California
Mendocino,2021-06-13,29,87545,16,47460,11,37239,2,2846,15,6558,13,41687,17,48245,California
Mendocino,2021-06-14,131,87676,59,47519,53,37292,19,2865,49,6544,81,41768,67,48312,California
Mendocino,2021-06-15,260,87936,168,47687,73,37365,19,2884,84,6471,176,41944,103,48415,California
Mendocino,2021-06-16,275,88211,174,47861,80,37445,21,2905,71,6361,202,42146,92,48507,California
Mendocino,2021-06-17,171,88382,89,47950,61,37506,21,2926,55,6321,116,42262,76,48583,California
Mendocino,2021-06-18,295,88677,128,48078,137,37643,30,2956,88,6233,205,42467,117,48700,California
Mendocino,2021-06-19,76,88753,43,48121,26,37669,7,2963,17,6198,59,42526,24,48724,California
Mendocino,2021-06-20,12,88765,4,48125,4,37673,4,2967,7,6204,5,42531,11,48735,California
Mendocino,2021-06-21,100,88865,35,48160,54,37727,11,2978,43,6203,54,42585,53,48788,California
Mendocino,2021-06-22,133,88998,86,48246,34,37761,13,2991,56,6197,75,42660,69,48857,California
Mendocino,2021-06-23,228,89226,161,48407,37,37798,30,3021,103,6206,124,42784,133,48990,California
Mendocino,2021-06-24,213,89439,109,48516,87,37885,17,3038,81,6173,131,42915,98,49088,California
Mendocino,2021-06-25,190,89629,99,48615,79,37964,12,3050,77,6150,112,43027,89,49177,California
Mendocino,2021-06-26,74,89703,49,48664,21,37985,4,3054,23,6126,51,43078,27,49204,California
Mendocino,2021-06-27,23,89726,13,48677,9,37994,1,3055,13,6130,10,43088,14,49218,California
Mendocino,2021-06-28,67,89793,45,48722,11,38005,11,3066,21,6118,44,43132,32,49250,California
Mendocino,2021-06-29,170,89963,118,48840,49,38054,3,3069,55,6061,115,43247,58,49308,California
Mendocino,2021-06-30,183,90146,149,48989,27,38081,7,3076,59,6005,123,43370,67,49375,California
Mendocino,2021-07-01,114,90260,66,49055,38,38119,10,3086,64,6030,49,43419,74,49449,California
Mendocino,2021-07-02,103,90363,64,49119,29,38148,10,3096,48,6034,54,43473,58,49507,California
Mendocino,2021-07-03,39,90402,28,49147,9,38157,2,3098,18,6033,21,43494,20,49527,California
Mendocino,2021-07-04,1,90403,0,49147,1,38158,0,3098,1,6034,0,43494,1,49528,California
Mendocino,2021-07-05,37,90440,17,49164,15,38173,5,3103,15,6032,22,43516,20,49548,California
Mendocino,2021-07-06,211,90651,156,49320,41,38214,14,3117,88,6011,123,43639,102,49650,California
Mendocino,2021-07-07,87,90738,56,49376,22,38236,9,3126,37,6009,48,43687,46,49696,California
Mendocino,2021-07-08,115,90853,53,49429,53,38289,9,3135,48,5999,67,43754,57,49753,California
Mendocino,2021-07-09,208,91061,139,49568,44,38333,25,3160,76,5970,129,43883,100,49853,California
Mendocino,2021-07-10,24,91085,12,49580,12,38345,0,3160,14,5974,10,43893,14,49867,California
Mendocino,2021-07-11,21,91106,11,49591,4,38349,6,3166,8,5975,13,43906,14,49881,California
Mendocino,2021-07-12,85,91191,32,49623,51,38400,2,3168,39,5971,45,43951,41,49922,California
Mendocino,2021-07-13,228,91419,135,49758,69,38469,24,3192,125,6019,102,44053,150,50072,California
Mendocino,2021-07-14,85,91504,53,49811,21,38490,11,3203,39,6023,46,44099,50,50122,California
Mendocino,2021-07-15,98,91602,72,49883,24,38514,2,3205,53,6034,44,44143,55,50177,California
Mendocino,2021-07-16,245,91847,165,50048,66,38580,14,3219,126,6055,119,44262,140,50317,California
Mendocino,2021-07-17,46,91893,29,50077,15,38595,2,3221,21,6053,25,44287,23,50340,California
Mendocino,2021-07-18,13,91906,7,50084,5,38600,1,3222,5,6051,7,44294,5,50345,California
Mendocino,2021-07-19,70,91976,43,50127,25,38625,2,3224,49,6081,21,44315,51,50396,California
Mendocino,2021-07-20,178,92154,114,50241,60,38685,4,3228,111,6131,65,44380,115,50511,California
Mendocino,2021-07-21,118,92272,74,50315,42,38727,2,3230,58,6133,58,44438,60,50571,California
Mendocino,2021-07-22,136,92408,69,50384,51,38778,16,3246,74,6161,62,44500,90,50661,California
Mendocino,2021-07-23,281,92689,187,50571,75,38853,19,3265,172,6244,108,44608,191,50852,California
Mendocino,2021-07-24,73,92762,40,50611,30,38883,3,3268,46,6266,27,44635,49,50901,California
Mendocino,2021-07-25,38,92800,28,50639,10,38893,0,3268,33,6294,5,44640,33,50934,California
Mendocino,2021-07-26,83,92883,39,50678,38,38931,6,3274,50,6318,32,44672,56,50990,California
Mendocino,2021-07-27,218,93101,122,50800,67,38998,29,3303,128,6385,88,44760,155,51145,California
Mendocino,2021-07-28,148,93249,84,50884,55,39053,9,3312,110,6468,36,44796,119,51264,California
Mendocino,2021-07-29,129,93378,68,50952,54,39107,7,3319,83,6512,45,44841,89,51353,California
Mendocino,2021-07-30,294,93672,226,51178,64,39171,4,3323,224,6671,69,44910,228,51581,California
Mendocino,2021-07-31,18,93690,10,51188,6,39177,2,3325,12,6679,6,44916,14,51595,California
Merced,2020-12-16,3,3,3,3,0,0,0,0,3,3,0,0,3,3,California
Merced,2020-12-17,9,12,9,12,0,0,0,0,9,12,0,0,9,12,California
Merced,2020-12-18,145,157,145,157,0,0,0,0,145,157,0,0,145,157,California
Merced,2020-12-19,37,194,37,194,0,0,0,0,37,194,0,0,37,194,California
Merced,2020-12-20,18,212,18,212,0,0,0,0,18,212,0,0,18,212,California
Merced,2020-12-21,122,334,119,331,3,3,0,0,122,334,0,0,122,334,California
Merced,2020-12-22,155,489,155,486,0,3,0,0,155,489,0,0,155,489,California
Merced,2020-12-23,253,742,246,732,7,10,0,0,253,742,0,0,253,742,California
Merced,2020-12-24,72,814,72,804,0,10,0,0,72,814,0,0,72,814,California
Merced,2020-12-25,4,818,4,808,0,10,0,0,4,818,0,0,4,818,California
Merced,2020-12-26,6,824,3,811,3,13,0,0,6,824,0,0,6,824,California
Merced,2020-12-27,12,836,11,822,1,14,0,0,12,836,0,0,12,836,California
Merced,2020-12-28,125,961,98,920,27,41,0,0,125,961,0,0,125,961,California
Merced,2020-12-29,192,1153,124,1044,68,109,0,0,192,1153,0,0,192,1153,California
Merced,2020-12-30,218,1371,88,1132,130,239,0,0,218,1371,0,0,218,1371,California
Merced,2020-12-31,103,1474,34,1166,69,308,0,0,103,1474,0,0,103,1474,California
Merced,2021-01-01,6,1480,1,1167,5,313,0,0,6,1480,0,0,6,1480,California
Merced,2021-01-02,132,1612,120,1287,12,325,0,0,132,1612,0,0,132,1612,California
Merced,2021-01-03,9,1621,5,1292,4,329,0,0,9,1621,0,0,9,1621,California
Merced,2021-01-04,83,1704,42,1334,41,370,0,0,83,1704,0,0,83,1704,California
Merced,2021-01-05,330,2034,234,1568,96,466,0,0,324,2024,6,6,326,2030,California
Merced,2021-01-06,256,2290,104,1672,152,618,0,0,249,2268,7,13,251,2281,California
Merced,2021-01-07,188,2478,85,1757,103,721,0,0,175,2429,14,27,175,2456,California
Merced,2021-01-08,527,3005,394,2151,133,854,0,0,373,2649,153,180,373,2829,California
Merced,2021-01-09,23,3028,10,2161,13,867,0,0,17,2660,6,186,17,2846,California
Merced,2021-01-10,11,3039,7,2168,4,871,0,0,7,2663,4,190,7,2853,California
Merced,2021-01-11,231,3270,172,2340,59,930,0,0,103,2641,128,318,106,2959,California
Merced,2021-01-12,296,3566,170,2510,126,1056,0,0,248,2840,49,367,248,3207,California
Merced,2021-01-13,396,3962,177,2687,219,1275,0,0,241,2930,154,521,244,3451,California
Merced,2021-01-14,326,4288,205,2892,121,1396,0,0,159,2925,166,687,161,3612,California
Merced,2021-01-15,591,4879,131,3023,460,1856,0,0,552,3440,40,727,555,4167,California
Merced,2021-01-16,213,5092,130,3153,83,1939,0,0,196,3619,17,744,196,4363,California
Merced,2021-01-17,51,5143,12,3165,39,1978,0,0,49,3666,2,746,49,4412,California
Merced,2021-01-18,270,5413,130,3295,140,2118,0,0,245,3890,25,771,249,4661,California
Merced,2021-01-19,717,6130,591,3886,126,2244,0,0,542,4266,173,944,549,5210,California
Merced,2021-01-20,576,6706,469,4355,107,2351,0,0,518,4730,58,1002,522,5732,California
Merced,2021-01-21,1033,7739,658,5013,375,2726,0,0,928,5557,104,1106,931,6663,California
Merced,2021-01-22,1320,9059,696,5709,624,3350,0,0,1290,6831,29,1135,1303,7966,California
Merced,2021-01-23,335,9394,202,5911,133,3483,0,0,224,6944,111,1246,224,8190,California
Merced,2021-01-24,36,9430,15,5926,21,3504,0,0,28,6965,7,1253,28,8218,California
Merced,2021-01-25,745,10175,245,6171,500,4004,0,0,684,7590,60,1313,685,8903,California
Merced,2021-01-26,950,11125,488,6659,462,4466,0,0,692,8053,230,1543,693,9596,California
Merced,2021-01-27,1008,12133,591,7250,417,4883,0,0,832,8712,174,1717,833,10429,California
Merced,2021-01-28,1163,13296,599,7849,564,5447,0,0,1038,9628,124,1841,1040,11469,California
Merced,2021-01-29,871,14167,313,8162,558,6005,0,0,619,10009,240,2081,621,12090,California
Merced,2021-01-30,267,14434,28,8190,239,6244,0,0,249,10240,18,2099,249,12339,California
Merced,2021-01-31,49,14483,11,8201,38,6282,0,0,47,10286,1,2100,47,12386,California
Merced,2021-02-01,397,14880,53,8254,344,6626,0,0,342,10576,53,2153,343,12729,California
Merced,2021-02-02,313,15193,181,8435,132,6758,0,0,186,10639,124,2277,187,12916,California
Merced,2021-02-03,364,15557,78,8513,286,7044,0,0,182,10642,179,2456,182,13098,California
Merced,2021-02-04,390,15947,158,8671,232,7276,0,0,256,10767,132,2588,257,13355,California
Merced,2021-02-05,521,16468,178,8849,343,7619,0,0,280,10810,239,2827,282,13637,California
Merced,2021-02-06,394,16862,221,9070,173,7792,0,0,250,10920,141,2968,251,13888,California
Merced,2021-02-07,17,16879,10,9080,7,7799,0,0,10,10923,7,2975,10,13898,California
Merced,2021-02-08,294,17173,201,9281,93,7892,0,0,179,10990,113,3088,180,14078,California
Merced,2021-02-09,1230,18403,962,10243,268,8160,0,0,783,11335,439,3527,784,14862,California
Merced,2021-02-10,1911,20314,1445,11688,466,8626,0,0,1310,12055,590,4117,1310,16172,California
Merced,2021-02-11,2560,22874,2046,13734,514,9140,0,0,1840,13190,706,4823,1841,18013,California
Merced,2021-02-12,1745,24619,1029,14763,716,9856,0,0,764,12996,961,5784,767,18780,California
Merced,2021-02-13,371,24990,214,14977,157,10013,0,0,271,13174,95,5879,273,19053,California
Merced,2021-02-14,119,25109,26,15003,93,10106,0,0,97,13250,22,5901,98,19151,California
Merced,2021-02-15,282,25391,45,15048,237,10343,0,0,173,13322,102,6003,174,19325,California
Merced,2021-02-16,1237,26628,853,15901,384,10727,0,0,843,13795,374,6377,847,20172,California
Merced,2021-02-17,1919,28547,1670,17571,249,10976,0,0,1334,14573,564,6941,1342,21514,California
Merced,2021-02-18,1287,29834,876,18447,411,11387,0,0,456,14225,808,7749,460,21974,California
Merced,2021-02-19,1289,31123,439,18886,850,12237,0,0,551,14049,729,8478,553,22527,California
Merced,2021-02-20,290,31413,32,18918,258,12495,0,0,141,14043,147,8625,141,22668,California
Merced,2021-02-21,80,31493,66,18984,14,12509,0,0,27,14019,51,8676,27,22695,California
Merced,2021-02-22,857,32350,305,19289,552,13061,0,0,490,14147,364,9040,492,23187,California
Merced,2021-02-23,1115,33465,431,19720,684,13745,0,0,646,14333,463,9503,649,23836,California
Merced,2021-02-24,864,34329,312,20032,552,14297,0,0,461,14404,391,9894,462,24298,California
Merced,2021-02-25,1830,36159,912,20944,918,15215,0,0,1343,15267,483,10377,1346,25644,California
Merced,2021-02-26,2228,38387,1416,22360,812,16027,0,0,1762,16576,454,10831,1763,27407,California
Merced,2021-02-27,2642,41029,1199,23559,1443,17470,0,0,2349,18634,291,11122,2349,29756,California
Merced,2021-02-28,325,41354,75,23634,249,17719,1,1,259,18831,62,11184,259,30015,California
Merced,2021-03-01,1166,42520,289,23923,876,18595,1,2,792,19260,364,11548,793,30808,California
Merced,2021-03-02,1897,44417,1037,24960,859,19454,1,3,1486,20346,404,11952,1490,32298,California
Merced,2021-03-03,2484,46901,1975,26935,508,19962,1,4,1706,21298,756,12708,1708,34006,California
Merced,2021-03-04,3167,50068,2529,29464,636,20598,2,6,2171,22496,976,13684,2174,36180,California
Merced,2021-03-05,2370,52438,1477,30941,869,21467,24,30,1817,23799,539,14223,1842,38022,California
Merced,2021-03-06,1188,53626,677,31618,490,21957,21,51,917,24467,270,14493,938,38960,California
Merced,2021-03-07,245,53871,74,31692,140,22097,31,82,211,24675,34,14527,242,39202,California
Merced,2021-03-08,1588,55459,970,32662,551,22648,67,149,1345,25844,242,14769,1411,40613,California
Merced,2021-03-09,1884,57343,1145,33807,630,23278,109,258,1213,26505,661,15430,1322,41935,California
Merced,2021-03-10,2973,60316,1994,35801,779,24057,200,458,1638,27033,1315,16745,1843,43778,California
Merced,2021-03-11,2231,62547,845,36646,1181,25238,205,663,1239,27526,972,17717,1465,45243,California
Merced,2021-03-12,2560,65107,1115,37761,1166,26404,279,942,1659,28580,895,18612,1949,47192,California
Merced,2021-03-13,1031,66138,318,38079,469,26873,244,1186,713,29225,310,18922,955,48147,California
Merced,2021-03-14,269,66407,156,38235,81,26954,32,1218,149,29289,117,19039,181,48328,California
Merced,2021-03-15,1723,68130,672,38907,791,27745,260,1478,1183,30202,529,19568,1442,49770,California
Merced,2021-03-16,1671,69801,883,39790,561,28306,227,1705,1144,31060,514,20082,1372,51142,California
Merced,2021-03-17,2321,72122,1398,41188,745,29051,178,1883,1841,32612,467,20549,2019,53161,California
Merced,2021-03-18,2267,74389,1381,42569,737,29788,149,2032,1409,33343,840,21389,1571,54732,California
Merced,2021-03-19,2813,77202,1586,44155,1027,30815,200,2232,1402,33547,1397,22786,1601,56333,California
Merced,2021-03-20,2477,79679,1534,45689,546,31361,397,2629,975,33431,1493,24279,1377,57710,California
Merced,2021-03-21,570,80249,346,46035,211,31572,13,2642,447,33772,121,24400,462,58172,California
Merced,2021-03-22,1282,81531,640,46675,566,32138,76,2718,892,34361,381,24781,970,59142,California
Merced,2021-03-23,1981,83512,1237,47912,679,32817,65,2783,1378,35212,592,25373,1443,60585,California
Merced,2021-03-24,1733,85245,1174,49086,523,33340,36,2819,1006,35541,713,26086,1042,61627,California
Merced,2021-03-25,3630,88875,2558,51644,1048,34388,24,2843,2123,36208,1483,27569,2150,63777,California
Merced,2021-03-26,2207,91082,1344,52988,827,35215,36,2879,902,35873,1272,28841,937,64714,California
Merced,2021-03-27,3608,94690,1932,54920,1253,36468,423,3302,1568,35840,2024,30865,1991,66705,California
Merced,2021-03-28,533,95223,221,55141,304,36772,8,3310,216,35750,314,31179,224,66929,California
Merced,2021-03-29,1993,97216,920,56061,902,37674,171,3481,687,35319,1291,32470,860,67789,California
Merced,2021-03-30,2297,99513,923,56984,1315,38989,59,3540,1010,35109,1281,33751,1071,68860,California
Merced,2021-03-31,2402,101915,1493,58477,724,39713,185,3725,993,34902,1384,35135,1177,70037,California
Merced,2021-04-01,2622,104537,1066,59543,1198,40911,358,4083,1069,34793,1535,36670,1426,71463,California
Merced,2021-04-02,2487,107024,752,60295,1311,42222,424,4507,796,34361,1643,38313,1211,72674,California
Merced,2021-04-03,1112,108136,619,60914,474,42696,19,4526,676,34631,426,38739,696,73370,California
Merced,2021-04-04,371,108507,144,61058,225,42921,2,4528,140,34544,230,38969,143,73513,California
Merced,2021-04-05,1524,110031,835,61893,475,43396,214,4742,413,34070,1101,40070,627,74140,California
Merced,2021-04-06,2609,112640,1071,62964,707,44103,831,5573,891,34082,1709,41779,1721,75861,California
Merced,2021-04-07,1927,114567,1141,64105,678,44781,108,5681,594,33494,1293,43072,705,76566,California
Merced,2021-04-08,2525,117092,1365,65470,940,45721,220,5901,1007,33251,1467,44539,1224,77790,California
Merced,2021-04-09,1731,118823,487,65957,660,46381,584,6485,564,33254,1145,45684,1148,78938,California
Merced,2021-04-10,987,119810,373,66330,427,46808,187,6672,179,32817,801,46485,364,79302,California
Merced,2021-04-11,490,120300,284,66614,71,46879,135,6807,149,32763,339,46824,285,79587,California
Merced,2021-04-12,1536,121836,1003,67617,406,47285,127,6934,874,33143,622,47446,1002,80589,California
Merced,2021-04-13,2068,123904,1480,69097,586,47871,2,6936,939,33060,1028,48474,945,81534,California
Merced,2021-04-14,2263,126167,1403,70500,860,48731,0,6936,1052,33039,1074,49548,1053,82587,California
Merced,2021-04-15,3058,129225,1990,72490,1068,49799,0,6936,940,32104,1879,51427,944,83531,California
Merced,2021-04-16,2426,131651,1179,73669,1247,51046,0,6936,968,31722,1350,52777,968,84499,California
Merced,2021-04-17,2163,133814,1488,75157,674,51720,1,6937,666,30904,1489,54266,671,85170,California
Merced,2021-04-18,526,134340,300,75457,226,51946,0,6937,199,30804,299,54565,199,85369,California
Merced,2021-04-19,1377,135717,763,76220,614,52560,0,6937,708,30944,568,55133,708,86077,California
Merced,2021-04-20,1564,137281,795,77015,769,53329,0,6937,813,31079,678,55811,813,86890,California
Merced,2021-04-21,1661,138942,1050,78065,611,53940,0,6937,801,31137,744,56555,802,87692,California
Merced,2021-04-22,1732,140674,797,78862,935,54875,0,6937,790,31080,848,57403,791,88483,California
Merced,2021-04-23,1721,142395,733,79595,988,55863,0,6937,923,31255,749,58152,924,89407,California
Merced,2021-04-24,894,143289,712,80307,182,56045,0,6937,550,31468,337,58489,550,89957,California
Merced,2021-04-25,334,143623,190,80497,144,56189,0,6937,192,31524,137,58626,193,90150,California
Merced,2021-04-26,1299,144922,567,81064,732,56921,0,6937,650,31565,611,59237,652,90802,California
Merced,2021-04-27,1844,146766,937,82001,895,57816,12,6949,744,31292,1029,60266,756,91558,California
Merced,2021-04-28,1446,148212,729,82730,708,58524,9,6958,817,31516,603,60869,827,92385,California
Merced,2021-04-29,1521,149733,686,83416,810,59334,25,6983,716,31467,791,61660,742,93127,California
Merced,2021-04-30,1524,151257,658,84074,821,60155,45,7028,791,31578,725,62385,836,93963,California
Merced,2021-05-01,578,151835,245,84319,328,60483,5,7033,271,31554,299,62684,275,94238,California
Merced,2021-05-02,302,152137,123,84442,164,60647,15,7048,124,31517,177,62861,140,94378,California
Merced,2021-05-03,887,153024,586,85028,228,60875,73,7121,318,31345,565,63426,393,94771,California
Merced,2021-05-04,1082,154106,593,85621,437,61312,52,7173,395,31112,680,64106,447,95218,California
Merced,2021-05-05,1478,155584,966,86587,436,61748,76,7249,650,31024,814,64920,726,95944,California
Merced,2021-05-06,956,156540,509,87096,397,62145,50,7299,316,30760,630,65550,366,96310,California
Merced,2021-05-07,1195,157735,533,87629,620,62765,42,7341,469,30554,721,66271,515,96825,California
Merced,2021-05-08,456,158191,256,87885,163,62928,37,7378,220,30577,234,66505,257,97082,California
Merced,2021-05-09,214,158405,106,87991,101,63029,7,7385,96,30563,117,66622,103,97185,California
Merced,2021-05-10,737,159142,392,88383,308,63337,37,7422,206,30279,527,67149,243,97428,California
Merced,2021-05-11,1217,160359,734,89117,423,63760,60,7482,479,30086,732,67881,539,97967,California
Merced,2021-05-12,1127,161486,645,89762,440,64200,42,7524,384,29773,739,68620,426,98393,California
Merced,2021-05-13,975,162461,563,90325,369,64569,43,7567,447,29741,522,69142,490,98883,California
Merced,2021-05-14,1097,163558,679,91004,378,64947,40,7607,581,29857,508,69650,624,99507,California
Merced,2021-05-15,771,164329,584,91588,168,65115,19,7626,458,30034,302,69952,479,99986,California
Merced,2021-05-16,370,164699,254,91842,107,65222,9,7635,215,30108,151,70103,225,100211,California
Merced,2021-05-17,1111,165810,723,92565,356,65578,32,7667,544,30126,560,70663,578,100789,California
Merced,2021-05-18,1286,167096,859,93424,396,65974,31,7698,709,30297,569,71232,740,101529,California
Merced,2021-05-19,1157,168253,767,94191,383,66357,7,7705,651,30458,501,71733,662,102191,California
Merced,2021-05-20,1103,169356,596,94787,450,66807,57,7762,426,30269,675,72408,486,102677,California
Merced,2021-05-21,1216,170572,705,95492,482,67289,29,7791,496,30090,706,73114,527,103204,California
Merced,2021-05-22,793,171365,573,96065,206,67495,14,7805,476,30269,314,73428,493,103697,California
Merced,2021-05-23,362,171727,261,96326,88,67583,13,7818,237,30395,124,73552,250,103947,California
Merced,2021-05-24,637,172364,274,96600,332,67915,31,7849,232,30261,398,73950,264,104211,California
Merced,2021-05-25,783,173147,440,97040,309,68224,34,7883,398,30312,380,74330,431,104642,California
Merced,2021-05-26,1010,174157,561,97601,416,68640,33,7916,402,30144,604,74934,436,105078,California
Merced,2021-05-27,938,175095,659,98260,242,68882,37,7953,561,30370,373,75307,599,105677,California
Merced,2021-05-28,792,175887,366,98626,379,69261,47,8000,341,30316,442,75749,388,106065,California
Merced,2021-05-29,392,176279,271,98897,113,69374,8,8008,158,30252,231,75980,167,106232,California
Merced,2021-05-30,213,176492,146,99043,56,69430,11,8019,129,30308,84,76064,140,106372,California
Merced,2021-05-31,111,176603,25,99068,80,69510,6,8025,31,30268,78,76142,38,106410,California
Merced,2021-06-01,876,177479,548,99616,294,69804,34,8059,321,30073,549,76691,354,106764,California
Merced,2021-06-02,768,178247,495,100111,246,70050,27,8086,352,30044,408,77099,379,107143,California
Merced,2021-06-03,780,179027,500,100611,246,70296,34,8120,302,29910,471,77570,337,107480,California
Merced,2021-06-04,843,179870,454,101065,367,70663,22,8142,312,29721,524,78094,335,107815,California
Merced,2021-06-05,518,180388,407,101472,98,70761,13,8155,193,29607,320,78414,206,108021,California
Merced,2021-06-06,233,180621,194,101666,31,70792,8,8163,83,29548,149,78563,90,108111,California
Merced,2021-06-07,667,181288,535,102201,119,70911,13,8176,196,29288,471,79034,211,108322,California
Merced,2021-06-08,871,182159,640,102841,205,71116,26,8202,275,28998,591,79625,301,108623,California
Merced,2021-06-09,894,183053,657,103498,220,71336,17,8219,266,28665,617,80242,284,108907,California
Merced,2021-06-10,657,183710,450,103948,183,71519,24,8243,256,28550,394,80636,279,109186,California
Merced,2021-06-11,576,184286,365,104313,194,71713,17,8260,237,28470,336,80972,256,109442,California
Merced,2021-06-12,600,184886,490,104803,86,71799,24,8284,179,28254,419,81391,203,109645,California
Merced,2021-06-13,259,185145,134,104937,118,71917,7,8291,64,28130,195,81586,71,109716,California
Merced,2021-06-14,559,185704,366,105303,159,72076,34,8325,259,28127,297,81883,294,110010,California
Merced,2021-06-15,802,186506,573,105876,201,72277,28,8353,270,27902,524,82407,299,110309,California
Merced,2021-06-16,735,187241,506,106382,203,72480,26,8379,335,27873,390,82797,361,110670,California
Merced,2021-06-17,746,187987,566,106948,149,72629,31,8410,242,27650,496,83293,273,110943,California
Merced,2021-06-18,783,188770,510,107458,242,72871,31,8441,393,27692,383,83676,425,111368,California
Merced,2021-06-19,368,189138,253,107711,88,72959,27,8468,201,27754,165,83841,227,111595,California
Merced,2021-06-20,245,189383,191,107902,46,73005,8,8476,141,27800,103,83944,149,111744,California
Merced,2021-06-21,326,189709,200,108102,114,73119,12,8488,203,27893,122,84066,215,111959,California
Merced,2021-06-22,521,190230,360,108462,140,73259,21,8509,255,27904,266,84332,277,112236,California
Merced,2021-06-23,587,190817,367,108829,209,73468,11,8520,293,27922,286,84618,304,112540,California
Merced,2021-06-24,551,191368,390,109219,129,73597,32,8552,258,27923,289,84907,290,112830,California
Merced,2021-06-25,489,191857,342,109561,123,73720,24,8576,257,27978,226,85133,281,113111,California
Merced,2021-06-26,192,192049,131,109692,52,73772,9,8585,92,27983,98,85231,103,113214,California
Merced,2021-06-27,211,192260,150,109842,40,73812,21,8606,124,28042,86,85317,145,113359,California
Merced,2021-06-28,343,192603,225,110067,101,73913,17,8623,180,28079,160,85477,197,113556,California
Merced,2021-06-29,336,192939,200,110267,114,74027,22,8645,155,28077,179,85656,177,113733,California
Merced,2021-06-30,446,193385,254,110521,171,74198,21,8666,248,28153,193,85849,269,114002,California
Merced,2021-07-01,383,193768,258,110779,111,74309,14,8680,216,28217,167,86016,231,114233,California
Merced,2021-07-02,388,194156,267,111046,107,74416,14,8694,216,28278,170,86186,231,114464,California
Merced,2021-07-03,197,194353,123,111169,62,74478,12,8706,102,28300,92,86278,114,114578,California
Merced,2021-07-04,17,194370,5,111174,11,74489,1,8707,8,28300,9,86287,9,114587,California
Merced,2021-07-05,238,194608,157,111331,77,74566,4,8711,127,28320,111,86398,131,114718,California
Merced,2021-07-06,362,194970,229,111560,116,74682,17,8728,155,28291,201,86599,172,114890,California
Merced,2021-07-07,366,195336,205,111765,149,74831,12,8740,161,28261,203,86802,173,115063,California
Merced,2021-07-08,397,195733,289,112054,102,74933,6,8746,176,28222,221,87023,182,115245,California
Merced,2021-07-09,479,196212,332,112386,126,75059,21,8767,218,28201,260,87283,239,115484,California
Merced,2021-07-10,159,196371,117,112503,36,75095,6,8773,86,28220,73,87356,92,115576,California
Merced,2021-07-11,192,196563,158,112661,31,75126,3,8776,66,28166,123,87479,69,115645,California
Merced,2021-07-12,323,196886,209,112870,104,75230,10,8786,150,28154,173,87652,161,115806,California
Merced,2021-07-13,307,197193,215,113085,83,75313,9,8795,136,28129,170,87822,145,115951,California
Merced,2021-07-14,364,197557,211,113296,145,75458,8,8803,169,28114,193,88015,178,116129,California
Merced,2021-07-15,368,197925,294,113590,67,75525,7,8810,192,28138,175,88190,199,116328,California
Merced,2021-07-16,401,198326,250,113840,136,75661,15,8825,203,28158,197,88387,217,116545,California
Merced,2021-07-17,182,198508,122,113962,51,75712,9,8834,105,28196,76,88463,114,116659,California
Merced,2021-07-18,108,198616,67,114029,29,75741,12,8846,53,28208,53,88516,65,116724,California
Merced,2021-07-19,355,198971,251,114280,92,75833,12,8858,191,28250,161,88677,203,116927,California
Merced,2021-07-20,357,199328,270,114550,79,75912,8,8866,173,28247,184,88861,181,117108,California
Merced,2021-07-21,405,199733,265,114815,127,76039,13,8879,215,28288,187,89048,228,117336,California
Merced,2021-07-22,402,200135,273,115088,114,76153,15,8894,232,28368,167,89215,247,117583,California
Merced,2021-07-23,455,200590,319,115407,118,76271,18,8912,272,28477,179,89394,288,117871,California
Merced,2021-07-24,228,200818,143,115550,80,76351,5,8917,131,28517,96,89490,136,118007,California
Merced,2021-07-25,107,200925,65,115615,38,76389,4,8921,81,28577,25,89515,85,118092,California
Merced,2021-07-26,353,201278,210,115825,131,76520,12,8933,214,28667,136,89651,226,118318,California
Merced,2021-07-27,445,201723,330,116155,105,76625,10,8943,289,28813,153,89804,299,118617,California
Merced,2021-07-28,438,202161,243,116398,176,76801,19,8962,277,28951,158,89962,296,118913,California
Merced,2021-07-29,361,202522,263,116661,89,76890,9,8971,243,29085,118,90080,252,119165,California
Merced,2021-07-30,313,202835,175,116836,111,77001,27,8998,199,29198,113,90193,226,119391,California
Merced,2021-07-31,70,202905,42,116878,27,77028,1,8999,47,29223,23,90216,48,119439,California
Modoc,2020-12-16,2,2,2,2,0,0,0,0,2,2,0,0,2,2,California
Modoc,2020-12-21,99,101,99,101,0,0,0,0,99,101,0,0,99,101,California
Modoc,2020-12-22,14,115,14,115,0,0,0,0,14,115,0,0,14,115,California
Modoc,2020-12-23,4,119,4,119,0,0,0,0,4,119,0,0,4,119,California
Modoc,2020-12-24,1,120,1,120,0,0,0,0,1,120,0,0,1,120,California
Modoc,2020-12-28,2,122,2,122,0,0,0,0,2,122,0,0,2,122,California
Modoc,2020-12-29,9,131,1,123,8,8,0,0,9,131,0,0,9,131,California
Modoc,2020-12-30,9,140,2,125,7,15,0,0,9,140,0,0,9,140,California
Modoc,2021-01-02,3,143,1,126,2,17,0,0,3,143,0,0,3,143,California
Modoc,2021-01-04,8,151,0,126,8,25,0,0,8,151,0,0,8,151,California
Modoc,2021-01-05,3,154,2,128,1,26,0,0,3,154,0,0,3,154,California
Modoc,2021-01-06,5,159,4,132,1,27,0,0,3,155,2,2,3,157,California
Modoc,2021-01-07,72,231,0,132,72,99,0,0,72,227,0,2,72,229,California
Modoc,2021-01-08,108,339,0,132,108,207,0,0,108,335,0,2,108,337,California
Modoc,2021-01-10,1,340,1,133,0,207,0,0,0,334,1,3,0,337,California
Modoc,2021-01-11,90,430,81,214,9,216,0,0,19,282,71,74,19,356,California
Modoc,2021-01-12,94,524,25,239,69,285,0,0,68,324,26,100,68,424,California
Modoc,2021-01-13,24,548,4,243,20,305,0,0,22,344,2,102,22,446,California
Modoc,2021-01-14,128,676,6,249,122,427,0,0,123,462,5,107,123,569,California
Modoc,2021-01-15,6,682,1,250,5,432,0,0,6,468,0,107,6,575,California
Modoc,2021-01-16,2,684,1,251,1,433,0,0,2,470,0,107,2,577,California
Modoc,2021-01-18,3,687,1,252,2,435,0,0,3,473,0,107,3,580,California
Modoc,2021-01-19,5,692,3,255,2,437,0,0,3,474,2,109,3,583,California
Modoc,2021-01-20,15,707,4,259,11,448,0,0,13,485,2,111,13,596,California
Modoc,2021-01-21,160,867,2,261,158,606,0,0,160,645,0,111,160,756,California
Modoc,2021-01-22,4,871,2,263,2,608,0,0,4,649,0,111,4,760,California
Modoc,2021-01-25,12,883,0,263,12,620,0,0,13,662,0,111,13,773,California
Modoc,2021-01-26,119,1002,2,265,117,737,0,0,118,779,1,112,118,891,California
Modoc,2021-01-27,48,1050,3,268,45,782,0,0,33,797,15,127,33,924,California
Modoc,2021-01-28,148,1198,4,272,144,926,0,0,147,943,1,128,147,1071,California
Modoc,2021-01-29,4,1202,1,273,3,929,0,0,4,947,0,128,4,1075,California
Modoc,2021-02-01,26,1228,12,285,14,943,0,0,12,945,14,142,12,1087,California
Modoc,2021-02-02,176,1404,2,287,174,1117,0,0,173,1115,3,145,173,1260,California
Modoc,2021-02-03,18,1422,13,300,5,1122,0,0,11,1119,7,152,11,1271,California
Modoc,2021-02-04,160,1582,3,303,157,1279,0,0,31,1021,129,281,31,1302,California
Modoc,2021-02-05,4,1586,2,305,2,1281,0,0,2,1021,2,283,2,1304,California
Modoc,2021-02-08,11,1597,1,306,10,1291,0,0,10,1030,1,284,10,1314,California
Modoc,2021-02-09,199,1796,11,317,188,1479,0,0,66,963,133,417,66,1380,California
Modoc,2021-02-10,6,1802,3,320,3,1482,0,0,4,965,2,419,4,1384,California
Modoc,2021-02-11,201,2003,2,322,199,1681,0,0,84,932,117,536,84,1468,California
Modoc,2021-02-12,9,2012,2,324,7,1688,0,0,3,929,6,542,3,1471,California
Modoc,2021-02-13,2,2014,0,324,2,1690,0,0,1,929,1,543,1,1472,California
Modoc,2021-02-16,147,2161,6,330,141,1831,0,0,140,1062,7,550,140,1612,California
Modoc,2021-02-17,24,2185,2,332,22,1853,0,0,10,1058,14,564,10,1622,California
Modoc,2021-02-18,191,2376,4,336,187,2040,0,0,22,914,168,732,24,1646,California
Modoc,2021-02-19,4,2380,4,340,0,2040,0,0,2,914,2,734,2,1648,California
Modoc,2021-02-20,1,2381,1,341,0,2040,0,0,0,913,1,735,0,1648,California
Modoc,2021-02-22,18,2399,8,349,10,2050,0,0,3,901,15,750,3,1651,California
Modoc,2021-02-23,88,2487,2,351,86,2136,0,0,14,842,73,823,14,1665,California
Modoc,2021-02-24,96,2583,3,354,93,2229,0,0,32,810,64,887,32,1697,California
Modoc,2021-02-25,172,2755,0,354,172,2401,0,0,13,664,159,1046,13,1710,California
Modoc,2021-02-26,2,2757,0,354,2,2403,0,0,1,664,1,1047,1,1711,California
Modoc,2021-02-27,2,2759,2,356,0,2403,0,0,2,666,0,1047,2,1713,California
Modoc,2021-03-01,7,2766,0,356,7,2410,0,0,1,662,5,1052,1,1714,California
Modoc,2021-03-02,198,2964,11,367,187,2597,0,0,26,516,172,1224,26,1740,California
Modoc,2021-03-03,12,2976,6,373,6,2603,0,0,2,508,10,1234,2,1742,California
Modoc,2021-03-04,174,3150,0,373,174,2777,0,0,146,626,28,1262,146,1888,California
Modoc,2021-03-05,2,3152,1,374,1,2778,0,0,1,626,1,1263,1,1889,California
Modoc,2021-03-06,11,3163,0,374,1,2779,10,10,1,627,10,1273,11,1900,California
Modoc,2021-03-07,8,3171,2,376,0,2779,6,16,2,629,6,1279,8,1908,California
Modoc,2021-03-08,8,3179,1,377,3,2782,4,20,1,628,6,1285,5,1913,California
Modoc,2021-03-09,128,3307,10,387,109,2891,9,29,61,631,67,1352,70,1983,California
Modoc,2021-03-10,9,3316,3,390,2,2893,4,33,4,634,5,1357,8,1991,California
Modoc,2021-03-11,209,3525,1,391,99,2992,109,142,23,580,186,1543,132,2123,California
Modoc,2021-03-12,10,3535,1,392,4,2996,5,147,4,583,6,1549,9,2132,California
Modoc,2021-03-13,6,3541,0,392,3,2999,3,150,1,582,5,1554,4,2136,California
Modoc,2021-03-15,13,3554,0,392,12,3011,1,151,12,594,1,1555,13,2149,California
Modoc,2021-03-16,174,3728,2,394,168,3179,4,155,42,507,132,1687,45,2194,California
Modoc,2021-03-17,12,3740,2,396,5,3184,5,160,3,506,9,1696,8,2202,California
Modoc,2021-03-18,67,3807,2,398,58,3242,7,167,35,516,32,1728,42,2244,California
Modoc,2021-03-19,5,3812,0,398,0,3242,5,172,0,516,5,1733,5,2249,California
Modoc,2021-03-20,5,3817,2,400,0,3242,3,175,0,514,5,1738,3,2252,California
Modoc,2021-03-21,3,3820,1,401,0,3242,2,177,1,515,2,1740,3,2255,California
Modoc,2021-03-22,17,3837,1,402,11,3253,5,182,12,527,5,1745,17,2272,California
Modoc,2021-03-23,65,3902,6,408,56,3309,3,185,43,551,22,1767,46,2318,California
Modoc,2021-03-24,29,3931,1,409,18,3327,10,195,1,534,28,1795,11,2329,California
Modoc,2021-03-25,79,4010,3,412,74,3401,2,197,47,551,32,1827,49,2378,California
Modoc,2021-03-26,7,4017,3,415,1,3402,3,200,2,551,5,1832,5,2383,California
Modoc,2021-03-27,2,4019,0,415,1,3403,1,201,1,552,1,1833,2,2385,California
Modoc,2021-03-29,15,4034,1,416,6,3409,8,209,6,557,9,1842,14,2399,California
Modoc,2021-03-30,54,4088,8,424,40,3449,6,215,21,551,33,1875,27,2426,California
Modoc,2021-03-31,10,4098,2,426,4,3453,4,219,4,553,6,1881,8,2434,California
Modoc,2021-04-01,169,4267,3,429,161,3614,5,224,34,457,135,2016,39,2473,California
Modoc,2021-04-02,5,4272,0,429,2,3616,3,227,1,458,3,2019,4,2477,California
Modoc,2021-04-03,3,4275,0,429,0,3616,3,230,0,458,2,2021,2,2479,California
Modoc,2021-04-05,10,4285,0,429,9,3625,1,231,9,467,1,2022,10,2489,California
Modoc,2021-04-06,23,4308,5,434,8,3633,10,241,5,464,18,2040,15,2504,California
Modoc,2021-04-07,12,4320,1,435,4,3637,7,248,3,465,9,2049,10,2514,California
Modoc,2021-04-08,94,4414,1,436,92,3729,1,249,26,424,68,2117,27,2541,California
Modoc,2021-04-09,11,4425,2,438,6,3735,3,252,2,419,9,2126,4,2545,California
Modoc,2021-04-10,5,4430,0,438,1,3736,4,256,0,418,5,2131,4,2549,California
Modoc,2021-04-11,2,4432,2,440,0,3736,0,256,1,418,1,2132,1,2550,California
Modoc,2021-04-12,13,4445,0,440,9,3745,4,260,1,412,11,2143,5,2555,California
Modoc,2021-04-13,33,4478,29,469,4,3749,0,260,22,423,11,2154,22,2577,California
Modoc,2021-04-14,3,4481,2,471,1,3750,0,260,1,422,2,2156,1,2578,California
Modoc,2021-04-15,102,4583,0,471,102,3852,0,260,29,379,72,2228,29,2607,California
Modoc,2021-04-16,7,4590,5,476,2,3854,0,260,6,384,1,2229,6,2613,California
Modoc,2021-04-17,2,4592,2,478,0,3854,0,260,2,386,0,2229,2,2615,California
Modoc,2021-04-18,1,4593,0,478,1,3855,0,260,1,387,0,2229,1,2616,California
Modoc,2021-04-19,7,4600,0,478,7,3862,0,260,2,384,5,2234,2,2618,California
Modoc,2021-04-20,48,4648,2,480,46,3908,0,260,12,360,36,2270,12,2630,California
Modoc,2021-04-21,2,4650,2,482,0,3908,0,260,1,360,1,2271,1,2631,California
Modoc,2021-04-22,97,4747,3,485,94,4002,0,260,38,339,59,2330,38,2669,California
Modoc,2021-04-23,4,4751,0,485,4,4006,0,260,4,343,0,2330,4,2673,California
Modoc,2021-04-24,2,4753,0,485,1,4007,1,261,1,344,1,2331,2,2675,California
Modoc,2021-04-25,1,4754,1,486,0,4007,0,261,1,345,0,2331,1,2676,California
Modoc,2021-04-26,8,4762,0,486,8,4015,0,261,2,341,6,2337,2,2678,California
Modoc,2021-04-27,7,4769,5,491,1,4016,1,262,1,337,6,2343,2,2680,California
Modoc,2021-04-28,7,4776,1,492,5,4021,1,263,2,335,5,2348,3,2683,California
Modoc,2021-04-29,65,4841,0,492,65,4086,0,263,20,310,45,2393,20,2703,California
Modoc,2021-04-30,4,4845,3,495,1,4087,0,263,2,310,2,2395,2,2705,California
Modoc,2021-05-02,3,4848,3,498,0,4087,0,263,2,311,1,2396,2,2707,California
Modoc,2021-05-03,15,4863,0,498,15,4102,0,263,6,308,9,2405,6,2713,California
Modoc,2021-05-04,8,4871,2,500,4,4106,2,265,3,308,5,2410,5,2718,California
Modoc,2021-05-05,28,4899,25,525,2,4108,1,266,8,297,20,2430,9,2727,California
Modoc,2021-05-06,55,4954,3,528,50,4158,2,268,21,286,34,2464,23,2750,California
Modoc,2021-05-07,8,4962,3,531,3,4161,2,270,2,284,6,2470,4,2754,California
Modoc,2021-05-08,3,4965,2,533,0,4161,1,271,1,284,2,2472,2,2756,California
Modoc,2021-05-09,1,4966,1,534,0,4161,0,271,0,283,1,2473,0,2756,California
Modoc,2021-05-10,2,4968,0,534,1,4162,1,272,1,284,1,2474,2,2758,California
Modoc,2021-05-11,3,4971,2,536,0,4162,1,273,0,282,3,2477,1,2759,California
Modoc,2021-05-12,3,4974,0,536,0,4162,3,276,0,282,3,2480,3,2762,California
Modoc,2021-05-13,44,5018,0,536,40,4202,4,280,14,270,30,2510,18,2780,California
Modoc,2021-05-14,8,5026,3,539,0,4202,5,285,3,273,5,2515,8,2788,California
Modoc,2021-05-15,1,5027,0,539,1,4203,0,285,1,274,0,2515,1,2789,California
Modoc,2021-05-16,2,5029,1,540,1,4204,0,285,0,272,2,2517,0,2789,California
Modoc,2021-05-17,6,5035,2,542,4,4208,0,285,3,272,3,2520,3,2792,California
Modoc,2021-05-18,28,5063,12,554,14,4222,2,287,13,272,15,2535,15,2807,California
Modoc,2021-05-19,8,5071,1,555,3,4225,4,291,4,276,4,2539,8,2815,California
Modoc,2021-05-20,57,5128,2,557,46,4271,9,300,8,244,49,2588,17,2832,California
Modoc,2021-05-21,4,5132,2,559,1,4272,1,301,0,241,4,2592,1,2833,California
Modoc,2021-05-22,3,5135,2,561,1,4273,0,301,1,240,2,2594,1,2834,California
Modoc,2021-05-23,2,5137,2,563,0,4273,0,301,0,238,2,2596,0,2834,California
Modoc,2021-05-24,4,5141,1,564,1,4274,2,303,2,240,2,2598,4,2838,California
Modoc,2021-05-25,1,5142,0,564,1,4275,0,303,1,241,0,2598,1,2839,California
Modoc,2021-05-26,35,5177,32,596,3,4278,0,303,26,258,9,2607,26,2865,California
Modoc,2021-05-27,31,5208,3,599,22,4300,6,309,8,249,23,2630,14,2879,California
Modoc,2021-05-28,8,5216,1,600,4,4304,3,312,3,250,5,2635,6,2885,California
Modoc,2021-05-29,1,5217,1,601,0,4304,0,312,0,249,1,2636,0,2885,California
Modoc,2021-05-31,1,5218,0,601,0,4304,1,313,0,249,0,2636,0,2885,California
Modoc,2021-06-01,7,5225,1,602,5,4309,1,314,3,249,4,2640,4,2889,California
Modoc,2021-06-02,12,5237,0,602,10,4319,2,316,4,247,8,2648,6,2895,California
Modoc,2021-06-03,24,5261,1,603,21,4340,2,318,4,233,20,2668,6,2901,California
Modoc,2021-06-04,5,5266,3,606,1,4341,1,319,0,229,5,2673,1,2902,California
Modoc,2021-06-07,3,5269,3,609,0,4341,0,319,1,228,2,2675,1,2903,California
Modoc,2021-06-08,27,5296,9,618,17,4358,1,320,17,236,10,2685,18,2921,California
Modoc,2021-06-09,3,5299,2,620,1,4359,0,320,2,237,1,2686,2,2923,California
Modoc,2021-06-10,21,5320,1,621,19,4378,1,321,7,231,14,2700,8,2931,California
Modoc,2021-06-11,2,5322,1,622,1,4379,0,321,2,233,0,2700,2,2933,California
Modoc,2021-06-12,1,5323,1,623,0,4379,0,321,0,232,1,2701,0,2933,California
Modoc,2021-06-14,4,5327,0,623,2,4381,2,323,0,230,4,2705,2,2935,California
Modoc,2021-06-15,7,5334,1,624,4,4385,2,325,4,233,3,2708,6,2941,California
Modoc,2021-06-16,41,5375,25,649,11,4396,5,330,22,243,19,2727,29,2970,California
Modoc,2021-06-17,48,5423,22,671,25,4421,1,331,27,250,21,2748,28,2998,California
Modoc,2021-06-18,5,5428,0,671,3,4424,2,333,3,253,2,2750,5,3003,California
Modoc,2021-06-19,3,5431,0,671,1,4425,2,335,1,254,2,2752,3,3006,California
Modoc,2021-06-21,2,5433,1,672,1,4426,0,335,2,256,0,2752,2,3008,California
Modoc,2021-06-22,11,5444,4,676,7,4433,0,335,8,261,3,2755,8,3016,California
Modoc,2021-06-23,6,5450,0,676,3,4436,3,338,1,260,5,2760,4,3020,California
Modoc,2021-06-24,33,5483,14,690,15,4451,4,342,23,277,10,2770,27,3047,California
Modoc,2021-06-25,7,5490,0,690,5,4456,2,344,2,276,5,2775,4,3051,California
Modoc,2021-06-28,4,5494,1,691,3,4459,0,344,3,278,1,2776,3,3054,California
Modoc,2021-06-29,10,5504,1,692,8,4467,1,345,7,283,3,2779,8,3062,California
Modoc,2021-06-30,8,5512,1,693,7,4474,0,345,5,285,3,2782,5,3067,California
Modoc,2021-07-01,23,5535,11,704,1,4475,11,356,9,291,14,2796,20,3087,California
Modoc,2021-07-02,2,5537,2,706,0,4475,0,356,0,289,2,2798,0,3087,California
Modoc,2021-07-03,3,5540,0,706,3,4478,0,356,3,292,0,2798,3,3090,California
Modoc,2021-07-06,11,5551,4,710,7,4485,0,356,6,293,5,2803,6,3096,California
Modoc,2021-07-07,6,5557,1,711,4,4489,1,357,3,294,3,2806,4,3100,California
Modoc,2021-07-08,72,5629,36,747,31,4520,5,362,20,267,52,2858,25,3125,California
Modoc,2021-07-09,1,5630,0,747,0,4520,1,363,0,267,1,2859,1,3126,California
Modoc,2021-07-10,1,5631,0,747,1,4521,0,363,1,268,0,2859,1,3127,California
Modoc,2021-07-11,1,5632,0,747,1,4522,0,363,1,269,0,2859,1,3128,California
Modoc,2021-07-13,8,5640,3,750,5,4527,0,363,4,269,4,2863,4,3132,California
Modoc,2021-07-14,4,5644,0,750,4,4531,0,363,1,267,3,2866,1,3133,California
Modoc,2021-07-15,45,5689,19,769,23,4554,3,366,12,249,33,2899,15,3148,California
Modoc,2021-07-16,4,5693,0,769,4,4558,0,366,1,247,3,2902,1,3149,California
Modoc,2021-07-19,4,5697,2,771,2,4560,0,366,4,251,0,2902,4,3153,California
Modoc,2021-07-20,23,5720,11,782,10,4570,2,368,11,254,12,2914,15,3168,California
Modoc,2021-07-21,2,5722,0,782,2,4572,0,368,0,252,2,2916,0,3168,California
Modoc,2021-07-22,23,5745,9,791,12,4584,2,370,4,239,19,2935,6,3174,California
Modoc,2021-07-23,7,5752,2,793,5,4589,0,370,5,242,2,2937,5,3179,California
Modoc,2021-07-24,1,5753,0,793,1,4590,0,370,1,243,0,2937,1,3180,California
Modoc,2021-07-26,7,5760,3,796,3,4593,1,371,4,245,3,2940,5,3185,California
Modoc,2021-07-27,13,5773,5,801,6,4599,2,373,3,240,10,2950,5,3190,California
Modoc,2021-07-28,14,5787,2,803,10,4609,2,375,6,240,8,2958,8,3198,California
Modoc,2021-07-29,31,5818,27,830,4,4613,0,375,18,245,13,2971,18,3216,California
Modoc,2021-07-30,7,5825,0,830,6,4619,1,376,5,249,2,2973,6,3222,California
Modoc,2021-07-31,2,5827,1,831,1,4620,0,376,2,251,0,2973,2,3224,California
Mono,2020-12-18,2,2,2,2,0,0,0,0,2,2,0,0,2,2,California
Mono,2020-12-19,5,7,5,7,0,0,0,0,5,7,0,0,5,7,California
Mono,2020-12-20,7,14,7,14,0,0,0,0,7,14,0,0,7,14,California
Mono,2020-12-21,24,38,17,31,7,7,0,0,24,38,0,0,24,38,California
Mono,2020-12-22,69,107,67,98,2,9,0,0,69,107,0,0,69,107,California
Mono,2020-12-23,71,178,45,143,26,35,0,0,71,178,0,0,71,178,California
Mono,2020-12-24,3,181,1,144,2,37,0,0,3,181,0,0,3,181,California
Mono,2020-12-26,4,185,4,148,0,37,0,0,4,185,0,0,4,185,California
Mono,2020-12-27,1,186,0,148,1,38,0,0,1,186,0,0,1,186,California
Mono,2020-12-28,93,279,62,210,31,69,0,0,93,279,0,0,93,279,California
Mono,2020-12-29,29,308,29,239,0,69,0,0,29,308,0,0,29,308,California
Mono,2020-12-30,77,385,36,275,41,110,0,0,77,385,0,0,77,385,California
Mono,2020-12-31,4,389,1,276,3,113,0,0,4,389,0,0,4,389,California
Mono,2021-01-01,4,393,4,280,0,113,0,0,4,393,0,0,4,393,California
Mono,2021-01-02,2,395,2,282,0,113,0,0,2,395,0,0,2,395,California
Mono,2021-01-04,2,397,0,282,2,115,0,0,2,397,0,0,2,397,California
Mono,2021-01-05,44,441,2,284,42,157,0,0,43,439,1,1,43,440,California
Mono,2021-01-06,52,493,0,284,52,209,0,0,52,491,0,1,52,492,California
Mono,2021-01-07,55,548,3,287,52,261,0,0,53,543,2,3,54,546,California
Mono,2021-01-08,5,553,2,289,3,264,0,0,3,544,2,5,3,549,California
Mono,2021-01-09,4,557,4,293,0,264,0,0,0,540,4,9,0,549,California
Mono,2021-01-10,5,562,5,298,0,264,0,0,0,535,5,14,0,549,California
Mono,2021-01-11,7,569,5,303,2,266,0,0,3,534,4,18,3,552,California
Mono,2021-01-12,286,855,78,381,208,474,0,0,220,689,65,83,220,772,California
Mono,2021-01-13,237,1092,74,455,163,637,0,0,181,814,56,139,181,953,California
Mono,2021-01-14,75,1167,72,527,3,640,0,0,74,887,1,140,74,1027,California
Mono,2021-01-15,71,1238,3,530,68,708,0,0,71,958,0,140,71,1098,California
Mono,2021-01-16,5,1243,4,534,1,709,0,0,1,955,4,144,1,1099,California
Mono,2021-01-18,64,1307,54,588,10,719,0,0,3,897,61,205,3,1102,California
Mono,2021-01-19,213,1520,210,798,3,722,0,0,174,1033,39,244,175,1277,California
Mono,2021-01-20,236,1756,203,1001,33,755,0,0,176,1149,60,304,176,1453,California
Mono,2021-01-21,7,1763,4,1005,3,758,0,0,7,1156,0,304,7,1460,California
Mono,2021-01-22,5,1768,0,1005,5,763,0,0,5,1161,0,304,5,1465,California
Mono,2021-01-23,594,2362,594,1599,0,763,0,0,593,1753,1,305,593,2058,California
Mono,2021-01-24,1,2363,0,1599,1,764,0,0,0,1752,1,306,0,2058,California
Mono,2021-01-25,200,2563,163,1762,37,801,0,0,162,1876,38,344,162,2220,California
Mono,2021-01-26,505,3068,503,2265,2,803,0,0,499,2369,6,350,499,2719,California
Mono,2021-01-27,4,3072,0,2265,4,807,0,0,4,2373,0,350,4,2723,California
Mono,2021-01-28,7,3079,2,2267,5,812,0,0,3,2372,4,354,3,2726,California
Mono,2021-01-30,196,3275,194,2461,2,814,0,0,195,2566,1,355,195,2921,California
Mono,2021-01-31,250,3525,138,2599,112,926,0,0,139,2594,111,466,139,3060,California
Mono,2021-02-01,27,3552,27,2626,0,926,0,0,0,2567,27,493,0,3060,California
Mono,2021-02-02,5,3557,0,2626,5,931,0,0,2,2566,3,496,2,3062,California
Mono,2021-02-03,6,3563,2,2628,4,935,0,0,3,2566,3,499,3,3065,California
Mono,2021-02-04,216,3779,159,2787,57,992,0,0,92,2536,122,621,92,3157,California
Mono,2021-02-05,621,4400,614,3401,7,999,0,0,617,3149,4,625,617,3774,California
Mono,2021-02-06,135,4535,134,3535,1,1000,0,0,134,3282,1,626,134,3908,California
Mono,2021-02-07,3,4538,0,3535,3,1003,0,0,3,3285,0,626,3,3911,California
Mono,2021-02-08,174,4712,173,3708,1,1004,0,0,16,3144,157,783,16,3927,California
Mono,2021-02-09,233,4945,8,3716,225,1229,0,0,15,2941,218,1001,15,3942,California
Mono,2021-02-10,545,5490,191,3907,354,1583,0,0,196,2789,349,1350,197,4139,California
Mono,2021-02-11,10,5500,5,3912,5,1588,0,0,4,2787,6,1356,4,4143,California
Mono,2021-02-12,96,5596,22,3934,74,1662,0,0,28,2747,68,1424,28,4171,California
Mono,2021-02-13,593,6189,591,4525,2,1664,0,0,28,2211,564,1988,28,4199,California
Mono,2021-02-15,168,6357,166,4691,2,1666,0,0,2,2049,164,2152,2,4201,California
Mono,2021-02-16,526,6883,520,5211,6,1672,0,0,46,1620,477,2629,48,4249,California
Mono,2021-02-17,5,6888,1,5212,4,1676,0,0,2,1619,3,2632,2,4251,California
Mono,2021-02-18,6,6894,2,5214,4,1680,0,0,2,1617,4,2636,2,4253,California
Mono,2021-02-19,55,6949,54,5268,1,1681,0,0,55,1672,0,2636,55,4308,California
Mono,2021-02-20,6,6955,6,5274,0,1681,0,0,6,1678,0,2636,6,4314,California
Mono,2021-02-21,9,6964,9,5283,0,1681,0,0,7,1683,2,2638,7,4321,California
Mono,2021-02-22,299,7263,298,5581,1,1682,0,0,27,1439,271,2909,27,4348,California
Mono,2021-02-23,156,7419,132,5713,24,1706,0,0,27,1337,129,3038,27,4375,California
Mono,2021-02-24,13,7432,3,5716,10,1716,0,0,4,1332,9,3047,4,4379,California
Mono,2021-02-25,6,7438,2,5718,4,1720,0,0,3,1333,2,3049,3,4382,California
Mono,2021-02-26,617,8055,615,6333,2,1722,0,0,23,764,592,3641,23,4405,California
Mono,2021-02-27,140,8195,136,6469,4,1726,0,0,5,636,133,3774,5,4410,California
Mono,2021-02-28,1,8196,0,6469,0,1726,1,1,0,636,1,3775,1,4411,California
Mono,2021-03-01,3,8199,2,6471,1,1727,0,1,2,638,0,3775,2,4413,California
Mono,2021-03-02,8,8207,4,6475,4,1731,0,1,6,642,2,3777,6,4419,California
Mono,2021-03-03,113,8320,3,6478,110,1841,0,1,109,748,3,3780,109,4528,California
Mono,2021-03-04,7,8327,2,6480,5,1846,0,1,3,747,4,3784,3,4531,California
Mono,2021-03-05,40,8367,31,6511,9,1855,0,1,12,731,28,3812,12,4543,California
Mono,2021-03-06,514,8881,17,6528,497,2352,0,1,505,1230,7,3819,506,5049,California
Mono,2021-03-07,1,8882,0,6528,1,2353,0,1,0,1229,1,3820,0,5049,California
Mono,2021-03-08,542,9424,11,6539,528,2881,3,4,531,1752,11,3831,534,5583,California
Mono,2021-03-09,7,9431,3,6542,3,2884,1,5,3,1753,3,3834,4,5587,California
Mono,2021-03-10,287,9718,92,6634,192,3076,3,8,8,1488,276,4110,11,5598,California
Mono,2021-03-11,11,9729,0,6634,2,3078,9,17,0,1486,11,4121,9,5607,California
Mono,2021-03-12,8,9737,1,6635,1,3079,6,23,2,1486,6,4127,6,5613,California
Mono,2021-03-13,837,10574,395,7030,441,3520,1,24,823,2296,14,4141,824,6437,California
Mono,2021-03-14,7,10581,7,7037,0,3520,0,24,1,2291,6,4147,1,6438,California
Mono,2021-03-15,31,10612,23,7060,3,3523,5,29,14,2294,16,4163,19,6457,California
Mono,2021-03-16,17,10629,6,7066,5,3528,6,35,7,2297,10,4173,13,6470,California
Mono,2021-03-17,32,10661,5,7071,19,3547,8,43,19,2311,13,4186,27,6497,California
Mono,2021-03-18,22,10683,2,7073,11,3558,9,52,9,2316,13,4199,18,6515,California
Mono,2021-03-19,21,10704,1,7074,17,3575,3,55,17,2333,3,4202,20,6535,California
Mono,2021-03-20,4,10708,2,7076,1,3576,1,56,3,2336,1,4203,4,6539,California
Mono,2021-03-22,11,10719,0,7076,6,3582,5,61,5,2340,6,4209,10,6549,California
Mono,2021-03-23,46,10765,6,7082,35,3617,5,66,17,2334,28,4237,22,6571,California
Mono,2021-03-24,14,10779,1,7083,8,3625,5,71,5,2336,9,4246,11,6582,California
Mono,2021-03-25,20,10799,3,7086,13,3638,4,75,14,2348,6,4252,18,6600,California
Mono,2021-03-26,19,10818,3,7089,11,3649,5,80,10,2356,7,4259,15,6615,California
Mono,2021-03-27,363,11181,360,7449,3,3652,0,80,337,2667,26,4285,337,6952,California
Mono,2021-03-29,11,11192,2,7451,8,3660,1,81,9,2675,2,4287,10,6962,California
Mono,2021-03-30,14,11206,0,7451,10,3670,4,85,7,2679,7,4294,11,6973,California
Mono,2021-03-31,136,11342,8,7459,127,3797,1,86,25,2595,110,4404,26,6999,California
Mono,2021-04-01,10,11352,0,7459,10,3807,0,86,6,2597,4,4408,6,7005,California
Mono,2021-04-02,18,11370,3,7462,15,3822,0,86,9,2597,9,4417,9,7014,California
Mono,2021-04-03,879,12249,381,7843,498,4320,0,86,49,1820,827,5244,50,7064,California
Mono,2021-04-04,2,12251,1,7844,1,4321,0,86,0,1818,2,5246,0,7064,California
Mono,2021-04-05,546,12797,18,7862,527,4848,1,87,35,1344,510,5756,36,7100,California
Mono,2021-04-06,19,12816,0,7862,6,4854,13,100,2,1342,17,5773,15,7115,California
Mono,2021-04-07,24,12840,2,7864,2,4856,20,120,2,1342,22,5795,22,7137,California
Mono,2021-04-08,26,12866,4,7868,3,4859,19,139,6,1347,20,5815,25,7162,California
Mono,2021-04-09,40,12906,6,7874,5,4864,29,168,10,1356,30,5845,39,7201,California
Mono,2021-04-10,460,13366,2,7876,451,5315,7,175,33,969,427,6272,40,7241,California
Mono,2021-04-12,6,13372,0,7876,3,5318,3,178,3,972,3,6275,6,7247,California
Mono,2021-04-13,20,13392,2,7878,17,5335,1,179,14,981,6,6281,15,7262,California
Mono,2021-04-14,26,13418,2,7880,24,5359,0,179,9,973,17,6298,9,7271,California
Mono,2021-04-15,20,13438,5,7885,15,5374,0,179,10,973,10,6308,10,7281,California
Mono,2021-04-16,17,13455,1,7886,16,5390,0,179,6,968,11,6319,6,7287,California
Mono,2021-04-17,52,13507,2,7888,50,5440,0,179,45,1006,7,6326,45,7332,California
Mono,2021-04-18,1,13508,0,7888,1,5441,0,179,1,1007,0,6326,1,7333,California
Mono,2021-04-19,553,14061,339,8227,214,5655,0,179,208,873,342,6668,208,7541,California
Mono,2021-04-20,14,14075,2,8229,12,5667,0,179,9,877,5,6673,9,7550,California
Mono,2021-04-21,8,14083,1,8230,7,5674,0,179,2,873,6,6679,2,7552,California
Mono,2021-04-22,25,14108,11,8241,14,5688,0,179,11,870,14,6693,11,7563,California
Mono,2021-04-23,24,14132,4,8245,20,5708,0,179,12,870,12,6705,12,7575,California
Mono,2021-04-24,35,14167,20,8265,15,5723,0,179,21,877,14,6719,21,7596,California
Mono,2021-04-25,5,14172,4,8269,1,5724,0,179,5,882,0,6719,5,7601,California
Mono,2021-04-26,16,14188,4,8273,12,5736,0,179,3,872,13,6732,3,7604,California
Mono,2021-04-27,67,14255,41,8314,18,5754,8,187,51,915,16,6748,59,7663,California
Mono,2021-04-28,64,14319,41,8355,18,5772,5,192,48,954,14,6762,53,7716,California
Mono,2021-04-29,13,14332,4,8359,6,5778,3,195,4,952,9,6771,7,7723,California
Mono,2021-04-30,20,14352,4,8363,12,5790,4,199,8,952,12,6783,12,7735,California
Mono,2021-05-01,116,14468,5,8368,111,5901,0,199,103,1043,12,6795,103,7838,California
Mono,2021-05-02,1,14469,1,8369,0,5901,0,199,0,1042,1,6796,0,7838,California
Mono,2021-05-03,2,14471,1,8370,1,5902,0,199,1,1042,1,6797,1,7839,California
Mono,2021-05-04,19,14490,0,8370,14,5916,5,204,10,1048,9,6806,15,7854,California
Mono,2021-05-05,53,14543,8,8378,41,5957,4,208,45,1089,8,6814,49,7903,California
Mono,2021-05-06,15,14558,3,8381,11,5968,1,209,9,1093,6,6820,10,7913,California
Mono,2021-05-07,30,14588,22,8403,8,5976,0,209,25,1113,5,6825,25,7938,California
Mono,2021-05-08,53,14641,7,8410,46,6022,0,209,23,1106,30,6855,23,7961,California
Mono,2021-05-09,1,14642,1,8411,0,6022,0,209,0,1106,0,6855,0,7961,California
Mono,2021-05-10,19,14661,2,8413,13,6035,4,213,9,1109,10,6865,13,7974,California
Mono,2021-05-11,16,14677,2,8415,11,6046,3,216,5,1106,11,6876,8,7982,California
Mono,2021-05-12,12,14689,0,8415,11,6057,1,217,4,1103,8,6884,5,7987,California
Mono,2021-05-13,53,14742,35,8450,17,6074,1,218,42,1135,11,6895,43,8030,California
Mono,2021-05-14,11,14753,2,8452,8,6082,1,219,6,1137,5,6900,7,8037,California
Mono,2021-05-15,69,14822,28,8480,35,6117,6,225,20,1114,49,6949,26,8063,California
Mono,2021-05-16,6,14828,4,8484,1,6118,1,226,2,1113,4,6953,3,8066,California
Mono,2021-05-17,255,15083,35,8519,213,6331,7,233,57,981,197,7150,65,8131,California
Mono,2021-05-18,134,15217,111,8630,22,6353,1,234,87,1023,47,7197,89,8220,California
Mono,2021-05-19,120,15337,113,8743,2,6355,5,239,76,1060,44,7241,81,8301,California
Mono,2021-05-20,72,15409,57,8800,10,6365,5,244,54,1101,18,7259,59,8360,California
Mono,2021-05-21,24,15433,4,8804,17,6382,3,247,10,1100,14,7273,13,8373,California
Mono,2021-05-22,22,15455,12,8816,8,6390,2,249,16,1112,6,7279,18,8391,California
Mono,2021-05-23,3,15458,1,8817,2,6392,0,249,2,1113,1,7280,2,8393,California
Mono,2021-05-24,14,15472,0,8817,13,6405,1,250,8,1117,6,7286,10,8403,California
Mono,2021-05-25,15,15487,5,8822,10,6415,0,250,8,1119,7,7293,9,8412,California
Mono,2021-05-26,18,15505,2,8824,15,6430,1,251,7,1116,11,7304,8,8420,California
Mono,2021-05-27,8,15513,0,8824,8,6438,0,251,5,1119,2,7306,5,8425,California
Mono,2021-05-28,42,15555,28,8852,14,6452,0,251,11,1099,31,7337,11,8436,California
Mono,2021-05-29,132,15687,26,8878,103,6555,3,254,31,1032,101,7438,34,8470,California
Mono,2021-06-01,16,15703,7,8885,9,6564,0,254,9,1034,7,7445,9,8479,California
Mono,2021-06-02,47,15750,4,8889,43,6607,0,254,10,1007,37,7482,10,8489,California
Mono,2021-06-03,10,15760,1,8890,7,6614,2,256,1,1001,9,7491,3,8492,California
Mono,2021-06-04,12,15772,1,8891,10,6624,1,257,3,996,9,7500,4,8496,California
Mono,2021-06-05,46,15818,26,8917,20,6644,0,257,5,960,41,7541,5,8501,California
Mono,2021-06-06,1,15819,0,8917,1,6645,0,257,0,959,1,7542,0,8501,California
Mono,2021-06-07,99,15918,87,9004,8,6653,4,261,11,886,88,7630,15,8516,California
Mono,2021-06-08,113,16031,103,9107,8,6661,2,263,12,799,101,7731,14,8530,California
Mono,2021-06-09,7,16038,2,9109,5,6666,0,263,1,794,6,7737,1,8531,California
Mono,2021-06-10,6,16044,0,9109,4,6670,2,265,2,794,4,7741,4,8535,California
Mono,2021-06-11,74,16118,62,9171,7,6677,5,270,6,737,68,7809,11,8546,California
Mono,2021-06-12,1,16119,1,9172,0,6677,0,270,0,736,1,7810,0,8546,California
Mono,2021-06-13,1,16120,0,9172,1,6678,0,270,1,737,0,7810,1,8547,California
Mono,2021-06-14,65,16185,30,9202,29,6707,6,276,20,718,45,7855,26,8573,California
Mono,2021-06-15,8,16193,5,9207,3,6710,0,276,4,718,4,7859,4,8577,California
Mono,2021-06-16,14,16207,5,9212,9,6719,0,276,6,716,8,7867,6,8583,California
Mono,2021-06-17,7,16214,1,9213,4,6723,2,278,3,717,4,7871,5,8588,California
Mono,2021-06-18,6,16220,3,9216,2,6725,1,279,2,717,3,7874,3,8591,California
Mono,2021-06-19,3,16223,2,9218,1,6726,0,279,3,720,0,7874,3,8594,California
Mono,2021-06-20,1,16224,0,9218,1,6727,0,279,0,719,1,7875,0,8594,California
Mono,2021-06-21,14,16238,2,9220,10,6737,2,281,3,714,10,7885,5,8599,California
Mono,2021-06-22,13,16251,2,9222,10,6747,1,282,4,711,8,7893,5,8604,California
Mono,2021-06-23,14,16265,1,9223,7,6754,6,288,3,710,11,7904,10,8614,California
Mono,2021-06-24,7,16272,0,9223,5,6759,2,290,2,709,5,7909,4,8618,California
Mono,2021-06-25,36,16308,25,9248,11,6770,0,290,10,693,26,7935,10,8628,California
Mono,2021-06-26,1,16309,1,9249,0,6770,0,290,0,692,1,7936,0,8628,California
Mono,2021-06-27,1,16310,0,9249,1,6771,0,290,1,693,0,7936,1,8629,California
Mono,2021-06-28,11,16321,6,9255,2,6773,3,293,3,691,8,7944,6,8635,California
Mono,2021-06-29,5,16326,4,9259,0,6773,1,294,4,695,1,7945,5,8640,California
Mono,2021-06-30,6,16332,1,9260,2,6775,3,297,2,696,4,7949,5,8645,California
Mono,2021-07-01,8,16340,1,9261,4,6779,3,300,2,695,6,7955,5,8650,California
Mono,2021-07-02,38,16378,34,9295,2,6781,2,302,13,685,25,7980,15,8665,California
Mono,2021-07-05,4,16382,0,9295,3,6784,1,303,3,688,1,7981,4,8669,California
Mono,2021-07-06,11,16393,1,9296,6,6790,4,307,4,689,7,7988,8,8677,California
Mono,2021-07-07,7,16400,4,9300,3,6793,0,307,2,686,5,7993,2,8679,California
Mono,2021-07-08,11,16411,9,9309,1,6794,1,308,4,685,6,7999,5,8684,California
Mono,2021-07-09,5,16416,1,9310,4,6798,0,308,2,684,3,8002,2,8686,California
Mono,2021-07-10,3,16419,3,9313,0,6798,0,308,2,685,1,8003,2,8688,California
Mono,2021-07-12,15,16434,8,9321,7,6805,0,308,10,690,5,8008,10,8698,California
Mono,2021-07-13,3,16437,3,9324,0,6805,0,308,3,693,0,8008,3,8701,California
Mono,2021-07-14,15,16452,11,9335,4,6809,0,308,8,695,6,8014,8,8709,California
Mono,2021-07-15,12,16464,6,9341,6,6815,0,308,7,697,5,8019,7,8716,California
Mono,2021-07-16,6,16470,1,9342,5,6820,0,308,3,698,2,8021,3,8719,California
Mono,2021-07-17,5,16475,0,9342,5,6825,0,308,5,703,0,8021,5,8724,California
Mono,2021-07-19,58,16533,37,9379,17,6842,4,312,44,737,14,8035,48,8772,California
Mono,2021-07-20,13,16546,4,9383,8,6850,1,313,4,733,9,8044,5,8777,California
Mono,2021-07-21,4,16550,2,9385,2,6852,0,313,3,735,1,8045,3,8780,California
Mono,2021-07-22,16,16566,5,9390,10,6862,1,314,11,742,5,8050,12,8792,California
Mono,2021-07-23,25,16591,16,9406,7,6869,2,316,18,755,7,8057,20,8812,California
Mono,2021-07-24,4,16595,2,9408,2,6871,0,316,2,756,1,8058,2,8814,California
Mono,2021-07-26,6,16601,5,9413,0,6871,1,317,5,761,1,8059,6,8820,California
Mono,2021-07-27,12,16613,3,9416,9,6880,0,317,9,767,3,8062,9,8829,California
Mono,2021-07-28,14,16627,3,9419,11,6891,0,317,11,776,2,8064,11,8840,California
Mono,2021-07-29,5,16632,1,9420,4,6895,0,317,3,777,2,8066,3,8843,California
Mono,2021-07-30,4,16636,0,9420,4,6899,0,317,4,781,0,8066,4,8847,California
Mono,2021-07-31,3,16639,3,9423,0,6899,0,317,3,784,0,8066,3,8850,California
Monterey,2020-12-16,6,6,6,6,0,0,0,0,6,6,0,0,6,6,California
Monterey,2020-12-17,90,96,90,96,0,0,0,0,90,96,0,0,90,96,California
Monterey,2020-12-18,494,590,494,590,0,0,0,0,494,590,0,0,494,590,California
Monterey,2020-12-19,581,1171,580,1170,1,1,0,0,580,1170,0,0,580,1170,California
Monterey,2020-12-20,422,1593,421,1591,1,2,0,0,422,1592,0,0,422,1592,California
Monterey,2020-12-21,724,2317,724,2315,0,2,0,0,724,2316,0,0,724,2316,California
Monterey,2020-12-22,552,2869,539,2854,13,15,0,0,552,2868,0,0,552,2868,California
Monterey,2020-12-23,447,3316,268,3122,179,194,0,0,447,3315,0,0,447,3315,California
Monterey,2020-12-24,86,3402,10,3132,76,270,0,0,86,3401,0,0,86,3401,California
Monterey,2020-12-25,6,3408,0,3132,6,276,0,0,6,3407,0,0,6,3407,California
Monterey,2020-12-26,94,3502,6,3138,88,364,0,0,94,3501,0,0,94,3501,California
Monterey,2020-12-27,7,3509,4,3142,3,367,0,0,7,3508,0,0,7,3508,California
Monterey,2020-12-28,491,4000,26,3168,465,832,0,0,491,3999,0,0,491,3999,California
Monterey,2020-12-29,920,4920,176,3344,744,1576,0,0,920,4919,0,0,920,4919,California
Monterey,2020-12-30,576,5496,101,3445,475,2051,0,0,576,5495,0,0,576,5495,California
Monterey,2020-12-31,36,5532,11,3456,25,2076,0,0,36,5531,0,0,36,5531,California
Monterey,2021-01-01,13,5545,3,3459,10,2086,0,0,13,5544,0,0,13,5544,California
Monterey,2021-01-02,140,5685,136,3595,4,2090,0,0,140,5684,0,0,140,5684,California
Monterey,2021-01-03,32,5717,31,3626,1,2091,0,0,32,5716,0,0,32,5716,California
Monterey,2021-01-04,415,6132,20,3646,395,2486,0,0,415,6131,0,0,415,6131,California
Monterey,2021-01-05,771,6903,337,3983,434,2920,0,0,756,6873,14,14,756,6887,California
Monterey,2021-01-06,680,7583,185,4168,495,3415,0,0,653,7499,27,41,653,7540,California
Monterey,2021-01-07,763,8346,580,4748,183,3598,0,0,432,7602,329,370,432,7972,California
Monterey,2021-01-08,1122,9468,754,5502,368,3966,0,0,412,7304,710,1080,412,8384,California
Monterey,2021-01-09,977,10445,937,6439,40,4006,0,0,325,6979,650,1730,325,8709,California
Monterey,2021-01-10,274,10719,271,6710,3,4009,0,0,9,6723,265,1995,9,8718,California
Monterey,2021-01-11,1081,11800,992,7702,89,4098,0,0,375,6392,706,2701,375,9093,California
Monterey,2021-01-12,520,12320,432,8134,88,4186,0,0,252,6377,268,2969,253,9346,California
Monterey,2021-01-13,1245,13565,609,8743,636,4822,0,0,1199,7530,46,3015,1199,10545,California
Monterey,2021-01-14,1216,14781,247,8990,969,5791,0,0,1194,8706,22,3037,1198,11743,California
Monterey,2021-01-15,1090,15871,46,9036,1044,6835,0,0,1078,9772,12,3049,1078,12821,California
Monterey,2021-01-16,369,16240,303,9339,66,6901,0,0,364,10131,5,3054,364,13185,California
Monterey,2021-01-17,314,16554,295,9634,19,6920,0,0,301,10419,13,3067,301,13486,California
Monterey,2021-01-18,413,16967,52,9686,361,7281,0,0,390,10786,23,3090,390,13876,California
Monterey,2021-01-19,610,17577,414,10100,196,7477,0,0,436,11050,172,3262,436,14312,California
Monterey,2021-01-20,564,18141,275,10375,289,7766,0,0,349,11184,215,3477,349,14661,California
Monterey,2021-01-21,932,19073,119,10494,813,8579,0,0,819,11894,113,3590,823,15484,California
Monterey,2021-01-22,1111,20184,212,10706,899,9478,0,0,1068,12920,42,3632,1068,16552,California
Monterey,2021-01-23,252,20436,179,10885,73,9551,0,0,126,12923,125,3757,128,16680,California
Monterey,2021-01-24,65,20501,40,10925,25,9576,0,0,30,12918,35,3792,30,16710,California
Monterey,2021-01-25,851,21352,185,11110,666,10242,0,0,209,12492,635,4427,209,16919,California
Monterey,2021-01-26,1149,22501,383,11493,766,11008,0,0,361,12065,788,5215,361,17280,California
Monterey,2021-01-27,952,23453,351,11844,601,11609,0,0,453,12019,499,5714,453,17733,California
Monterey,2021-01-28,2081,25534,748,12592,1333,12942,0,0,1729,13400,351,6065,1732,19465,California
Monterey,2021-01-29,1322,26856,723,13315,599,13541,0,0,1202,14484,119,6184,1203,20668,California
Monterey,2021-01-30,494,27350,302,13617,192,13733,0,0,234,14458,260,6444,234,20902,California
Monterey,2021-01-31,511,27861,82,13699,429,14162,0,0,500,14948,11,6455,501,21403,California
Monterey,2021-02-01,1670,29531,1147,14846,523,14685,0,0,1088,15455,581,7036,1088,22491,California
Monterey,2021-02-02,2238,31769,497,15343,1741,16426,0,0,1593,16405,643,7679,1593,24084,California
Monterey,2021-02-03,2402,34171,1087,16430,1315,17741,0,0,1604,17214,795,8474,1604,25688,California
Monterey,2021-02-04,2877,37048,2123,18553,754,18495,0,0,2512,19366,360,8834,2512,28200,California
Monterey,2021-02-05,3745,40793,2864,21417,881,19376,0,0,3287,22201,452,9286,3287,31487,California
Monterey,2021-02-06,1150,41943,383,21800,767,20143,0,0,793,22640,354,9640,793,32280,California
Monterey,2021-02-07,329,42272,268,22068,61,20204,0,0,107,22526,221,9861,107,32387,California
Monterey,2021-02-08,550,42822,295,22363,255,20459,0,0,438,22852,112,9973,438,32825,California
Monterey,2021-02-09,942,43764,719,23082,223,20682,0,0,623,23157,318,10291,623,33448,California
Monterey,2021-02-10,2163,45927,1122,24204,1041,21723,0,0,1285,23567,877,11168,1287,34735,California
Monterey,2021-02-11,2574,48501,983,25187,1591,23314,0,0,1572,24142,999,12167,1574,36309,California
Monterey,2021-02-12,2704,51205,454,25641,2250,25564,0,0,1567,24574,1136,13303,1568,37877,California
Monterey,2021-02-13,1119,52324,51,25692,1068,26632,0,0,1023,25502,95,13398,1023,38900,California
Monterey,2021-02-14,639,52963,75,25767,564,27196,0,0,568,25999,71,13469,568,39468,California
Monterey,2021-02-15,1427,54390,175,25942,1252,28448,0,0,998,26571,427,13896,999,40467,California
Monterey,2021-02-16,1128,55518,252,26194,876,29324,0,0,894,27231,234,14130,894,41361,California
Monterey,2021-02-17,2054,57572,1208,27402,846,30170,0,0,1699,28581,351,14481,1701,43062,California
Monterey,2021-02-18,2317,59889,1189,28591,1128,31298,0,0,935,28151,1367,15848,937,43999,California
Monterey,2021-02-19,3042,62931,1574,30165,1468,32766,0,0,1393,27899,1647,17495,1395,45394,California
Monterey,2021-02-20,1138,64069,705,30870,433,33199,0,0,1067,28897,70,17565,1068,46462,California
Monterey,2021-02-21,1385,65454,1343,32213,42,33241,0,0,1293,30105,86,17651,1294,47756,California
Monterey,2021-02-22,1152,66606,978,33191,174,33415,0,0,708,30373,440,18091,708,48464,California
Monterey,2021-02-23,1087,67693,674,33865,413,33828,0,0,350,29990,734,18825,351,48815,California
Monterey,2021-02-24,2692,70385,1402,35267,1290,35118,0,0,1944,31192,743,19568,1945,50760,California
Monterey,2021-02-25,4758,75143,2593,37860,2165,37283,0,0,1607,29662,3139,22707,1609,52369,California
Monterey,2021-02-26,5621,80764,3268,41128,2353,39636,0,0,2800,29648,2815,25522,2801,55170,California
Monterey,2021-02-27,1142,81906,213,41341,929,40565,0,0,897,30306,239,25761,897,56067,California
Monterey,2021-02-28,1662,83568,94,41435,1567,42132,1,1,1151,30961,497,26258,1152,57219,California
Monterey,2021-03-01,1421,84989,189,41624,1229,43361,3,4,819,31188,595,26853,822,58041,California
Monterey,2021-03-02,3014,88003,1841,43465,1173,44534,0,4,2082,32343,927,27780,2082,60123,California
Monterey,2021-03-03,3354,91357,1273,44738,2080,46614,1,5,1349,31693,2001,29781,1351,61474,California
Monterey,2021-03-04,4825,96182,1538,46276,3287,49901,0,5,3124,33126,1693,31474,3126,64600,California
Monterey,2021-03-05,3771,99953,1649,47925,1841,51742,281,286,3078,35793,692,32166,3359,67959,California
Monterey,2021-03-06,5279,105232,1182,49107,3788,55530,309,595,4338,39499,939,33105,4645,72604,California
Monterey,2021-03-07,614,105846,107,49214,194,55724,313,908,246,39688,367,33472,556,73160,California
Monterey,2021-03-08,1698,107544,331,49545,971,56695,396,1304,1134,40651,564,34036,1527,74687,California
Monterey,2021-03-09,2066,109610,700,50245,1086,57781,280,1584,1538,41939,525,34561,1813,76500,California
Monterey,2021-03-10,3313,112923,1058,51303,1765,59546,490,2074,1543,42203,1764,36325,2028,78528,California
Monterey,2021-03-11,4263,117186,1439,52742,2444,61990,380,2454,2433,43194,1820,38145,2811,81339,California
Monterey,2021-03-12,4515,121701,2077,54819,2281,64271,157,2611,2771,44379,1738,39883,2923,84262,California
Monterey,2021-03-13,5457,127158,1039,55858,4064,68335,354,2965,4046,47370,1408,41291,4399,88661,California
Monterey,2021-03-14,2207,129365,1356,57214,827,69162,24,2989,521,46245,1670,42961,545,89206,California
Monterey,2021-03-15,4059,133424,1289,58503,2464,71626,306,3295,2279,47056,1775,44736,2586,91792,California
Monterey,2021-03-16,3631,137055,618,59121,2621,74247,392,3687,2164,48145,1464,46200,2553,94345,California
Monterey,2021-03-17,6037,143092,2482,61603,3296,77543,259,3946,4367,51117,1659,47859,4631,98976,California
Monterey,2021-03-18,4601,147693,2255,63858,2174,79717,172,4118,3184,53098,1412,49271,3393,102369,California
Monterey,2021-03-19,5624,153317,2623,66481,2836,82553,165,4283,4251,56148,1365,50636,4415,106784,California
Monterey,2021-03-20,3436,156753,464,66945,2279,84832,693,4976,2329,58065,1103,51739,3020,109804,California
Monterey,2021-03-21,669,157422,230,67175,428,85260,11,4987,587,58583,79,51818,597,110401,California
Monterey,2021-03-22,2548,159970,1485,68660,1000,86260,63,5050,2314,60728,230,52048,2375,112776,California
Monterey,2021-03-23,4165,164135,2452,71112,1670,87930,43,5093,2598,61808,1561,53609,2641,115417,California
Monterey,2021-03-24,5310,169445,2237,73349,2753,90683,320,5413,3866,64553,1437,55046,4182,119599,California
Monterey,2021-03-25,5439,174884,1263,74612,3813,94496,363,5776,2679,64845,2751,57797,3043,122642,California
Monterey,2021-03-26,5622,180506,2708,77320,2827,97323,87,5863,2816,64957,2792,60589,2904,125546,California
Monterey,2021-03-27,5097,185603,1598,78918,3239,100562,260,6123,3223,66570,1871,62460,3484,129030,California
Monterey,2021-03-28,1159,186762,371,79289,779,101341,9,6132,637,66703,513,62973,646,129676,California
Monterey,2021-03-29,3312,190074,1457,80746,1841,103182,14,6146,2020,67458,1284,64257,2039,131715,California
Monterey,2021-03-30,4660,194734,2180,82926,2424,105606,56,6202,2806,68481,1841,66098,2864,134579,California
Monterey,2021-03-31,5503,200237,2424,85350,2277,107883,802,7004,3420,70612,2078,68176,4209,138788,California
Monterey,2021-04-01,6305,206542,2110,87460,3785,111668,410,7414,3127,70983,3162,71338,3533,142321,California
Monterey,2021-04-02,4822,211364,2241,89701,2506,114174,75,7489,3206,72654,1612,72950,3283,145604,California
Monterey,2021-04-03,6025,217389,1146,90847,3819,117993,1060,8549,1229,70146,4789,77739,2281,147885,California
Monterey,2021-04-04,793,218182,177,91024,602,118595,14,8563,505,70380,287,78026,521,148406,California
Monterey,2021-04-05,4077,222259,2518,93542,1319,119914,240,8803,1516,69578,2556,80582,1754,150160,California
Monterey,2021-04-06,3579,225838,1401,94943,1694,121608,484,9287,1237,68958,2337,82919,1717,151877,California
Monterey,2021-04-07,5771,231609,1408,96351,3838,125446,525,9812,2697,69110,3063,85982,3215,155092,California
Monterey,2021-04-08,6886,238495,3616,99967,2427,127873,843,10655,3412,69894,3469,89451,4253,159345,California
Monterey,2021-04-09,5844,244339,3465,103432,1726,129599,653,11308,2311,69326,3529,92980,2961,162306,California
Monterey,2021-04-10,10347,254686,4947,108379,3169,132768,2231,13539,4977,71169,5354,98334,7197,169503,California
Monterey,2021-04-11,5553,260239,4350,112729,585,133353,618,14157,4482,75196,1065,99399,5092,174595,California
Monterey,2021-04-12,4239,264478,1909,114638,1987,135340,343,14500,981,73399,3118,102517,1321,175916,California
Monterey,2021-04-13,3328,267806,790,115428,2532,137872,6,14506,1589,73275,1720,104237,1596,177512,California
Monterey,2021-04-14,7093,274899,3316,118744,3774,141646,3,14509,1922,70055,5146,109383,1926,179438,California
Monterey,2021-04-15,6035,280934,3979,122723,2056,143702,0,14509,3901,71855,2102,111485,3902,183340,California
Monterey,2021-04-16,4991,285925,2510,125233,2470,146172,11,14520,2235,71363,2739,114224,2247,185587,California
Monterey,2021-04-17,5937,291862,1428,126661,4509,150681,0,14520,3831,73107,2088,116312,3832,189419,California
Monterey,2021-04-18,914,292776,309,126970,605,151286,0,14520,267,72731,643,116955,267,189686,California
Monterey,2021-04-19,3673,296449,1194,128164,2479,153765,0,14520,1660,72395,1997,118952,1661,191347,California
Monterey,2021-04-20,4012,300461,1679,129843,2333,156098,0,14520,1586,71588,2394,121346,1587,192934,California
Monterey,2021-04-21,6556,307017,3675,133518,2881,158979,0,14520,3132,71365,3357,124703,3134,196068,California
Monterey,2021-04-22,5047,312064,1157,134675,3890,162869,0,14520,2069,70509,2925,127628,2069,198137,California
Monterey,2021-04-23,5927,317991,2792,137467,3134,166003,1,14521,2362,69336,3541,131169,2368,200505,California
Monterey,2021-04-24,4617,322608,774,138241,3842,169845,1,14522,1744,68232,2850,134019,1746,202251,California
Monterey,2021-04-25,1299,323907,651,138892,648,170493,0,14522,817,68582,467,134486,817,203068,California
Monterey,2021-04-26,3932,327839,2359,141251,1556,172049,17,14539,1022,66741,2880,137366,1039,204107,California
Monterey,2021-04-27,3037,330876,1018,142269,1879,173928,140,14679,1298,66446,1732,139098,1437,205544,California
Monterey,2021-04-28,3898,334774,1551,143820,2190,176118,157,14836,2362,67441,1519,140617,2514,208058,California
Monterey,2021-04-29,4804,339578,2621,146441,2101,178219,82,14918,1760,66257,3027,143644,1843,209901,California
Monterey,2021-04-30,3328,342906,1737,148178,1517,179736,74,14992,862,64736,2455,146099,934,210835,California
Monterey,2021-05-01,5860,348766,4419,152597,1399,181135,42,15034,712,60362,5127,151226,753,211588,California
Monterey,2021-05-02,4511,353277,4067,156664,417,181552,27,15061,320,56533,4176,155402,347,211935,California
Monterey,2021-05-03,2604,355881,1613,158277,873,182425,118,15179,605,55268,1988,157390,723,212658,California
Monterey,2021-05-04,1939,357820,701,158978,1144,183569,94,15273,686,54811,1238,158628,781,213439,California
Monterey,2021-05-05,3570,361390,1346,160324,2138,185707,86,15359,1130,53604,2424,161052,1217,214656,California
Monterey,2021-05-06,4502,365892,3007,163331,1272,186979,223,15582,1188,51718,3298,164350,1412,216068,California
Monterey,2021-05-07,2261,368153,1212,164543,947,187926,102,15684,735,51043,1511,165861,836,216904,California
Monterey,2021-05-08,2791,370944,1534,166077,932,188858,325,16009,997,50584,1780,167641,1321,218225,California
Monterey,2021-05-09,415,371359,129,166206,259,189117,27,16036,138,50473,276,167917,165,218390,California
Monterey,2021-05-10,2906,374265,2136,168342,720,189837,50,16086,551,48735,2341,170258,603,218993,California
Monterey,2021-05-11,1969,376234,1023,169365,863,190700,83,16169,797,48457,1159,171417,881,219874,California
Monterey,2021-05-12,4103,380337,2182,171547,1833,192533,88,16257,902,46264,3183,174600,990,220864,California
Monterey,2021-05-13,2753,383090,1643,173190,1054,193587,56,16313,1559,46697,1179,175779,1612,222476,California
Monterey,2021-05-14,1953,385043,630,173820,1221,194808,102,16415,754,46364,1189,176968,856,223332,California
Monterey,2021-05-15,3467,388510,860,174680,2341,197149,266,16681,966,45105,2487,179455,1228,224560,California
Monterey,2021-05-16,1019,389529,652,175332,292,197441,75,16756,288,44744,724,180179,363,224923,California
Monterey,2021-05-17,2293,391822,1369,176701,844,198285,80,16836,1085,44715,1194,181373,1165,226088,California
Monterey,2021-05-18,1918,393740,839,177540,1032,199317,47,16883,850,44556,1058,182431,899,226987,California
Monterey,2021-05-19,3802,397542,2494,180034,1218,200535,90,16973,1945,44744,1850,184281,2038,229025,California
Monterey,2021-05-20,2948,400490,1115,181149,1715,202250,118,17091,1009,43950,1923,186204,1129,230154,California
Monterey,2021-05-21,3445,403935,1468,182617,1879,204129,98,17189,1122,42860,2309,188513,1219,231373,California
Monterey,2021-05-22,2215,406150,807,183424,1127,205256,281,17470,861,42656,1344,189857,1140,232513,California
Monterey,2021-05-23,886,407036,528,183952,342,205598,16,17486,504,42801,375,190232,520,233033,California
Monterey,2021-05-24,1759,408795,578,184530,1119,206717,62,17548,571,42253,1182,191414,634,233667,California
Monterey,2021-05-25,1552,410347,628,185158,852,207569,72,17620,582,41956,952,192366,655,234322,California
Monterey,2021-05-26,2762,413109,1091,186249,1613,209182,58,17678,1009,41288,1734,194100,1066,235388,California
Monterey,2021-05-27,2551,415660,1397,187646,1093,210275,61,17739,892,40598,1643,195743,953,236341,California
Monterey,2021-05-28,1777,417437,609,188255,1108,211383,60,17799,751,40394,1016,196759,812,237153,California
Monterey,2021-05-29,1017,418454,658,188913,326,211709,33,17832,403,40224,607,197366,437,237590,California
Monterey,2021-05-30,388,418842,168,189081,205,211914,15,17847,144,40141,243,197609,160,237750,California
Monterey,2021-05-31,187,419029,34,189115,144,212058,9,17856,52,40068,134,197743,61,237811,California
Monterey,2021-06-01,1793,420822,970,190085,686,212744,137,17993,546,39519,1228,198971,679,238490,California
Monterey,2021-06-02,1740,422562,1010,191095,680,213424,50,18043,709,39254,1024,199995,759,239249,California
Monterey,2021-06-03,2282,424844,1441,192536,802,214226,39,18082,540,38100,1732,201727,578,239827,California
Monterey,2021-06-04,1401,426245,752,193288,614,214840,35,18117,577,37895,816,202543,611,240438,California
Monterey,2021-06-05,2246,428491,894,194182,722,215562,630,18747,487,37264,1740,204283,1109,241547,California
Monterey,2021-06-06,534,429025,438,194620,85,215647,11,18758,282,37305,251,204534,292,241839,California
Monterey,2021-06-07,964,429989,510,195130,409,216056,45,18803,371,37137,582,205116,414,242253,California
Monterey,2021-06-08,1257,431246,813,195943,420,216476,24,18827,433,36780,813,205929,456,242709,California
Monterey,2021-06-09,2984,434230,2252,198195,606,217082,126,18953,645,35215,2335,208264,770,243479,California
Monterey,2021-06-10,1579,435809,983,199178,533,217615,63,19016,557,34817,1016,209280,618,244097,California
Monterey,2021-06-11,1448,437257,792,199970,562,218177,94,19110,520,34508,921,210201,612,244709,California
Monterey,2021-06-12,774,438031,531,200501,228,218405,15,19125,356,34465,414,210615,371,245080,California
Monterey,2021-06-13,603,438634,465,200966,125,218530,13,19138,117,34112,482,211097,129,245209,California
Monterey,2021-06-14,1425,440059,1022,201988,367,218897,36,19174,378,33487,1039,212136,414,245623,California
Monterey,2021-06-15,1206,441265,623,202611,456,219353,127,19301,414,33247,781,212917,541,246164,California
Monterey,2021-06-16,1623,442888,1147,203758,442,219795,34,19335,430,32528,1183,214100,464,246628,California
Monterey,2021-06-17,1215,444103,704,204462,348,220143,163,19498,439,32361,769,214869,602,247230,California
Monterey,2021-06-18,1241,445344,751,205213,458,220601,32,19530,547,32255,685,215554,579,247809,California
Monterey,2021-06-19,1327,446671,1028,206241,268,220869,31,19561,497,31961,822,216376,528,248337,California
Monterey,2021-06-20,245,446916,166,206407,70,220939,9,19570,85,31896,160,216536,95,248432,California
Monterey,2021-06-21,680,447596,374,206781,271,221210,35,19605,389,32034,285,216821,423,248855,California
Monterey,2021-06-22,1553,449149,991,207772,360,221570,202,19807,506,31703,1034,217855,703,249558,California
Monterey,2021-06-23,1105,450254,740,208512,331,221901,34,19841,460,31560,636,218491,493,250051,California
Monterey,2021-06-24,905,451159,538,209050,338,222239,29,19870,436,31560,465,218956,465,250516,California
Monterey,2021-06-25,1039,452198,650,209700,373,222612,16,19886,495,31531,539,219495,510,251026,California
Monterey,2021-06-26,625,452823,453,210153,155,222767,17,19903,343,31611,277,219772,357,251383,California
Monterey,2021-06-27,379,453202,298,210451,67,222834,14,19917,104,31456,273,220045,118,251501,California
Monterey,2021-06-28,599,453801,391,210842,177,223011,31,19948,261,31415,333,220378,292,251793,California
Monterey,2021-06-29,923,454724,575,211417,263,223274,85,20033,352,31285,566,220944,436,252229,California
Monterey,2021-06-30,1058,455782,715,212132,320,223594,23,20056,439,31133,614,221558,462,252691,California
Monterey,2021-07-01,798,456580,543,212675,232,223826,23,20079,366,31096,425,221983,388,253079,California
Monterey,2021-07-02,946,457526,538,213213,366,224192,42,20121,500,31198,439,222422,541,253620,California
Monterey,2021-07-03,587,458113,448,213661,134,224326,5,20126,270,31159,313,222735,274,253894,California
Monterey,2021-07-04,35,458148,24,213685,10,224336,1,20127,23,31171,12,222747,24,253918,California
Monterey,2021-07-05,393,458541,240,213925,146,224482,7,20134,175,31137,216,222963,182,254100,California
Monterey,2021-07-06,906,459447,640,214565,241,224723,25,20159,380,31020,521,223484,404,254504,California
Monterey,2021-07-07,820,460267,553,215118,244,224967,23,20182,394,31018,419,223903,417,254921,California
Monterey,2021-07-08,860,461127,466,215584,361,225328,33,20215,316,30836,529,224432,347,255268,California
Monterey,2021-07-09,1025,462152,633,216217,352,225680,40,20255,441,30740,576,225008,480,255748,California
Monterey,2021-07-10,843,462995,509,216726,195,225875,139,20394,366,30770,469,225477,499,256247,California
Monterey,2021-07-11,206,463201,139,216865,59,225934,8,20402,104,30784,98,225575,112,256359,California
Monterey,2021-07-12,611,463812,425,217290,167,226101,19,20421,259,30714,347,225922,277,256636,California
Monterey,2021-07-13,779,464591,579,217869,183,226284,17,20438,263,30480,513,226435,279,256915,California
Monterey,2021-07-14,809,465400,548,218417,239,226523,22,20460,413,30530,385,226820,435,257350,California
Monterey,2021-07-15,860,466260,578,218995,273,226796,9,20469,393,30473,458,227278,401,257751,California
Monterey,2021-07-16,944,467204,600,219595,312,227108,32,20501,441,30445,501,227779,473,258224,California
Monterey,2021-07-17,667,467871,473,220068,184,227292,10,20511,324,30442,337,228116,334,258558,California
Monterey,2021-07-18,208,468079,148,220216,58,227350,2,20513,112,30461,96,228212,115,258673,California
Monterey,2021-07-19,600,468679,403,220619,170,227520,27,20540,308,30513,283,228495,335,259008,California
Monterey,2021-07-20,771,469450,506,221125,230,227750,35,20575,379,30540,387,228882,414,259422,California
Monterey,2021-07-21,895,470345,644,221769,232,227982,19,20594,479,30627,412,229294,499,259921,California
Monterey,2021-07-22,930,471275,622,222391,297,228279,11,20605,524,30761,401,229695,535,260456,California
Monterey,2021-07-23,1146,472421,687,223078,391,228670,68,20673,591,30871,549,230244,659,261115,California
Monterey,2021-07-24,580,473001,433,223511,142,228812,5,20678,322,30942,255,230499,326,261441,California
Monterey,2021-07-25,230,473231,153,223664,72,228884,5,20683,167,31051,63,230562,172,261613,California
Monterey,2021-07-26,617,473848,402,224066,197,229081,18,20701,386,31229,226,230788,404,262017,California
Monterey,2021-07-27,879,474727,591,224657,253,229334,35,20736,449,31290,423,231211,484,262501,California
Monterey,2021-07-28,968,475695,726,225383,239,229573,3,20739,638,31606,324,231535,640,263141,California
Monterey,2021-07-29,829,476524,516,225899,283,229856,30,20769,519,31854,300,231835,548,263689,California
Monterey,2021-07-30,956,477480,554,226453,373,230229,29,20798,517,31982,417,232252,545,264234,California
Monterey,2021-07-31,644,478124,496,226949,131,230360,17,20815,383,32128,254,232506,400,264634,California
Napa,2020-12-16,12,12,12,12,0,0,0,0,12,12,0,0,12,12,California
Napa,2020-12-17,48,60,48,60,0,0,0,0,48,60,0,0,48,60,California
Napa,2020-12-18,105,165,105,165,0,0,0,0,105,165,0,0,105,165,California
Napa,2020-12-19,227,392,227,392,0,0,0,0,227,392,0,0,227,392,California
Napa,2020-12-20,189,581,189,581,0,0,0,0,189,581,0,0,189,581,California
Napa,2020-12-21,321,902,321,902,0,0,0,0,322,903,0,0,322,903,California
Napa,2020-12-22,336,1238,327,1229,9,9,0,0,336,1239,0,0,336,1239,California
Napa,2020-12-23,446,1684,332,1561,114,123,0,0,446,1685,0,0,446,1685,California
Napa,2020-12-24,139,1823,78,1639,61,184,0,0,139,1824,0,0,139,1824,California
Napa,2020-12-26,39,1862,11,1650,28,212,0,0,39,1863,0,0,39,1863,California
Napa,2020-12-27,32,1894,16,1666,16,228,0,0,32,1895,0,0,32,1895,California
Napa,2020-12-28,250,2144,184,1850,66,294,0,0,276,2171,0,0,276,2171,California
Napa,2020-12-29,273,2417,217,2067,56,350,0,0,306,2477,0,0,306,2477,California
Napa,2020-12-30,643,3060,491,2558,152,502,0,0,651,3128,0,0,651,3128,California
Napa,2020-12-31,458,3518,370,2928,88,590,0,0,458,3586,0,0,458,3586,California
Napa,2021-01-01,1,3519,1,2929,0,590,0,0,1,3587,0,0,1,3587,California
Napa,2021-01-02,92,3611,87,3016,5,595,0,0,92,3679,0,0,92,3679,California
Napa,2021-01-03,13,3624,11,3027,2,597,0,0,9,3688,0,0,9,3688,California
Napa,2021-01-04,108,3732,64,3091,44,641,0,0,108,3796,0,0,108,3796,California
Napa,2021-01-05,166,3898,88,3179,78,719,0,0,149,3921,24,24,149,3945,California
Napa,2021-01-06,468,4366,117,3296,351,1070,0,0,400,4255,66,90,400,4345,California
Napa,2021-01-07,509,4875,248,3544,261,1331,0,0,396,4539,112,202,396,4741,California
Napa,2021-01-08,438,5313,224,3768,214,1545,0,0,258,4618,179,381,258,4999,California
Napa,2021-01-09,329,5642,304,4072,25,1570,0,0,189,4667,140,521,189,5188,California
Napa,2021-01-10,187,5829,104,4176,83,1653,0,0,109,4699,78,599,110,5298,California
Napa,2021-01-11,885,6714,430,4606,455,2108,0,0,504,4823,382,981,506,5804,California
Napa,2021-01-12,1339,8053,385,4991,954,3062,0,0,1013,5510,326,1307,1013,6817,California
Napa,2021-01-13,1317,9370,267,5258,1050,4112,0,0,1152,6499,164,1471,1153,7970,California
Napa,2021-01-14,1055,10425,167,5425,888,5000,0,0,940,7326,113,1584,940,8910,California
Napa,2021-01-15,1479,11904,391,5816,1088,6088,0,0,1334,8509,152,1736,1335,10245,California
Napa,2021-01-16,363,12267,136,5952,227,6315,0,0,345,8836,18,1754,345,10590,California
Napa,2021-01-17,338,12605,175,6127,163,6478,0,0,329,9156,9,1763,329,10919,California
Napa,2021-01-18,1090,13695,195,6322,895,7373,0,0,999,10064,91,1854,999,11918,California
Napa,2021-01-19,1015,14710,413,6735,602,7975,0,0,769,10588,245,2099,769,12687,California
Napa,2021-01-20,842,15552,193,6928,649,8624,0,0,652,11053,188,2287,653,13340,California
Napa,2021-01-21,1557,17109,593,7521,964,9588,0,0,1108,11714,448,2735,1109,14449,California
Napa,2021-01-22,1572,18681,437,7958,1135,10723,0,0,1228,12600,343,3078,1229,15678,California
Napa,2021-01-23,400,19081,318,8276,82,10805,0,0,339,12878,61,3139,339,16017,California
Napa,2021-01-24,270,19351,186,8462,84,10889,0,0,212,13032,58,3197,212,16229,California
Napa,2021-01-25,1531,20882,230,8692,1301,12190,0,0,1441,14383,90,3287,1441,17670,California
Napa,2021-01-26,879,21761,283,8975,596,12786,0,0,784,15073,95,3382,785,18455,California
Napa,2021-01-27,634,22395,222,9197,412,13198,0,0,469,15378,165,3547,470,18925,California
Napa,2021-01-28,398,22793,178,9375,220,13418,0,0,201,15384,195,3742,201,19126,California
Napa,2021-01-29,267,23060,66,9441,201,13619,0,0,170,15457,97,3839,170,19296,California
Napa,2021-01-30,829,23889,716,10157,113,13732,0,0,659,15946,170,4009,659,19955,California
Napa,2021-01-31,697,24586,665,10822,32,13764,0,0,673,16595,24,4033,673,20628,California
Napa,2021-02-01,325,24911,111,10933,214,13978,0,0,167,16604,158,4191,167,20795,California
Napa,2021-02-02,614,25525,280,11213,334,14312,0,0,300,16593,311,4502,300,21095,California
Napa,2021-02-03,747,26272,310,11523,437,14749,0,0,428,16703,318,4820,428,21523,California
Napa,2021-02-04,790,27062,371,11894,419,15168,0,0,441,16797,347,5167,441,21964,California
Napa,2021-02-05,719,27781,313,12207,406,15574,0,0,340,16759,379,5546,341,22305,California
Napa,2021-02-06,436,28217,143,12350,293,15867,0,0,329,16982,106,5652,329,22634,California
Napa,2021-02-07,175,28392,161,12511,14,15881,0,0,66,16939,109,5761,66,22700,California
Napa,2021-02-08,844,29236,194,12705,650,16531,0,0,273,16643,569,6330,273,22973,California
Napa,2021-02-09,1092,30328,448,13153,644,17175,0,0,442,16436,649,6979,442,23415,California
Napa,2021-02-10,1753,32081,192,13345,1561,18736,0,0,457,15601,1293,8272,458,23873,California
Napa,2021-02-11,1495,33576,189,13534,1306,20042,0,0,404,14927,1078,9350,404,24277,California
Napa,2021-02-12,2186,35762,858,14392,1328,21370,0,0,689,14125,1491,10841,689,24966,California
Napa,2021-02-13,523,36285,60,14452,463,21833,0,0,326,14254,197,11038,326,25292,California
Napa,2021-02-14,335,36620,68,14520,267,22100,0,0,173,14266,161,11199,173,25465,California
Napa,2021-02-15,893,37513,184,14704,709,22809,0,0,233,13841,658,11857,233,25698,California
Napa,2021-02-16,1297,38810,603,15307,694,23503,0,0,618,13783,676,12533,618,26316,California
Napa,2021-02-17,1053,39863,526,15833,527,24030,0,0,477,13687,574,13107,478,26794,California
Napa,2021-02-18,1942,41805,491,16324,1451,25481,0,0,669,13087,1269,14376,669,27463,California
Napa,2021-02-19,1515,43320,600,16924,915,26396,0,0,682,12938,831,15207,682,28145,California
Napa,2021-02-20,882,44202,643,17567,239,26635,0,0,284,12624,598,15805,284,28429,California
Napa,2021-02-21,908,45110,831,18398,77,26712,0,0,199,12114,709,16514,199,28628,California
Napa,2021-02-22,485,45595,200,18598,285,26997,0,0,149,11928,335,16849,149,28777,California
Napa,2021-02-23,1166,46761,310,18908,856,27853,0,0,327,11417,838,17687,327,29104,California
Napa,2021-02-24,1196,47957,655,19563,541,28394,0,0,590,11402,605,18292,590,29694,California
Napa,2021-02-25,2700,50657,1309,20872,1391,29785,0,0,1951,12606,747,19039,1951,31645,California
Napa,2021-02-26,1588,52245,565,21437,1023,30808,0,0,627,12275,958,19997,627,32272,California
Napa,2021-02-27,1184,53429,431,21868,753,31561,0,0,920,12933,262,20259,920,33192,California
Napa,2021-02-28,735,54164,613,22481,122,31683,0,0,616,13433,117,20376,617,33809,California
Napa,2021-03-01,1210,55374,897,23378,312,31995,1,1,923,14072,285,20661,924,34733,California
Napa,2021-03-02,1555,56929,1072,24450,483,32478,0,1,1192,14903,361,21022,1192,35925,California
Napa,2021-03-03,1588,58517,698,25148,890,33368,0,1,1398,16113,188,21210,1398,37323,California
Napa,2021-03-04,1751,60268,804,25952,947,34315,0,1,1502,17369,246,21456,1502,38825,California
Napa,2021-03-05,1927,62195,789,26741,1134,35449,4,5,1502,18454,421,21877,1506,40331,California
Napa,2021-03-06,666,62861,296,27037,340,35789,30,35,547,18915,117,21994,578,40909,California
Napa,2021-03-07,535,63396,298,27335,198,35987,39,74,387,19193,147,22141,425,41334,California
Napa,2021-03-08,725,64121,338,27673,332,36319,55,129,547,19617,174,22315,598,41932,California
Napa,2021-03-09,1700,65821,614,28287,1037,37356,49,178,1254,20476,443,22758,1302,43234,California
Napa,2021-03-10,1511,67332,928,29215,489,37845,94,272,807,20676,698,23456,898,44132,California
Napa,2021-03-11,1895,69227,1074,30289,688,38533,133,405,994,20898,899,24355,1121,45253,California
Napa,2021-03-12,1536,70763,931,31220,512,39045,93,498,832,21119,700,25055,921,46174,California
Napa,2021-03-13,1180,71943,309,31529,847,39892,24,522,832,21629,346,25401,856,47030,California
Napa,2021-03-14,626,72569,339,31868,135,40027,152,674,208,21570,416,25817,357,47387,California
Napa,2021-03-15,968,73537,412,32280,487,40514,69,743,481,21633,485,26302,548,47935,California
Napa,2021-03-16,1859,75396,390,32670,1341,41855,128,871,1385,22677,470,26772,1514,49449,California
Napa,2021-03-17,2507,77903,1834,34504,494,42349,179,1050,1592,23532,914,27686,1769,51218,California
Napa,2021-03-18,2151,80054,958,35462,1179,43528,14,1064,1268,23937,877,28563,1282,52500,California
Napa,2021-03-19,1457,81511,891,36353,542,44070,24,1088,680,23867,774,29337,704,53204,California
Napa,2021-03-20,1027,82538,543,36896,330,44400,154,1242,390,23776,635,29972,544,53748,California
Napa,2021-03-21,730,83268,705,37601,23,44423,2,1244,232,23513,497,30469,234,53982,California
Napa,2021-03-22,1300,84568,1119,38720,170,44593,11,1255,412,23053,883,31352,423,54405,California
Napa,2021-03-23,1910,86478,1216,39936,678,45271,16,1271,1006,23175,900,32252,1022,55427,California
Napa,2021-03-24,1715,88193,942,40878,764,46035,9,1280,814,23097,899,33151,821,56248,California
Napa,2021-03-25,1961,90154,1067,41945,840,46875,54,1334,765,22726,1190,34341,819,57067,California
Napa,2021-03-26,1319,91473,848,42793,466,47341,5,1339,584,22586,729,35070,589,57656,California
Napa,2021-03-27,932,92405,444,43237,461,47802,27,1366,294,22269,638,35708,321,57977,California
Napa,2021-03-28,492,92897,380,43617,105,47907,7,1373,177,22140,313,36021,184,58161,California
Napa,2021-03-29,1211,94108,881,44498,325,48232,5,1378,730,22398,477,36498,735,58896,California
Napa,2021-03-30,2828,96936,945,45443,1878,50110,5,1383,1988,23550,841,37339,1993,60889,California
Napa,2021-03-31,1997,98933,981,46424,947,51057,69,1452,812,23247,1182,38521,879,61768,California
Napa,2021-04-01,1770,100703,849,47273,803,51860,118,1570,485,22569,1277,39798,599,62367,California
Napa,2021-04-02,1889,102592,851,48124,896,52756,142,1712,476,21777,1409,41207,617,62984,California
Napa,2021-04-03,643,103235,373,48497,212,52968,58,1770,213,21617,429,41636,269,63253,California
Napa,2021-04-04,359,103594,147,48644,154,53122,58,1828,123,21563,235,41871,181,63434,California
Napa,2021-04-05,1285,104879,760,49404,304,53426,221,2049,572,21645,710,42581,792,64226,California
Napa,2021-04-06,2273,107152,565,49969,1445,54871,263,2312,511,20658,1759,44340,772,64998,California
Napa,2021-04-07,1771,108923,720,50689,828,55699,223,2535,530,20175,1234,45574,751,65749,California
Napa,2021-04-08,1877,110800,1077,51766,420,56119,380,2915,963,20609,908,46482,1342,67091,California
Napa,2021-04-09,1576,112376,937,52703,331,56450,308,3223,679,20701,894,47376,986,68077,California
Napa,2021-04-10,1044,113420,343,53046,597,57047,104,3327,236,20236,805,48181,340,68417,California
Napa,2021-04-11,388,113808,305,53351,61,57108,22,3349,159,20188,229,48410,181,68598,California
Napa,2021-04-12,797,114605,302,53653,369,57477,126,3475,296,20105,499,48909,416,69014,California
Napa,2021-04-13,2598,117203,870,54523,1728,59205,0,3475,933,19380,1658,50567,933,69947,California
Napa,2021-04-14,2158,119361,1013,55536,1145,60350,0,3475,1047,19324,1103,51670,1047,70994,California
Napa,2021-04-15,2072,121433,532,56068,1540,61890,0,3475,877,19015,1186,52856,877,71871,California
Napa,2021-04-16,3043,124476,1671,57739,1372,63262,0,3475,2309,20595,729,53585,2309,74180,California
Napa,2021-04-17,1176,125652,287,58026,889,64151,0,3475,861,21143,313,53898,861,75041,California
Napa,2021-04-18,285,125937,193,58219,92,64243,0,3475,120,21098,165,54063,120,75161,California
Napa,2021-04-19,626,126563,340,58559,286,64529,0,3475,271,21016,353,54416,271,75432,California
Napa,2021-04-20,3101,129664,2115,60674,986,65515,0,3475,2111,22141,987,55403,2112,77544,California
Napa,2021-04-21,3028,132692,2242,62916,786,66301,0,3475,1917,22954,1105,56508,1918,79462,California
Napa,2021-04-22,1870,134562,1305,64221,564,66865,1,3476,864,22818,1000,57508,864,80326,California
Napa,2021-04-23,1684,136246,1290,65511,392,67257,2,3478,1187,23512,493,58001,1187,81513,California
Napa,2021-04-24,579,136825,321,65832,258,67515,0,3478,293,23522,283,58284,293,81806,California
Napa,2021-04-25,257,137082,194,66026,63,67578,0,3478,132,23531,123,58407,132,81938,California
Napa,2021-04-26,556,137638,288,66314,268,67846,0,3478,286,23553,264,58671,286,82224,California
Napa,2021-04-27,1806,139444,476,66790,1318,69164,12,3490,600,22962,1203,59874,612,82836,California
Napa,2021-04-28,1045,140489,484,67274,544,69708,17,3507,355,22647,687,60561,372,83208,California
Napa,2021-04-29,739,141228,370,67644,350,70058,19,3526,262,22459,468,61029,280,83488,California
Napa,2021-04-30,634,141862,318,67962,252,70310,64,3590,261,22412,371,61400,324,83812,California
Napa,2021-05-01,331,142193,267,68229,53,70363,11,3601,127,22346,204,61604,138,83950,California
Napa,2021-05-02,239,142432,196,68425,37,70400,6,3607,100,22314,138,61742,106,84056,California
Napa,2021-05-03,637,143069,496,68921,105,70505,36,3643,111,21940,522,62264,148,84204,California
Napa,2021-05-04,1161,144230,740,69661,311,70816,110,3753,317,21526,840,63104,426,84630,California
Napa,2021-05-05,1046,145276,705,70366,302,71118,39,3792,261,21044,782,63886,300,84930,California
Napa,2021-05-06,726,146002,316,70682,387,71505,23,3815,376,21103,341,64227,400,85330,California
Napa,2021-05-07,1613,147615,1381,72063,168,71673,64,3879,335,20247,1254,65481,398,85728,California
Napa,2021-05-08,263,147878,167,72230,85,71758,11,3890,88,20174,172,65653,99,85827,California
Napa,2021-05-09,120,147998,87,72317,33,71791,0,3890,58,20172,60,65713,58,85885,California
Napa,2021-05-10,436,148434,151,72468,265,72056,20,3910,111,19979,324,66037,131,86016,California
Napa,2021-05-11,2237,150671,1844,74312,368,72424,25,3935,385,18542,1847,67884,410,86426,California
Napa,2021-05-12,2274,152945,1422,75734,795,73219,57,3992,318,16966,1950,69834,374,86800,California
Napa,2021-05-13,1966,154911,1265,76999,662,73881,39,4031,872,16791,1087,70921,912,87712,California
Napa,2021-05-14,1992,156903,1206,78205,701,74582,85,4116,537,15965,1449,72370,623,88335,California
Napa,2021-05-15,1084,157987,367,78572,705,75287,12,4128,258,15415,821,73191,271,88606,California
Napa,2021-05-16,251,158238,170,78742,79,75366,2,4130,71,15308,180,73371,73,88679,California
Napa,2021-05-17,903,159141,354,79096,519,75885,30,4160,304,15108,535,73906,335,89014,California
Napa,2021-05-18,1082,160223,559,79655,466,76351,57,4217,516,15120,561,74467,573,89587,California
Napa,2021-05-19,994,161217,590,80245,374,76725,30,4247,517,15193,473,74940,546,90133,California
Napa,2021-05-20,661,161878,435,80680,196,76921,30,4277,385,15335,273,75213,415,90548,California
Napa,2021-05-21,532,162410,268,80948,232,77153,32,4309,220,15277,310,75523,252,90800,California
Napa,2021-05-22,468,162878,282,81230,177,77330,9,4318,194,15207,274,75797,204,91004,California
Napa,2021-05-23,404,163282,358,81588,35,77365,11,4329,300,15414,104,75901,311,91315,California
Napa,2021-05-24,379,163661,187,81775,172,77537,20,4349,153,15364,223,76124,173,91488,California
Napa,2021-05-25,426,164087,174,81949,181,77718,71,4420,143,15296,281,76405,213,91701,California
Napa,2021-05-26,555,164642,357,82306,172,77890,26,4446,315,15401,236,76641,341,92042,California
Napa,2021-05-27,385,165027,170,82476,187,78077,28,4474,150,15344,235,76876,178,92220,California
Napa,2021-05-28,408,165435,210,82686,174,78251,24,4498,166,15294,238,77114,188,92408,California
Napa,2021-05-29,131,165566,79,82765,48,78299,4,4502,76,15320,54,77168,80,92488,California
Napa,2021-05-30,99,165665,63,82828,31,78330,5,4507,28,15285,68,77236,33,92521,California
Napa,2021-05-31,51,165716,17,82845,28,78358,6,4513,9,15258,42,77278,15,92536,California
Napa,2021-06-01,610,166326,310,83155,276,78634,24,4537,264,15205,340,77618,287,92823,California
Napa,2021-06-02,417,166743,249,83404,146,78780,22,4559,195,15201,220,77838,216,93039,California
Napa,2021-06-03,753,167496,453,83857,275,79055,25,4584,127,14729,622,78460,150,93189,California
Napa,2021-06-04,790,168286,609,84466,143,79198,38,4622,142,14264,644,79104,179,93368,California
Napa,2021-06-05,313,168599,255,84721,47,79245,11,4633,75,14114,236,79340,86,93454,California
Napa,2021-06-06,147,168746,127,84848,19,79264,1,4634,46,14061,100,79440,47,93501,California
Napa,2021-06-07,408,169154,295,85143,85,79349,28,4662,101,13884,306,79746,129,93630,California
Napa,2021-06-08,627,169781,496,85639,114,79463,17,4679,279,13835,345,80091,296,93926,California
Napa,2021-06-09,566,170347,457,86096,94,79557,15,4694,92,13472,470,80561,107,94033,California
Napa,2021-06-10,519,170866,419,86515,68,79625,32,4726,107,13200,411,80972,139,94172,California
Napa,2021-06-11,409,171275,268,86783,118,79743,23,4749,116,13047,292,81264,139,94311,California
Napa,2021-06-12,206,171481,172,86955,29,79772,5,4754,41,12930,164,81428,47,94358,California
Napa,2021-06-13,291,171772,278,87233,8,79780,5,4759,27,12698,264,81692,32,94390,California
Napa,2021-06-14,483,172255,341,87574,115,79895,27,4786,90,12424,388,82080,114,94504,California
Napa,2021-06-15,375,172630,277,87851,85,79980,13,4799,187,12437,187,82267,200,94704,California
Napa,2021-06-16,261,172891,164,88015,81,80061,16,4815,83,12362,174,82441,99,94803,California
Napa,2021-06-17,398,173289,326,88341,63,80124,9,4824,75,12123,323,82764,84,94887,California
Napa,2021-06-18,274,173563,179,88520,84,80208,11,4835,93,12049,179,82943,105,94992,California
Napa,2021-06-19,107,173670,74,88594,23,80231,10,4845,45,12043,61,83004,55,95047,California
Napa,2021-06-20,54,173724,42,88636,9,80240,3,4848,19,12030,35,83039,22,95069,California
Napa,2021-06-21,159,173883,73,88709,66,80306,20,4868,76,12043,82,83121,95,95164,California
Napa,2021-06-22,377,174260,299,89008,63,80369,15,4883,109,11900,267,83388,124,95288,California
Napa,2021-06-23,341,174601,265,89273,54,80423,22,4905,106,11796,231,83619,127,95415,California
Napa,2021-06-24,169,174770,114,89387,49,80472,6,4911,72,11779,95,83714,78,95493,California
Napa,2021-06-25,247,175017,163,89550,71,80543,13,4924,121,11793,119,83833,133,95626,California
Napa,2021-06-26,95,175112,81,89631,10,80553,4,4928,49,11800,46,83879,53,95679,California
Napa,2021-06-27,72,175184,62,89693,10,80563,0,4928,34,11796,38,83917,34,95713,California
Napa,2021-06-28,192,175376,147,89840,33,80596,12,4940,80,11776,111,84028,91,95804,California
Napa,2021-06-29,415,175791,339,90179,57,80653,19,4959,111,11604,302,84330,130,95934,California
Napa,2021-06-30,180,175971,122,90301,48,80701,10,4969,76,11587,103,84433,86,96020,California
Napa,2021-07-01,169,176140,114,90415,46,80747,9,4978,77,11581,91,84524,85,96105,California
Napa,2021-07-02,172,176312,130,90545,35,80782,7,4985,68,11553,103,84627,75,96180,California
Napa,2021-07-03,74,176386,60,90605,8,80790,6,4991,42,11570,31,84658,48,96228,California
Napa,2021-07-04,7,176393,0,90605,6,80796,1,4992,0,11564,7,84665,1,96229,California
Napa,2021-07-05,91,176484,71,90676,15,80811,5,4997,49,11576,42,84707,54,96283,California
Napa,2021-07-06,328,176812,283,90959,33,80844,12,5009,118,11498,207,84914,129,96412,California
Napa,2021-07-07,163,176975,113,91072,38,80882,12,5021,70,11487,93,85007,82,96494,California
Napa,2021-07-08,171,177146,123,91195,31,80913,17,5038,71,11476,97,85104,86,96580,California
Napa,2021-07-09,201,177347,125,91320,59,80972,17,5055,86,11467,112,85216,103,96683,California
Napa,2021-07-10,79,177426,48,91368,27,80999,4,5059,42,11476,37,85253,46,96729,California
Napa,2021-07-11,59,177485,54,91422,5,81004,0,5059,22,11465,33,85286,22,96751,California
Napa,2021-07-12,162,177647,121,91543,31,81035,10,5069,70,11454,91,85377,80,96831,California
Napa,2021-07-13,296,177943,250,91793,27,81062,19,5088,180,11538,113,85490,197,97028,California
Napa,2021-07-14,163,178106,117,91910,32,81094,14,5102,71,11531,92,85582,85,97113,California
Napa,2021-07-15,193,178299,147,92057,40,81134,6,5108,94,11536,94,85676,99,97212,California
Napa,2021-07-16,204,178503,157,92214,39,81173,8,5116,85,11511,118,85794,93,97305,California
Napa,2021-07-17,88,178591,67,92281,13,81186,8,5124,34,11500,53,85847,42,97347,California
Napa,2021-07-18,49,178640,40,92321,5,81191,4,5128,18,11491,31,85878,22,97369,California
Napa,2021-07-19,179,178819,125,92446,42,81233,12,5140,83,11490,96,85974,95,97464,California
Napa,2021-07-20,366,179185,295,92741,52,81285,19,5159,229,11605,133,86107,248,97712,California
Napa,2021-07-21,146,179331,107,92848,31,81316,8,5167,75,11619,69,86176,83,97795,California
Napa,2021-07-22,171,179502,137,92985,21,81337,13,5180,94,11651,74,86250,106,97901,California
Napa,2021-07-23,212,179714,154,93139,47,81384,11,5191,140,11731,71,86321,151,98052,California
Napa,2021-07-24,104,179818,93,93232,8,81392,3,5194,58,11748,44,86365,61,98113,California
Napa,2021-07-25,52,179870,45,93277,7,81399,0,5194,41,11780,9,86374,41,98154,California
Napa,2021-07-26,201,180071,142,93419,54,81453,5,5199,124,11835,74,86448,129,98283,California
Napa,2021-07-27,271,180342,222,93641,46,81499,3,5202,173,11916,95,86543,176,98459,California
Napa,2021-07-28,180,180522,139,93780,30,81529,11,5213,95,11938,82,86625,104,98563,California
Napa,2021-07-29,147,180669,107,93887,27,81556,13,5226,71,11947,74,86699,83,98646,California
Napa,2021-07-30,175,180844,132,94019,27,81583,16,5242,105,11999,69,86768,121,98767,California
Napa,2021-07-31,67,180911,51,94070,12,81595,4,5246,47,12030,20,86788,51,98818,California
Nevada,2020-12-16,2,2,2,2,0,0,0,0,2,2,0,0,2,2,California
Nevada,2020-12-17,6,8,6,8,0,0,0,0,6,8,0,0,6,8,California
Nevada,2020-12-18,60,68,60,68,0,0,0,0,60,68,0,0,60,68,California
Nevada,2020-12-19,53,121,53,121,0,0,0,0,53,121,0,0,53,121,California
Nevada,2020-12-20,16,137,16,137,0,0,0,0,16,137,0,0,16,137,California
Nevada,2020-12-21,68,205,68,205,0,0,0,0,68,205,0,0,68,205,California
Nevada,2020-12-22,94,299,92,297,2,2,0,0,94,299,0,0,94,299,California
Nevada,2020-12-23,243,542,212,509,31,33,0,0,243,542,0,0,243,542,California
Nevada,2020-12-24,15,557,12,521,3,36,0,0,15,557,0,0,15,557,California
Nevada,2020-12-25,3,560,3,524,0,36,0,0,3,560,0,0,3,560,California
Nevada,2020-12-26,7,567,5,529,2,38,0,0,7,567,0,0,7,567,California
Nevada,2020-12-27,92,659,91,620,1,39,0,0,92,659,0,0,92,659,California
Nevada,2020-12-28,172,831,92,712,80,119,0,0,172,831,0,0,172,831,California
Nevada,2020-12-29,101,932,71,783,30,149,0,0,101,932,0,0,101,932,California
Nevada,2020-12-30,87,1019,64,847,23,172,0,0,87,1019,0,0,87,1019,California
Nevada,2020-12-31,45,1064,9,856,36,208,0,0,45,1064,0,0,45,1064,California
Nevada,2021-01-01,3,1067,0,856,3,211,0,0,3,1067,0,0,3,1067,California
Nevada,2021-01-02,2,1069,1,857,1,212,0,0,2,1069,0,0,2,1069,California
Nevada,2021-01-03,132,1201,127,984,5,217,0,0,132,1201,0,0,132,1201,California
Nevada,2021-01-04,76,1277,43,1027,33,250,0,0,76,1277,0,0,76,1277,California
Nevada,2021-01-05,284,1561,129,1156,155,405,0,0,283,1559,1,1,283,1560,California
Nevada,2021-01-06,95,1656,44,1200,51,456,0,0,88,1640,7,8,88,1648,California
Nevada,2021-01-07,224,1880,44,1244,180,636,0,0,215,1848,8,16,216,1864,California
Nevada,2021-01-08,237,2117,132,1376,105,741,0,0,177,1966,60,76,178,2042,California
Nevada,2021-01-09,63,2180,56,1432,7,748,0,0,14,1931,49,125,14,2056,California
Nevada,2021-01-10,22,2202,11,1443,11,759,0,0,12,1933,10,135,12,2068,California
Nevada,2021-01-11,197,2399,135,1578,62,821,0,0,67,1870,130,265,67,2135,California
Nevada,2021-01-12,607,3006,458,2036,149,970,0,0,536,2335,71,336,536,2671,California
Nevada,2021-01-13,274,3280,155,2191,119,1089,0,0,135,2331,139,475,135,2806,California
Nevada,2021-01-14,251,3531,127,2318,124,1213,0,0,232,2545,18,493,232,3038,California
Nevada,2021-01-15,419,3950,174,2492,245,1458,0,0,317,2760,102,595,317,3355,California
Nevada,2021-01-16,340,4290,21,2513,319,1777,0,0,334,3088,6,601,334,3689,California
Nevada,2021-01-17,44,4334,39,2552,5,1782,0,0,41,3126,3,604,41,3730,California
Nevada,2021-01-18,159,4493,44,2596,115,1897,0,0,148,3263,11,615,148,3878,California
Nevada,2021-01-19,266,4759,100,2696,166,2063,0,0,243,3483,23,638,243,4121,California
Nevada,2021-01-20,283,5042,168,2864,115,2178,0,0,269,3738,14,652,269,4390,California
Nevada,2021-01-21,348,5390,205,3069,143,2321,0,0,333,4056,15,667,333,4723,California
Nevada,2021-01-22,388,5778,237,3306,151,2472,0,0,356,4380,32,699,356,5079,California
Nevada,2021-01-23,192,5970,108,3414,84,2556,0,0,192,4572,0,699,192,5271,California
Nevada,2021-01-24,123,6093,110,3524,13,2569,0,0,81,4611,42,741,81,5352,California
Nevada,2021-01-25,264,6357,127,3651,137,2706,0,0,198,4743,66,807,198,5550,California
Nevada,2021-01-26,444,6801,154,3805,290,2996,0,0,337,4973,107,914,337,5887,California
Nevada,2021-01-27,472,7273,277,4082,195,3191,0,0,443,5387,29,943,443,6330,California
Nevada,2021-01-28,511,7784,340,4422,171,3362,0,0,460,5797,50,993,460,6790,California
Nevada,2021-01-29,639,8423,402,4824,237,3599,0,0,610,6380,28,1021,611,7401,California
Nevada,2021-01-30,331,8754,131,4955,200,3799,0,0,328,6705,3,1024,328,7729,California
Nevada,2021-01-31,113,8867,95,5050,18,3817,0,0,109,6812,3,1027,110,7839,California
Nevada,2021-02-01,308,9175,79,5129,229,4046,0,0,288,7080,20,1047,288,8127,California
Nevada,2021-02-02,566,9741,201,5330,365,4411,0,0,350,7214,216,1263,350,8477,California
Nevada,2021-02-03,832,10573,563,5893,269,4680,0,0,772,7927,59,1322,772,9249,California
Nevada,2021-02-04,790,11363,403,6296,387,5067,0,0,530,8198,259,1581,530,9779,California
Nevada,2021-02-05,722,12085,393,6689,329,5396,0,0,518,8514,202,1783,518,10297,California
Nevada,2021-02-06,306,12391,109,6798,197,5593,0,0,267,8742,39,1822,267,10564,California
Nevada,2021-02-07,318,12709,254,7052,64,5657,0,0,255,8935,62,1884,255,10819,California
Nevada,2021-02-08,705,13414,425,7477,280,5937,0,0,592,9416,111,1995,592,11411,California
Nevada,2021-02-09,654,14068,373,7850,281,6218,0,0,506,9775,147,2142,506,11917,California
Nevada,2021-02-10,691,14759,346,8196,345,6563,0,0,458,10001,233,2375,459,12376,California
Nevada,2021-02-11,945,15704,536,8732,409,6972,0,0,596,10249,348,2723,596,12972,California
Nevada,2021-02-12,1006,16710,464,9196,542,7514,0,0,669,10584,334,3057,669,13641,California
Nevada,2021-02-13,692,17402,274,9470,418,7932,0,0,428,10752,260,3317,428,14069,California
Nevada,2021-02-14,250,17652,137,9607,113,8045,0,0,211,10924,39,3356,211,14280,California
Nevada,2021-02-15,753,18405,455,10062,298,8343,0,0,577,11325,176,3532,577,14857,California
Nevada,2021-02-16,689,19094,237,10299,452,8795,0,0,505,11647,183,3715,505,15362,California
Nevada,2021-02-17,1261,20355,815,11114,446,9241,0,0,892,12171,369,4084,893,16255,California
Nevada,2021-02-18,1054,21409,584,11698,470,9711,0,0,621,12363,429,4513,621,16876,California
Nevada,2021-02-19,1163,22572,668,12366,495,10206,0,0,780,12764,380,4893,781,17657,California
Nevada,2021-02-20,384,22956,136,12502,248,10454,0,0,226,12833,157,5050,226,17883,California
Nevada,2021-02-21,127,23083,105,12607,22,10476,0,0,21,12752,102,5152,21,17904,California
Nevada,2021-02-22,540,23623,363,12970,177,10653,0,0,378,12969,161,5313,378,18282,California
Nevada,2021-02-23,545,24168,259,13229,286,10939,0,0,226,12880,316,5629,227,18509,California
Nevada,2021-02-24,569,24737,307,13536,262,11201,0,0,263,12844,303,5932,267,18776,California
Nevada,2021-02-25,923,25660,507,14043,416,11617,0,0,450,12825,469,6401,450,19226,California
Nevada,2021-02-26,1352,27012,928,14971,424,12041,0,0,475,12425,875,7276,475,19701,California
Nevada,2021-02-27,493,27505,134,15105,359,12400,0,0,222,12376,271,7547,222,19923,California
Nevada,2021-02-28,373,27878,230,15335,143,12543,0,0,154,12313,217,7764,154,20077,California
Nevada,2021-03-01,906,28784,474,15809,432,12975,0,0,398,12207,504,8268,398,20475,California
Nevada,2021-03-02,823,29607,331,16140,492,13467,0,0,535,12459,283,8551,535,21010,California
Nevada,2021-03-03,1076,30683,547,16687,528,13995,1,1,546,12480,527,9078,548,21558,California
Nevada,2021-03-04,1200,31883,661,17348,539,14534,0,1,490,12264,706,9784,490,22048,California
Nevada,2021-03-05,1262,33145,524,17872,728,15262,10,11,733,12481,526,10310,743,22791,California
Nevada,2021-03-06,398,33543,140,18012,231,15493,27,38,154,12417,244,10554,180,22971,California
Nevada,2021-03-07,232,33775,118,18130,88,15581,26,64,73,12357,159,10713,99,23070,California
Nevada,2021-03-08,902,34677,586,18716,267,15848,49,113,400,12305,501,11214,449,23519,California
Nevada,2021-03-09,841,35518,426,19142,360,16208,55,168,471,12463,367,11581,525,24044,California
Nevada,2021-03-10,1059,36577,674,19816,326,16534,59,227,356,12181,695,12276,413,24457,California
Nevada,2021-03-11,1166,37743,744,20560,395,16929,27,254,563,12177,594,12870,590,25047,California
Nevada,2021-03-12,1581,39324,738,21298,809,17738,34,288,836,12305,741,13611,869,25916,California
Nevada,2021-03-13,953,40277,63,21361,884,18622,6,294,754,12867,197,13808,759,26675,California
Nevada,2021-03-14,167,40444,27,21388,134,18756,6,300,36,12778,131,13939,42,26717,California
Nevada,2021-03-15,900,41344,480,21868,408,19164,12,312,374,12643,521,14460,386,27103,California
Nevada,2021-03-16,1033,42377,467,22335,503,19667,63,375,659,12992,372,14832,721,27824,California
Nevada,2021-03-17,1041,43418,452,22787,579,20246,10,385,582,13129,456,15288,593,28417,California
Nevada,2021-03-18,1021,44439,551,23338,448,20694,22,407,488,13112,526,15814,509,28926,California
Nevada,2021-03-19,956,45395,456,23794,462,21156,38,445,381,12961,570,16384,419,29345,California
Nevada,2021-03-20,860,46255,98,23892,320,21476,442,887,216,12975,638,17022,652,29997,California
Nevada,2021-03-21,69,46324,35,23927,33,21509,1,888,36,12980,32,17054,37,30034,California
Nevada,2021-03-22,832,47156,533,24460,295,21804,4,892,542,13239,287,17341,546,30580,California
Nevada,2021-03-23,878,48034,399,24859,451,22255,28,920,632,13657,242,17583,660,31240,California
Nevada,2021-03-24,1054,49088,565,25424,482,22737,7,927,654,13925,392,17975,660,31900,California
Nevada,2021-03-25,940,50028,485,25909,427,23164,28,955,505,14024,432,18407,531,32431,California
Nevada,2021-03-26,1255,51283,482,26391,731,23895,42,997,870,14552,383,18790,911,33342,California
Nevada,2021-03-27,619,51902,76,26467,527,24422,16,1013,407,14764,211,19001,423,33765,California
Nevada,2021-03-28,205,52107,55,26522,137,24559,13,1026,36,14650,163,19164,49,33814,California
Nevada,2021-03-29,878,52985,523,27045,334,24893,21,1047,385,14568,487,19651,405,34219,California
Nevada,2021-03-30,1107,54092,495,27540,578,25471,34,1081,507,14517,593,20244,542,34761,California
Nevada,2021-03-31,1219,55311,679,28219,523,25994,17,1098,681,14685,528,20772,696,35457,California
Nevada,2021-04-01,1292,56603,749,28968,490,26484,53,1151,574,14604,706,21478,625,36082,California
Nevada,2021-04-02,1343,57946,664,29632,645,27129,34,1185,818,14934,522,22000,852,36934,California
Nevada,2021-04-03,304,58250,92,29724,177,27306,35,1220,87,14840,216,22216,122,37056,California
Nevada,2021-04-04,140,58390,48,29772,85,27391,7,1227,82,14871,58,22274,89,37145,California
Nevada,2021-04-05,978,59368,641,30413,314,27705,23,1250,626,15171,347,22621,647,37792,California
Nevada,2021-04-06,1106,60474,680,31093,280,27985,146,1396,459,15133,641,23262,603,38395,California
Nevada,2021-04-07,1186,61660,840,31933,258,28243,88,1484,636,15314,542,23804,723,39118,California
Nevada,2021-04-08,1331,62991,910,32843,329,28572,92,1576,728,15536,597,24401,819,39937,California
Nevada,2021-04-09,1309,64300,864,33707,370,28942,75,1651,863,16029,444,24845,937,40874,California
Nevada,2021-04-10,910,65210,90,33797,744,29686,76,1727,136,15473,768,25613,212,41086,California
Nevada,2021-04-11,113,65323,37,33834,70,29756,6,1733,35,15436,78,25691,41,41127,California
Nevada,2021-04-12,785,66108,565,34399,202,29958,18,1751,324,15322,456,26147,342,41469,California
Nevada,2021-04-13,906,67014,372,34771,534,30492,0,1751,457,15335,444,26591,457,41926,California
Nevada,2021-04-14,1084,68098,602,35373,482,30974,0,1751,538,15334,539,27130,538,42464,California
Nevada,2021-04-15,1111,69209,720,36093,391,31365,0,1751,621,15477,478,27608,621,43085,California
Nevada,2021-04-16,932,70141,707,36800,225,31590,0,1751,517,15581,413,28021,517,43602,California
Nevada,2021-04-17,201,70342,54,36854,147,31737,0,1751,83,15547,117,28138,83,43685,California
Nevada,2021-04-18,207,70549,22,36876,185,31922,0,1751,104,15548,103,28241,104,43789,California
Nevada,2021-04-19,798,71347,508,37384,290,32212,0,1751,312,15385,475,28716,312,44101,California
Nevada,2021-04-20,831,72178,342,37726,489,32701,0,1751,308,15178,515,29231,308,44409,California
Nevada,2021-04-21,965,73143,546,38272,419,33120,0,1751,283,14791,670,29901,283,44692,California
Nevada,2021-04-22,1035,74178,647,38919,388,33508,0,1751,346,14462,676,30577,347,45039,California
Nevada,2021-04-23,1285,75463,570,39489,715,34223,0,1751,405,13998,869,31446,405,45444,California
Nevada,2021-04-24,536,75999,80,39569,456,34679,0,1751,178,13820,356,31802,178,45622,California
Nevada,2021-04-25,137,76136,62,39631,70,34749,5,1756,56,13800,80,31882,60,45682,California
Nevada,2021-04-26,782,76918,593,40224,180,34929,9,1765,221,13479,551,32433,230,45912,California
Nevada,2021-04-27,847,77765,400,40624,442,35371,5,1770,410,13465,429,32862,415,46327,California
Nevada,2021-04-28,1023,78788,606,41230,412,35783,5,1775,389,13232,627,33489,394,46721,California
Nevada,2021-04-29,1062,79850,738,41968,319,36102,5,1780,299,12777,759,34248,304,47025,California
Nevada,2021-04-30,1304,81154,754,42722,540,36642,10,1790,223,11931,1079,35327,233,47258,California
Nevada,2021-05-01,156,81310,70,42792,82,36724,4,1794,66,11913,88,35415,70,47328,California
Nevada,2021-05-02,67,81377,34,42826,29,36753,4,1798,23,11896,44,35459,27,47355,California
Nevada,2021-05-03,632,82009,425,43251,188,36941,19,1817,180,11648,446,35905,198,47553,California
Nevada,2021-05-04,604,82613,178,43429,407,37348,19,1836,328,11724,272,36177,348,47901,California
Nevada,2021-05-05,765,83378,403,43832,347,37695,15,1851,327,11636,430,36607,342,48243,California
Nevada,2021-05-06,833,84211,579,44411,243,37938,11,1862,205,11236,618,37225,218,48461,California
Nevada,2021-05-07,909,85120,498,44909,374,38312,37,1899,183,10740,718,37943,222,48683,California
Nevada,2021-05-08,180,85300,23,44932,138,38450,19,1918,78,10737,100,38043,97,48780,California
Nevada,2021-05-09,44,85344,7,44939,35,38485,2,1920,20,10735,24,38067,22,48802,California
Nevada,2021-05-10,412,85756,263,45202,124,38609,25,1945,75,10500,336,38403,101,48903,California
Nevada,2021-05-11,520,86276,162,45364,338,38947,20,1965,126,10263,385,38788,148,49051,California
Nevada,2021-05-12,549,86825,249,45613,289,39236,11,1976,150,10037,389,39177,163,49214,California
Nevada,2021-05-13,858,87683,562,46175,286,39522,10,1986,435,10070,414,39591,447,49661,California
Nevada,2021-05-14,796,88479,585,46760,194,39716,17,2003,436,10169,356,39947,455,50116,California
Nevada,2021-05-15,185,88664,90,46850,89,39805,6,2009,88,10167,96,40043,94,50210,California
Nevada,2021-05-16,166,88830,56,46906,110,39915,0,2009,56,10113,110,40153,56,50266,California
Nevada,2021-05-17,513,89343,329,47235,152,40067,32,2041,218,10081,283,40436,251,50517,California
Nevada,2021-05-18,430,89773,258,47493,167,40234,5,2046,219,10098,208,40644,225,50742,California
Nevada,2021-05-19,498,90271,353,47846,140,40374,5,2051,252,10118,237,40881,257,50999,California
Nevada,2021-05-20,621,90892,362,48208,246,40620,13,2064,215,9945,401,41282,228,51227,California
Nevada,2021-05-21,525,91417,340,48548,175,40795,10,2074,221,9878,298,41580,231,51458,California
Nevada,2021-05-22,257,91674,39,48587,164,40959,54,2128,93,9862,163,41743,147,51605,California
Nevada,2021-05-23,54,91728,17,48604,37,40996,0,2128,17,9843,36,41779,17,51622,California
Nevada,2021-05-24,323,92051,223,48827,83,41079,17,2145,106,9754,213,41992,124,51746,California
Nevada,2021-05-25,348,92399,84,48911,250,41329,14,2159,82,9590,260,42252,96,51842,California
Nevada,2021-05-26,453,92852,200,49111,243,41572,10,2169,137,9428,309,42561,147,51989,California
Nevada,2021-05-27,445,93297,235,49346,188,41760,22,2191,181,9372,259,42820,203,52192,California
Nevada,2021-05-28,358,93655,219,49565,113,41873,26,2217,188,9420,167,42987,215,52407,California
Nevada,2021-05-29,68,93723,13,49578,55,41928,0,2217,40,9432,28,43015,40,52447,California
Nevada,2021-05-30,43,93766,19,49597,22,41950,2,2219,29,9449,14,43029,31,52478,California
Nevada,2021-05-31,6,93772,4,49601,0,41950,2,2221,2,9449,4,43033,4,52482,California
Nevada,2021-06-01,421,94193,128,49729,274,42224,19,2240,99,9255,312,43345,118,52600,California
Nevada,2021-06-02,404,94597,165,49894,232,42456,7,2247,104,9075,291,43636,111,52711,California
Nevada,2021-06-03,567,95164,406,50300,156,42612,5,2252,99,8715,464,44100,104,52815,California
Nevada,2021-06-04,540,95704,434,50734,102,42714,4,2256,106,8396,429,44529,110,52925,California
Nevada,2021-06-05,173,95877,72,50806,99,42813,2,2258,68,8362,104,44633,70,52995,California
Nevada,2021-06-06,57,95934,41,50847,16,42829,0,2258,15,8335,42,44675,15,53010,California
Nevada,2021-06-07,272,96206,196,51043,45,42874,31,2289,60,8219,207,44882,91,53101,California
Nevada,2021-06-08,285,96491,188,51231,85,42959,12,2301,65,8085,211,45093,77,53178,California
Nevada,2021-06-09,321,96812,215,51446,99,43058,7,2308,82,7939,235,45328,89,53267,California
Nevada,2021-06-10,274,97086,177,51623,87,43145,10,2318,72,7824,196,45524,81,53348,California
Nevada,2021-06-11,326,97412,232,51855,75,43220,19,2337,73,7665,250,45774,91,53439,California
Nevada,2021-06-12,93,97505,54,51909,34,43254,5,2342,28,7633,65,45839,33,53472,California
Nevada,2021-06-13,32,97537,16,51925,15,43269,1,2343,6,7614,26,45865,7,53479,California
Nevada,2021-06-14,191,97728,136,52061,44,43313,11,2354,50,7541,134,45999,61,53540,California
Nevada,2021-06-15,166,97894,95,52156,63,43376,8,2362,62,7510,101,46100,70,53610,California
Nevada,2021-06-16,242,98136,136,52292,97,43473,9,2371,71,7426,164,46264,80,53690,California
Nevada,2021-06-17,228,98364,136,52428,79,43552,13,2384,43,7298,184,46448,56,53746,California
Nevada,2021-06-18,222,98586,154,52582,50,43602,18,2402,70,7236,150,46598,88,53834,California
Nevada,2021-06-19,70,98656,33,52615,31,43633,6,2408,29,7230,41,46639,35,53869,California
Nevada,2021-06-20,29,98685,21,52636,7,43640,1,2409,9,7221,19,46658,10,53879,California
Nevada,2021-06-21,109,98794,49,52685,53,43693,7,2416,48,7221,55,46713,55,53934,California
Nevada,2021-06-22,166,98960,98,52783,56,43749,12,2428,68,7209,92,46805,80,54014,California
Nevada,2021-06-23,211,99171,139,52922,44,43793,28,2456,87,7204,119,46924,114,54128,California
Nevada,2021-06-24,178,99349,112,53034,48,43841,18,2474,59,7168,113,47037,77,54205,California
Nevada,2021-06-25,204,99553,136,53170,46,43887,22,2496,72,7130,132,47169,94,54299,California
Nevada,2021-06-26,88,99641,67,53237,18,43905,3,2499,35,7115,53,47222,38,54337,California
Nevada,2021-06-27,33,99674,15,53252,14,43919,4,2503,8,7102,25,47247,12,54349,California
Nevada,2021-06-28,167,99841,119,53371,28,43947,20,2523,67,7097,92,47339,87,54436,California
Nevada,2021-06-29,135,99976,79,53450,44,43991,12,2535,50,7082,77,47416,62,54498,California
Nevada,2021-06-30,176,100152,130,53580,40,44031,6,2541,57,7028,116,47532,62,54560,California
Nevada,2021-07-01,121,100273,82,53662,27,44058,12,2553,51,7023,68,47600,63,54623,California
Nevada,2021-07-02,150,100423,97,53759,39,44097,14,2567,74,7043,68,47668,88,54711,California
Nevada,2021-07-03,34,100457,16,53775,11,44108,7,2574,17,7050,17,47685,24,54735,California
Nevada,2021-07-05,43,100500,26,53801,11,44119,6,2580,16,7045,27,47712,22,54757,California
Nevada,2021-07-06,146,100646,90,53891,42,44161,14,2594,53,7025,87,47799,67,54824,California
Nevada,2021-07-07,138,100784,93,53984,32,44193,13,2607,46,7001,83,47882,59,54883,California
Nevada,2021-07-08,149,100933,89,54073,45,44238,15,2622,73,7017,71,47953,87,54970,California
Nevada,2021-07-09,137,101070,78,54151,43,44281,16,2638,50,6997,86,48039,66,55036,California
Nevada,2021-07-10,40,101110,29,54180,7,44288,4,2642,20,7000,20,48059,23,55059,California
Nevada,2021-07-11,19,101129,12,54192,7,44295,0,2642,9,7000,9,48068,9,55068,California
Nevada,2021-07-12,83,101212,43,54235,34,44329,6,2648,50,7027,29,48097,56,55124,California
Nevada,2021-07-13,151,101363,113,54348,29,44358,9,2657,62,7013,85,48182,71,55195,California
Nevada,2021-07-14,152,101515,97,54445,37,44395,18,2675,60,7006,85,48267,78,55273,California
Nevada,2021-07-15,124,101639,94,54539,23,44418,7,2682,56,7006,62,48329,62,55335,California
Nevada,2021-07-16,127,101766,79,54618,44,44462,4,2686,58,7000,68,48397,62,55397,California
Nevada,2021-07-17,54,101820,40,54658,10,44472,4,2690,26,7006,28,48425,34,55431,California
Nevada,2021-07-18,31,101851,14,54672,15,44487,2,2692,18,7013,13,48438,20,55451,California
Nevada,2021-07-19,109,101960,70,54742,31,44518,8,2700,53,7023,51,48489,61,55512,California
Nevada,2021-07-20,149,102109,98,54840,43,44561,8,2708,84,7053,63,48552,93,55605,California
Nevada,2021-07-21,132,102241,93,54933,36,44597,3,2711,76,7084,48,48600,79,55684,California
Nevada,2021-07-22,193,102434,133,55066,47,44644,13,2724,106,7121,82,48682,119,55803,California
Nevada,2021-07-23,197,102631,133,55199,49,44693,15,2739,97,7135,98,48780,112,55915,California
Nevada,2021-07-24,61,102692,36,55235,21,44714,4,2743,38,7154,23,48803,42,55957,California
Nevada,2021-07-25,16,102708,8,55243,7,44721,1,2744,12,7163,4,48807,13,55970,California
Nevada,2021-07-26,129,102837,74,55317,46,44767,9,2753,77,7201,48,48855,86,56056,California
Nevada,2021-07-27,148,102985,95,55412,36,44803,17,2770,67,7209,76,48931,84,56140,California
Nevada,2021-07-28,138,103123,87,55499,45,44848,6,2776,81,7245,51,48982,87,56227,California
Nevada,2021-07-29,130,103253,87,55586,36,44884,7,2783,73,7272,53,49035,80,56307,California
Nevada,2021-07-30,179,103432,114,55700,54,44938,11,2794,121,7349,55,49090,132,56439,California
Nevada,2021-07-31,33,103465,19,55719,5,44943,9,2803,13,7350,20,49110,21,56460,California
Orange,2020-12-15,18,18,18,18,0,0,0,0,18,18,0,0,18,18,California
Orange,2020-12-16,405,423,405,423,0,0,0,0,405,423,0,0,405,423,California
Orange,2020-12-17,3769,4192,3769,4192,0,0,0,0,3768,4191,0,0,3768,4191,California
Orange,2020-12-18,5114,9306,5106,9298,8,8,0,0,5112,9302,1,1,5112,9303,California
Orange,2020-12-19,2245,11551,2238,11536,7,15,0,0,2244,11546,0,1,2244,11547,California
Orange,2020-12-20,2001,13552,1998,13534,3,18,0,0,2001,13546,1,2,2001,13548,California
Orange,2020-12-21,4291,17843,4285,17819,6,24,0,0,4291,17837,0,2,4291,17839,California
Orange,2020-12-22,3996,21839,3961,21780,35,59,0,0,3995,21832,0,2,3995,21834,California
Orange,2020-12-23,3614,25453,3243,25023,371,430,0,0,3613,25444,1,3,3613,25447,California
Orange,2020-12-24,1384,26837,1084,26107,300,730,0,0,1382,26825,1,4,1382,26829,California
Orange,2020-12-25,22,26859,17,26124,5,735,0,0,22,26847,0,4,22,26851,California
Orange,2020-12-26,1003,27862,424,26548,579,1314,0,0,1003,27850,0,4,1003,27854,California
Orange,2020-12-27,586,28448,273,26821,313,1627,0,0,586,28436,0,4,586,28440,California
Orange,2020-12-28,3644,32092,2647,29468,997,2624,0,0,3644,32080,0,4,3644,32084,California
Orange,2020-12-29,3544,35636,2515,31983,1029,3653,0,0,3543,35622,1,5,3543,35627,California
Orange,2020-12-30,5146,40782,3545,35528,1601,5254,0,0,5146,40768,0,5,5146,40773,California
Orange,2020-12-31,1524,42306,810,36338,714,5968,0,0,1521,42286,3,8,1521,42294,California
Orange,2021-01-01,789,43095,442,36780,347,6315,0,0,787,43071,2,10,787,43081,California
Orange,2021-01-02,1376,44471,846,37626,530,6845,0,0,1373,44442,2,12,1373,44454,California
Orange,2021-01-03,594,45065,327,37953,267,7112,0,0,593,45035,0,12,593,45047,California
Orange,2021-01-04,2800,47865,1580,39533,1220,8332,0,0,2801,47835,1,13,2801,47848,California
Orange,2021-01-05,3588,51453,2343,41876,1245,9577,0,0,3158,50574,422,435,3161,51009,California
Orange,2021-01-06,5087,56540,3513,45389,1574,11151,0,0,3695,52894,1375,1810,3695,54704,California
Orange,2021-01-07,9420,65960,5267,50656,4153,15304,0,0,5753,55003,3650,5460,5759,60463,California
Orange,2021-01-08,9632,75592,5431,56087,4201,19505,0,0,5725,56844,3887,9347,5728,66191,California
Orange,2021-01-09,5116,80708,1804,57891,3312,22817,0,0,3794,59321,1317,10664,3794,69985,California
Orange,2021-01-10,4295,85003,1056,58947,3239,26056,0,0,3409,61849,885,11549,3413,73398,California
Orange,2021-01-11,9603,94606,4986,63933,4617,30673,0,0,5924,64097,3680,15229,5928,79326,California
Orange,2021-01-12,9106,103712,4896,68829,4210,34883,0,0,5577,66154,3523,18752,5580,84906,California
Orange,2021-01-13,10405,114117,4970,73799,5435,40318,0,0,7169,70097,3233,21985,7176,92082,California
Orange,2021-01-14,10208,124325,3839,77638,6369,46687,0,0,8593,77084,1612,23597,8599,100681,California
Orange,2021-01-15,10407,134732,2709,80347,7698,54385,0,0,9496,85674,913,24510,9503,110184,California
Orange,2021-01-16,8873,143605,2118,82465,6755,61140,0,0,8464,93738,405,24915,8469,118653,California
Orange,2021-01-17,8296,151901,1531,83996,6765,67905,0,0,8135,101723,161,25076,8146,126799,California
Orange,2021-01-18,9822,161723,4454,88450,5368,73273,0,0,7540,106985,2281,27357,7543,134342,California
Orange,2021-01-19,7650,169373,5501,93951,2149,75422,0,0,4978,109295,2670,30027,4980,139322,California
Orange,2021-01-20,8728,178101,6121,100072,2607,78029,0,0,5639,111856,3087,33114,5648,144970,California
Orange,2021-01-21,11435,189536,5146,105218,6289,84318,0,0,10565,121567,866,33980,10577,155547,California
Orange,2021-01-22,14043,203579,5258,110476,8785,93103,0,0,13125,133791,909,34889,13133,168680,California
Orange,2021-01-23,13348,216927,6228,116704,7120,100223,0,0,12394,145249,949,35838,12407,181087,California
Orange,2021-01-24,9999,226926,4316,121020,5683,105906,0,0,9643,154545,352,36190,9648,190735,California
Orange,2021-01-25,10559,237485,5913,126933,4646,110552,0,0,7794,159588,2756,38946,7799,198534,California
Orange,2021-01-26,12046,249531,7717,134650,4329,114881,0,0,9823,167197,2217,41163,9826,208360,California
Orange,2021-01-27,13685,263216,8037,142687,5648,120529,0,0,10893,175318,2779,43942,10900,219260,California
Orange,2021-01-28,13327,276543,7276,149963,6051,126580,0,0,11383,184782,1928,45870,11392,230652,California
Orange,2021-01-29,13874,290417,8501,158464,5373,131953,0,0,10901,192736,2950,48820,10904,241556,California
Orange,2021-01-30,13269,303686,4527,162991,8742,140695,0,0,12459,204407,793,49613,12464,254020,California
Orange,2021-01-31,13922,317608,4942,167933,8980,149675,0,0,13448,217396,467,50080,13456,267476,California
Orange,2021-02-01,15150,332758,6563,174496,8587,158262,0,0,12586,227453,2536,52616,12593,280069,California
Orange,2021-02-02,15328,348086,8044,182540,7284,165546,0,0,12792,237756,2496,55112,12799,292868,California
Orange,2021-02-03,16895,364981,12513,195053,4382,169928,0,0,13865,248687,2940,58052,13871,306739,California
Orange,2021-02-04,20216,385197,13145,208198,7071,176999,0,0,15011,258545,5162,63214,15020,321759,California
Orange,2021-02-05,21091,406288,12112,220310,8979,185978,0,0,14628,266775,6410,69624,14640,336399,California
Orange,2021-02-06,16644,422932,10927,231237,5717,191695,0,0,11288,272949,5335,74959,11509,347908,California
Orange,2021-02-07,11715,434647,8206,239443,3509,195204,0,0,7672,276765,4025,78984,7841,355749,California
Orange,2021-02-08,15352,449999,8799,248242,6553,201757,0,0,9178,279802,6145,85129,9182,364931,California
Orange,2021-02-09,18087,468086,12239,260481,5848,207605,0,0,10839,283495,7163,92292,10856,375787,California
Orange,2021-02-10,21283,489369,11355,271836,9928,217533,0,0,12914,288159,8272,100564,12936,388723,California
Orange,2021-02-11,22623,511992,11712,283548,10911,228444,0,0,12374,290459,10099,110663,12399,401122,California
Orange,2021-02-12,25390,537382,12187,295735,13203,241647,0,0,14856,294879,10458,121121,14878,416000,California
Orange,2021-02-13,22419,559801,12082,307817,10337,251984,0,0,11333,295954,10916,132037,11991,427991,California
Orange,2021-02-14,16834,576635,6714,314531,10120,262104,0,0,9863,298887,6939,138976,9872,437863,California
Orange,2021-02-15,17747,594382,7589,322120,10158,272262,0,0,9203,299622,8493,147469,9228,447091,California
Orange,2021-02-16,20476,614858,9207,331327,11269,283531,0,0,11046,301344,9369,156838,11091,458182,California
Orange,2021-02-17,18446,633304,9656,340983,8790,292321,0,0,9422,301881,8953,165791,9490,467672,California
Orange,2021-02-18,15401,648705,10080,351063,5321,297642,0,0,6938,300449,8403,174194,6971,474643,California
Orange,2021-02-19,18783,667488,11217,362280,7566,305208,0,0,7122,296007,11590,185784,7148,481791,California
Orange,2021-02-20,7799,675287,5775,368055,2024,307232,0,0,3896,296066,3866,189650,3925,485716,California
Orange,2021-02-21,4869,680156,4138,372193,731,307963,0,0,992,293235,3832,193482,1001,486717,California
Orange,2021-02-22,10504,690660,8573,380766,1931,309894,0,0,4165,291148,6280,199762,4193,490910,California
Orange,2021-02-23,14381,705041,7870,388636,6511,316405,0,0,3776,284461,10508,210270,3821,494731,California
Orange,2021-02-24,22467,727508,13567,402203,8900,325305,0,0,5651,273477,16709,226979,5725,500456,California
Orange,2021-02-25,24408,751916,13183,415386,11225,336530,0,0,8500,266229,15805,242784,8557,509013,California
Orange,2021-02-26,29627,781543,14946,430332,14681,351211,0,0,11960,260781,17479,260263,12031,521044,California
Orange,2021-02-27,26893,808436,10935,441267,15953,367164,5,5,7826,249758,18919,279182,7896,528940,California
Orange,2021-02-28,20434,828870,7945,449212,12489,379653,0,5,5189,239899,15092,294274,5233,534173,California
Orange,2021-03-01,20007,848877,9164,458376,10815,390468,28,33,7794,235692,12074,306348,7867,542040,California
Orange,2021-03-02,22346,871223,10851,469227,11491,401959,4,37,9936,233373,12324,318672,10005,552045,California
Orange,2021-03-03,22118,893341,10530,479757,11581,413540,7,44,11876,235177,10145,328817,11949,563994,California
Orange,2021-03-04,24731,918072,14173,493930,10545,424085,13,57,12585,235747,12092,340909,12662,576656,California
Orange,2021-03-05,24192,942264,12780,506710,11364,435449,48,105,14469,240700,9668,350577,14621,591277,California
Orange,2021-03-06,25729,967993,14193,520903,10635,446084,901,1006,13554,243087,12114,362691,14501,605778,California
Orange,2021-03-07,16735,984728,9029,529932,6831,452915,875,1881,9606,246545,7075,369766,10533,616311,California
Orange,2021-03-08,18853,1003581,8750,538682,8648,461563,1455,3336,11844,252949,6944,376710,13348,629659,California
Orange,2021-03-09,22129,1025710,10125,548807,9338,470901,2666,6002,12963,259464,9116,385826,15631,645290,California
Orange,2021-03-10,25448,1051158,12478,561285,9440,480341,3530,9532,12776,263174,12590,398416,16300,661590,California
Orange,2021-03-11,29834,1080992,16118,577403,9357,489698,4359,13891,13726,265261,15992,414408,18079,679669,California
Orange,2021-03-12,29886,1110878,14517,591920,11441,501139,3928,17819,14915,269256,14856,429264,18851,698520,California
Orange,2021-03-13,28283,1139161,10376,602296,13901,515040,4006,21825,14228,273495,13984,443248,18223,716743,California
Orange,2021-03-14,19296,1158457,8352,610648,8375,523415,2569,24394,11956,280708,7299,450547,14512,731255,California
Orange,2021-03-15,23616,1182073,10375,621023,12468,535883,773,25167,14506,286991,9003,459550,15286,746541,California
Orange,2021-03-16,26943,1209016,11386,632409,15277,551160,280,25447,17248,294957,9588,469138,17554,764095,California
Orange,2021-03-17,27841,1236857,13823,646232,13460,564620,558,26005,19707,307182,8042,477180,20267,784362,California
Orange,2021-03-18,28385,1265242,14349,660581,13727,578347,309,26314,21819,322847,6475,483655,22140,806502,California
Orange,2021-03-19,34342,1299584,18969,679550,14913,593260,460,26774,25259,339626,8947,492602,25726,832228,California
Orange,2021-03-20,26270,1325854,13910,693460,12156,605416,204,26978,22238,358137,3948,496550,22459,854687,California
Orange,2021-03-21,18957,1344811,11002,704462,7209,612625,746,27724,15939,371855,2967,499517,16685,871372,California
Orange,2021-03-22,23184,1367995,12065,716527,10798,623423,321,28045,19330,387794,3723,503240,19662,891034,California
Orange,2021-03-23,26605,1394600,13933,730460,12025,635448,647,28692,20890,403731,5610,508850,21547,912581,California
Orange,2021-03-24,29715,1424315,16652,747112,12129,647577,934,29626,22102,419277,7491,516341,23037,935618,California
Orange,2021-03-25,32997,1457312,17559,764671,14720,662297,718,30344,24197,435519,8679,525020,24921,960539,California
Orange,2021-03-26,35443,1492755,18386,783057,16184,678481,873,31217,24617,450337,10680,535700,25498,986037,California
Orange,2021-03-27,28931,1521686,13835,796892,14774,693255,322,31539,19629,461104,9186,544886,19953,1005990,California
Orange,2021-03-28,25291,1546977,13128,810020,12095,705350,68,31607,18631,473256,6557,551443,18709,1024699,California
Orange,2021-03-29,26992,1573969,12383,822403,14040,719390,569,32176,17722,482416,9138,560581,18298,1042997,California
Orange,2021-03-30,31323,1605292,14187,836590,16496,735886,640,32816,20423,492695,10787,571368,21066,1064063,California
Orange,2021-03-31,37686,1642978,19748,856338,17209,753095,729,33545,23665,503228,13860,585228,24393,1088456,California
Orange,2021-04-01,41232,1684210,21614,877952,17654,770749,1964,35509,25877,515928,15111,600339,27811,1116267,California
Orange,2021-04-02,40639,1724849,20490,898442,18287,789036,1862,37371,21970,521234,18532,618871,23838,1140105,California
Orange,2021-04-03,30716,1755565,15928,914370,13010,802046,1778,39149,14140,520671,16470,635341,15907,1156012,California
Orange,2021-04-04,18645,1774210,10803,925173,7066,809112,776,39925,7993,518853,10581,645922,8763,1164775,California
Orange,2021-04-05,30476,1804686,14229,939402,12765,821877,3482,43407,13211,518376,17152,663074,16675,1181450,California
Orange,2021-04-06,33783,1838469,15814,955216,14505,836382,3464,46871,14153,516451,19513,682587,17588,1199038,California
Orange,2021-04-07,36673,1875142,20382,975598,11631,848013,4660,51531,16077,516662,20482,703069,20693,1219731,California
Orange,2021-04-08,39638,1914780,21912,997510,12136,860149,5590,57121,19030,520771,20459,723528,24568,1244299,California
Orange,2021-04-09,41537,1956317,24140,1021650,12077,872226,5320,62441,18090,520817,23315,746843,23361,1267660,California
Orange,2021-04-10,34962,1991279,18450,1040100,12195,884421,4317,66758,14295,518843,20557,767400,18583,1286243,California
Orange,2021-04-11,25969,2017248,14699,1054799,7965,892386,3305,70063,9900,516024,15996,783396,13177,1299420,California
Orange,2021-04-12,30964,2048212,15616,1070415,11686,904072,3662,73725,12135,513070,18725,802121,15771,1315191,California
Orange,2021-04-13,33074,2081286,18586,1089001,14418,918490,70,73795,15306,510794,17656,819777,15380,1330571,California
Orange,2021-04-14,35280,2116566,20656,1109657,14586,933076,38,73833,15268,506229,19884,839661,15319,1345890,California
Orange,2021-04-15,40999,2157565,24960,1134617,16018,949094,21,73854,18955,503308,21891,861552,18970,1364860,California
Orange,2021-04-16,42307,2199872,24852,1159469,17426,966520,29,73883,18959,499124,23186,884738,19002,1383862,California
Orange,2021-04-17,30923,2230795,17455,1176924,13461,979981,7,73890,13449,495269,17317,902055,13462,1397324,California
Orange,2021-04-18,22641,2253436,13667,1190591,8972,988953,2,73892,9015,490755,13535,915590,9021,1406345,California
Orange,2021-04-19,33177,2286613,18321,1208912,14852,1003805,4,73896,15185,488078,17873,933463,15196,1421541,California
Orange,2021-04-20,36568,2323181,19227,1228139,17335,1021140,6,73902,18008,487661,18438,951901,18021,1439562,California
Orange,2021-04-21,42867,2366048,25071,1253210,17786,1038926,10,73912,20223,485462,22441,974342,20242,1459804,California
Orange,2021-04-22,40819,2406867,21826,1275036,18982,1057908,11,73923,16852,478551,23785,998127,16874,1476678,California
Orange,2021-04-23,41616,2448483,21824,1296860,19784,1077692,8,73931,18541,474191,22919,1021046,18559,1495237,California
Orange,2021-04-24,32877,2481360,17091,1313951,15753,1093445,33,73964,13664,468806,19086,1040132,13701,1508938,California
Orange,2021-04-25,23459,2504819,13206,1327157,10238,1103683,15,73979,9971,465406,13393,1053525,9993,1518931,California
Orange,2021-04-26,29758,2534577,14761,1341918,14800,1118483,197,74176,12854,461700,16763,1070288,13057,1531988,California
Orange,2021-04-27,31959,2566536,15134,1357052,16184,1134667,641,74817,12065,454718,19696,1089984,12714,1544702,California
Orange,2021-04-28,32018,2598554,16218,1373270,14900,1149567,900,75717,12810,449390,19036,1109020,13708,1558410,California
Orange,2021-04-29,33073,2631627,18200,1391470,13887,1163454,986,76703,11717,440888,21198,1130218,12696,1571106,California
Orange,2021-04-30,30894,2662521,17769,1409239,12171,1175625,954,77657,13150,437402,17578,1147796,14092,1585198,California
Orange,2021-05-01,23566,2686087,16021,1425260,6542,1182167,1003,78660,9052,433098,14348,1162144,10044,1595242,California
Orange,2021-05-02,15604,2701691,10406,1435666,4550,1186717,648,79308,5443,429105,10079,1172223,6086,1601328,California
Orange,2021-05-03,21073,2722764,12932,1448598,7366,1194083,775,80083,6576,422076,14379,1186602,7350,1608678,California
Orange,2021-05-04,24445,2747209,14137,1462735,9380,1203463,928,81011,8345,415385,15950,1202552,9259,1617937,California
Orange,2021-05-05,25762,2772971,14629,1477364,10224,1213687,909,81920,8277,407247,17322,1219874,9184,1627121,California
Orange,2021-05-06,27267,2800238,16622,1493986,9631,1223318,1014,82934,7471,396090,19632,1239506,8475,1635596,California
Orange,2021-05-07,29757,2829995,18043,1512029,10649,1233967,1065,83999,8236,384110,21272,1260778,9292,1644888,California
Orange,2021-05-08,19410,2849405,12957,1524986,5646,1239613,807,84806,5631,376911,13627,1274405,6428,1651316,California
Orange,2021-05-09,11237,2860642,8574,1533560,2287,1241900,376,85182,2833,371772,8345,1282750,3206,1654522,California
Orange,2021-05-10,19755,2880397,12191,1545751,6773,1248673,791,85973,4361,361655,15267,1298017,5150,1659672,California
Orange,2021-05-11,23250,2903647,13231,1558982,9273,1257946,746,86719,5452,350183,17663,1315680,6191,1665863,California
Orange,2021-05-12,24341,2927988,15102,1574084,8399,1266345,840,87559,6577,339991,17606,1333286,7414,1673277,California
Orange,2021-05-13,22347,2950335,13843,1587927,7888,1274233,616,88175,8211,334813,14004,1347290,8826,1682103,California
Orange,2021-05-14,27114,2977449,17911,1605838,8349,1282582,854,89029,10527,329750,16414,1363704,11351,1693454,California
Orange,2021-05-15,20697,2998146,14891,1620729,5243,1287825,563,89592,8379,326453,12231,1375935,8934,1702388,California
Orange,2021-05-16,15692,3013838,12939,1633668,2409,1290234,344,89936,6733,324639,8886,1384821,7072,1709460,California
Orange,2021-05-17,19686,3033524,12927,1646595,6052,1296286,707,90643,6905,319545,12690,1397511,7596,1717056,California
Orange,2021-05-18,20807,3054331,12079,1658674,8048,1304334,680,91323,8019,315561,12674,1410185,8690,1725746,California
Orange,2021-05-19,22768,3077099,12985,1671659,9102,1313436,681,92004,7740,309089,14883,1425068,8411,1734157,California
Orange,2021-05-20,22844,3099943,13386,1685045,8780,1322216,678,92682,7781,302617,14932,1440000,8460,1742617,California
Orange,2021-05-21,26121,3126064,15075,1700120,10318,1332534,728,93410,8292,293955,17684,1457684,9022,1751639,California
Orange,2021-05-22,18493,3144557,12292,1712412,5651,1338185,550,93960,7001,290120,11386,1469070,7551,1759190,California
Orange,2021-05-23,10124,3154681,7002,1719414,2848,1341033,274,94234,3529,287388,6538,1475608,3806,1762996,California
Orange,2021-05-24,15768,3170449,9361,1728775,5780,1346813,627,94861,5789,283924,9875,1485483,6411,1769407,California
Orange,2021-05-25,15759,3186208,9252,1738027,5980,1352793,527,95388,5560,279934,10070,1495553,6080,1775487,California
Orange,2021-05-26,15382,3201590,8593,1746620,6284,1359077,505,95893,5616,276384,9662,1505215,6112,1781599,California
Orange,2021-05-27,14517,3216107,8713,1755333,5251,1364328,553,96446,6307,275115,8122,1513337,6853,1788452,California
Orange,2021-05-28,16950,3233057,9969,1765302,6347,1370675,634,97080,7411,273725,9428,1522765,8038,1796490,California
Orange,2021-05-29,9108,3242165,5320,1770622,3427,1374102,361,97441,4098,273240,4942,1527707,4457,1800947,California
Orange,2021-05-30,6080,3248245,3954,1774576,1846,1375948,280,97721,2183,271838,3859,1531566,2457,1803404,California
Orange,2021-05-31,1719,3249964,1065,1775641,606,1376554,48,97769,525,271243,1167,1532733,572,1803976,California
Orange,2021-06-01,13553,3263517,7855,1783496,5204,1381758,494,98263,5018,268352,8398,1541131,5507,1809483,California
Orange,2021-06-02,13189,3276706,8136,1791632,4633,1386391,420,98683,4488,264712,8542,1549673,4902,1814385,California
Orange,2021-06-03,13038,3289744,8976,1800608,3603,1389994,459,99142,4413,261029,8552,1558225,4869,1819254,California
Orange,2021-06-04,17295,3307039,12246,1812854,4466,1394460,583,99725,5266,254938,11938,1570163,5847,1825101,California
Orange,2021-06-05,13095,3320134,9860,1822714,2852,1397312,383,100108,3859,250009,9169,1579332,4240,1829341,California
Orange,2021-06-06,5415,3325549,4600,1827314,611,1397923,204,100312,1822,248472,3566,1582898,2029,1831370,California
Orange,2021-06-07,10855,3336404,7670,1834984,2713,1400636,472,100784,3334,244828,7444,1590342,3800,1835170,California
Orange,2021-06-08,12305,3348709,8823,1843807,2963,1403599,519,101303,3778,240695,8429,1598771,4296,1839466,California
Orange,2021-06-09,11872,3360581,8208,1852015,3204,1406803,460,101763,3326,236021,8455,1607226,3781,1843247,California
Orange,2021-06-10,11711,3372292,8515,1860530,2729,1409532,467,102230,3406,231656,8233,1615459,3868,1847115,California
Orange,2021-06-11,13451,3385743,9450,1869980,3503,1413035,498,102728,4356,227513,8993,1624452,4850,1851965,California
Orange,2021-06-12,9894,3395637,7548,1877528,2028,1415063,318,103046,2988,223975,6845,1631297,3307,1855272,California
Orange,2021-06-13,4090,3399727,2985,1880513,941,1416004,164,103210,1029,222144,3025,1634322,1194,1856466,California
Orange,2021-06-14,9903,3409630,7214,1887727,2224,1418228,465,103675,3258,219285,6580,1640902,3721,1860187,California
Orange,2021-06-15,10316,3419946,7416,1895143,2463,1420691,437,104112,3586,216651,6653,1647555,4019,1864206,California
Orange,2021-06-16,9661,3429607,6923,1902066,2265,1422956,473,104585,3295,214112,6303,1653858,3764,1867970,California
Orange,2021-06-17,9512,3439119,7152,1909218,1982,1424938,378,104963,3365,211769,6083,1659941,3740,1871710,California
Orange,2021-06-18,11332,3450451,8256,1917474,2573,1427511,503,105466,3908,208832,7343,1667284,4406,1876116,California
Orange,2021-06-19,6383,3456834,4736,1922210,1398,1428909,249,105715,2618,207992,3711,1670995,2871,1878987,California
Orange,2021-06-20,3091,3459925,2390,1924600,607,1429516,94,105809,1032,207072,2046,1673041,1126,1880113,California
Orange,2021-06-21,6795,3466720,4669,1929269,1674,1431190,452,106261,3640,208044,3120,1676161,4092,1884205,California
Orange,2021-06-22,7848,3474568,5792,1935061,1692,1432882,364,106625,2986,206612,4784,1680945,3352,1887557,California
Orange,2021-06-23,7521,3482089,5652,1940713,1559,1434441,310,106935,3050,205551,4417,1685362,3356,1890913,California
Orange,2021-06-24,7335,3489424,5491,1946204,1461,1435902,383,107318,3112,204865,4179,1689541,3493,1894406,California
Orange,2021-06-25,8917,3498341,6533,1952737,2000,1437902,384,107702,3430,203244,5429,1694970,3808,1898214,California
Orange,2021-06-26,6019,3504360,4603,1957340,1186,1439088,230,107932,2551,202602,3423,1698393,2781,1900995,California
Orange,2021-06-27,3470,3507830,2812,1960152,546,1439634,112,108044,1484,202238,1963,1700356,1599,1902594,California
Orange,2021-06-28,6386,3514216,5132,1965284,898,1440532,356,108400,2837,201936,3494,1703850,3192,1905786,California
Orange,2021-06-29,6395,3520611,4695,1969979,1442,1441974,258,108658,2621,201098,3718,1707568,2880,1908666,California
Orange,2021-06-30,6303,3526914,4548,1974527,1489,1443463,266,108924,2781,200702,3441,1711009,3045,1911711,California
Orange,2021-07-01,6056,3532970,4626,1979153,1178,1444641,252,109176,2773,200507,3221,1714230,3026,1914737,California
Orange,2021-07-02,7232,3540202,5389,1984542,1510,1446151,333,109509,3136,199907,4064,1718294,3464,1918201,California
Orange,2021-07-03,4095,3544297,3013,1987555,945,1447096,137,109646,1869,199721,2189,1720483,2003,1920204,California
Orange,2021-07-04,342,3544639,220,1987775,108,1447204,14,109660,145,199688,193,1720676,160,1920364,California
Orange,2021-07-05,3887,3548526,2973,1990748,777,1447981,137,109797,1841,199653,2015,1722691,1980,1922344,California
Orange,2021-07-06,6797,3555323,5032,1995780,1443,1449424,322,110119,2623,198477,4118,1726809,2942,1925286,California
Orange,2021-07-07,5701,3561024,4234,2000014,1226,1450650,241,110360,2354,197765,3305,1730114,2593,1927879,California
Orange,2021-07-08,5864,3566888,4427,2004441,1167,1451817,270,110630,2298,196812,3519,1733633,2566,1930445,California
Orange,2021-07-09,6881,3573769,5035,2009476,1491,1453308,355,110985,2795,195931,4031,1737664,3150,1933595,California
Orange,2021-07-10,4674,3578443,3510,2012986,997,1454305,167,111152,1955,195376,2673,1740337,2118,1935713,California
Orange,2021-07-11,2312,3580755,1823,2014809,450,1454755,39,111191,1132,195389,1160,1741497,1173,1936886,California
Orange,2021-07-12,6018,3586773,4551,2019360,1162,1455917,305,111496,2262,194232,3721,1745218,2564,1939450,California
Orange,2021-07-13,5553,3592326,4046,2023406,1297,1457214,210,111706,2465,193870,3039,1748257,2677,1942127,California
Orange,2021-07-14,5176,3597502,3835,2027241,1152,1458366,189,111895,2259,193440,2874,1751131,2444,1944571,California
Orange,2021-07-15,5359,3602861,4087,2031328,1075,1459441,197,112092,2416,193143,2905,1754036,2608,1947179,California
Orange,2021-07-16,6842,3609703,5055,2036383,1522,1460963,265,112357,3226,193065,3570,1757606,3492,1950671,California
Orange,2021-07-17,4617,3614320,3469,2039852,1041,1462004,107,112464,2251,193100,2321,1759927,2356,1953027,California
Orange,2021-07-18,2556,3616876,1963,2041815,531,1462535,62,112526,1172,192961,1374,1761301,1235,1954262,California
Orange,2021-07-19,6093,3622969,4642,2046457,1192,1463727,259,112785,2883,192945,3157,1764458,3141,1957403,California
Orange,2021-07-20,6145,3629114,4441,2050898,1480,1465207,224,113009,3140,193362,2946,1767404,3363,1960766,California
Orange,2021-07-21,5795,3634909,4292,2055190,1306,1466513,197,113206,3162,194139,2580,1769984,3357,1964123,California
Orange,2021-07-22,6025,3640934,4488,2059678,1327,1467840,210,113416,3249,194884,2710,1772694,3455,1967578,California
Orange,2021-07-23,7367,3648301,5373,2065051,1704,1469544,290,113706,3938,195747,3363,1776057,4226,1971804,California
Orange,2021-07-24,4778,3653079,3369,2068420,1269,1470813,140,113846,2686,196508,2066,1778123,2827,1974631,California
Orange,2021-07-25,2389,3655468,1779,2070199,576,1471389,34,113880,1763,197696,608,1778731,1796,1976427,California
Orange,2021-07-26,6064,3661532,4474,2074673,1309,1472698,281,114161,3622,199193,2401,1781132,3898,1980325,California
Orange,2021-07-27,6094,3667626,4367,2079040,1487,1474185,240,114401,3518,200416,2531,1783663,3754,1984079,California
Orange,2021-07-28,6179,3673805,4454,2083494,1425,1475610,300,114701,3569,201741,2542,1786205,3867,1987946,California
Orange,2021-07-29,5828,3679633,4330,2087824,1255,1476865,243,114944,3449,203122,2308,1788513,3689,1991635,California
Orange,2021-07-30,7285,3686918,5382,2093206,1650,1478515,253,115197,4243,204655,2964,1791477,4497,1996132,California
Orange,2021-07-31,2633,3689551,1821,2095027,715,1479230,97,115294,1473,205095,1130,1792607,1570,1997702,California
Placer,2020-12-15,30,30,30,30,0,0,0,0,30,30,0,0,30,30,California
Placer,2020-12-16,62,92,62,92,0,0,0,0,62,92,0,0,62,92,California
Placer,2020-12-17,149,241,149,241,0,0,0,0,149,241,0,0,149,241,California
Placer,2020-12-18,439,680,439,680,0,0,0,0,439,680,0,0,439,680,California
Placer,2020-12-19,256,936,256,936,0,0,0,0,256,936,0,0,256,936,California
Placer,2020-12-20,231,1167,231,1167,0,0,0,0,231,1167,0,0,231,1167,California
Placer,2020-12-21,511,1678,509,1676,2,2,0,0,511,1678,0,0,511,1678,California
Placer,2020-12-22,678,2356,672,2348,6,8,0,0,678,2356,0,0,678,2356,California
Placer,2020-12-23,761,3117,671,3019,90,98,0,0,761,3117,0,0,761,3117,California
Placer,2020-12-24,410,3527,358,3377,52,150,0,0,410,3527,0,0,410,3527,California
Placer,2020-12-25,1,3528,1,3378,0,150,0,0,1,3528,0,0,1,3528,California
Placer,2020-12-26,167,3695,121,3499,46,196,0,0,167,3695,0,0,167,3695,California
Placer,2020-12-27,183,3878,161,3660,22,218,0,0,183,3878,0,0,183,3878,California
Placer,2020-12-28,682,4560,556,4216,126,344,0,0,681,4558,1,1,681,4559,California
Placer,2020-12-29,774,5334,526,4742,248,592,0,0,773,5330,1,2,773,5332,California
Placer,2020-12-30,737,6071,462,5204,275,867,0,0,736,6066,0,2,736,6068,California
Placer,2020-12-31,552,6623,367,5571,185,1052,0,0,552,6618,0,2,552,6620,California
Placer,2021-01-01,18,6641,12,5583,6,1058,0,0,18,6636,0,2,18,6638,California
Placer,2021-01-02,190,6831,157,5740,33,1091,0,0,190,6826,0,2,190,6828,California
Placer,2021-01-03,154,6985,77,5817,77,1168,0,0,154,6980,0,2,154,6982,California
Placer,2021-01-04,634,7619,190,6007,444,1612,0,0,634,7614,0,2,634,7616,California
Placer,2021-01-05,725,8344,161,6168,564,2176,0,0,635,8161,89,91,636,8252,California
Placer,2021-01-06,768,9112,248,6416,520,2696,0,0,614,8621,154,245,614,8866,California
Placer,2021-01-07,993,10105,376,6792,617,3313,0,0,762,9153,230,475,762,9628,California
Placer,2021-01-08,1187,11292,536,7328,651,3964,0,0,785,9540,398,873,785,10413,California
Placer,2021-01-09,462,11754,325,7653,137,4101,0,0,241,9561,220,1093,241,10654,California
Placer,2021-01-10,337,12091,187,7840,150,4251,0,0,169,9562,168,1261,169,10823,California
Placer,2021-01-11,1444,13535,819,8659,625,4876,0,0,846,9811,598,1859,847,11670,California
Placer,2021-01-12,1681,15216,889,9548,792,5668,0,0,1070,10272,610,2469,1071,12741,California
Placer,2021-01-13,1657,16873,835,10383,822,6490,0,0,1230,11080,425,2894,1233,13974,California
Placer,2021-01-14,1842,18715,701,11084,1141,7631,0,0,1453,12149,386,3280,1455,15429,California
Placer,2021-01-15,1946,20661,732,11816,1214,8845,0,0,1589,13383,356,3636,1590,17019,California
Placer,2021-01-16,1480,22141,715,12531,765,9610,0,0,1356,14616,124,3760,1357,18376,California
Placer,2021-01-17,581,22722,400,12931,181,9791,0,0,439,14914,141,3901,439,18815,California
Placer,2021-01-18,977,23699,540,13471,437,10228,0,0,739,15417,237,4138,740,19555,California
Placer,2021-01-19,2640,26339,1973,15444,667,10895,0,0,2188,17154,452,4590,2189,21744,California
Placer,2021-01-20,2368,28707,1782,17226,586,11481,0,0,2021,18829,347,4937,2022,23766,California
Placer,2021-01-21,2604,31311,1154,18380,1450,12931,0,0,2198,20624,404,5341,2199,25965,California
Placer,2021-01-22,2350,33661,635,19015,1715,14646,0,0,2171,22620,177,5518,2173,28138,California
Placer,2021-01-23,1199,34860,389,19404,810,15456,0,0,1036,23495,162,5680,1037,29175,California
Placer,2021-01-24,514,35374,265,19669,249,15705,0,0,434,23849,80,5760,434,29609,California
Placer,2021-01-25,1695,37069,817,20486,878,16583,0,0,1397,24949,298,6058,1398,31007,California
Placer,2021-01-26,1873,38942,1038,21524,835,17418,0,0,1600,26276,273,6331,1600,32607,California
Placer,2021-01-27,1840,40782,1153,22677,687,18105,0,0,1590,27619,248,6579,1591,34198,California
Placer,2021-01-28,1831,42613,1131,23808,700,18805,0,0,1584,28959,244,6823,1584,35782,California
Placer,2021-01-29,1913,44526,1169,24977,744,19549,0,0,1711,30471,200,7023,1712,37494,California
Placer,2021-01-30,1715,46241,949,25926,766,20315,0,0,1594,31945,120,7143,1594,39088,California
Placer,2021-01-31,779,47020,619,26545,160,20475,0,0,705,32576,74,7217,705,39793,California
Placer,2021-02-01,2110,49130,1104,27649,1006,21481,0,0,1783,34034,325,7542,1783,41576,California
Placer,2021-02-02,2412,51542,1557,29206,855,22336,0,0,1909,35443,500,8042,1909,43485,California
Placer,2021-02-03,2938,54480,1896,31102,1042,23378,0,0,2303,37116,630,8672,2303,45788,California
Placer,2021-02-04,2751,57231,1183,32285,1568,24946,0,0,1907,38185,839,9511,1908,47696,California
Placer,2021-02-05,2760,59991,1264,33549,1496,26442,0,0,1389,38227,1347,10858,1389,49085,California
Placer,2021-02-06,1976,61967,1322,34871,654,27096,0,0,1419,39090,556,11414,1419,50504,California
Placer,2021-02-07,1167,63134,857,35728,310,27406,0,0,874,39672,292,11706,874,51378,California
Placer,2021-02-08,3280,66414,1744,37472,1536,28942,0,0,1922,40264,1331,13037,1923,53301,California
Placer,2021-02-09,3565,69979,2190,39662,1375,30317,0,0,1618,39939,1943,14980,1618,54919,California
Placer,2021-02-10,3779,73758,2213,41875,1566,31883,0,0,1704,39575,2068,17048,1704,56623,California
Placer,2021-02-11,3709,77467,1909,43784,1800,33683,0,0,1551,38985,2142,19190,1552,58175,California
Placer,2021-02-12,2881,80348,1341,45125,1540,35223,0,0,1665,39472,1179,20369,1666,59841,California
Placer,2021-02-13,2582,82930,1451,46576,1131,36354,0,0,1916,40723,665,21034,1916,61757,California
Placer,2021-02-14,1101,84031,684,47260,417,36771,0,0,750,41124,349,21383,750,62507,California
Placer,2021-02-15,2249,86280,1042,48302,1207,37978,0,0,1529,41935,720,22103,1531,64038,California
Placer,2021-02-16,3568,89848,1776,50078,1792,39770,0,0,1558,41495,1999,24102,1559,65597,California
Placer,2021-02-17,3570,93418,1973,52051,1597,41367,0,0,1515,40959,2051,26153,1515,67112,California
Placer,2021-02-18,3844,97262,2071,54122,1773,43140,0,0,1622,40373,2209,28362,1623,68735,California
Placer,2021-02-19,3656,100918,1950,56072,1706,44846,0,0,1361,39454,2282,30644,1363,70098,California
Placer,2021-02-20,2105,103023,1286,57358,819,45665,0,0,960,39281,1138,31782,965,71063,California
Placer,2021-02-21,1173,104196,771,58129,402,46067,0,0,428,38967,743,32525,429,71492,California
Placer,2021-02-22,2655,106851,1863,59992,792,46859,0,0,626,37569,2024,34549,626,72118,California
Placer,2021-02-23,2739,109590,1690,61682,1049,47908,0,0,921,36674,1816,36365,921,73039,California
Placer,2021-02-24,3454,113044,1228,62910,2226,50134,0,0,1881,36996,1561,37926,1883,74922,California
Placer,2021-02-25,3853,116897,1590,64500,2263,52397,0,0,2102,37361,1740,39666,2105,77027,California
Placer,2021-02-26,4368,121265,2535,67035,1833,54230,0,0,2495,37990,1867,41533,2496,79523,California
Placer,2021-02-27,2982,124247,1581,68616,1401,55631,0,0,1530,38075,1447,42980,1532,81055,California
Placer,2021-02-28,1620,125867,876,69492,743,56374,1,1,749,37961,864,43844,750,81805,California
Placer,2021-03-01,3311,129178,2193,71685,1118,57492,0,1,1676,38015,1622,45466,1676,83481,California
Placer,2021-03-02,2983,132161,1845,73530,1138,58630,0,1,1931,38903,1044,46510,1932,85413,California
Placer,2021-03-03,3466,135627,1504,75034,1961,60591,1,2,1884,39216,1573,48083,1886,87299,California
Placer,2021-03-04,3701,139328,1484,76518,2217,62808,0,2,1917,39363,1771,49854,1918,89217,California
Placer,2021-03-05,3004,142332,1037,77555,1947,64755,20,22,1795,39975,1203,51057,1815,91032,California
Placer,2021-03-06,2475,144807,1531,79086,845,65600,99,121,942,39493,1523,52580,1041,92073,California
Placer,2021-03-07,1380,146187,766,79852,555,66155,59,180,555,39284,821,53401,612,92685,California
Placer,2021-03-08,2926,149113,1836,81688,973,67128,117,297,1654,39789,1266,54667,1771,94456,California
Placer,2021-03-09,3178,152291,1688,83376,1402,68530,88,385,1837,40377,1337,56004,1925,96381,California
Placer,2021-03-10,3316,155607,1337,84713,1877,70407,102,487,1741,40651,1569,57573,1843,98224,California
Placer,2021-03-11,3669,159276,1662,86375,1877,72284,130,617,1762,40649,1895,59468,1893,100117,California
Placer,2021-03-12,3725,163001,1501,87876,1444,73728,780,1397,1276,40263,2441,61909,2055,102172,California
Placer,2021-03-13,2230,165231,754,88630,1352,75080,124,1521,1201,40562,1024,62933,1323,103495,California
Placer,2021-03-14,1728,166959,690,89320,885,75965,153,1674,906,40801,819,63752,1058,104553,California
Placer,2021-03-15,3250,170209,1559,90879,1561,77526,130,1804,1800,41287,1445,65197,1931,106484,California
Placer,2021-03-16,3685,173894,1995,92874,1556,79082,134,1938,2344,42439,1327,66524,2479,108963,California
Placer,2021-03-17,3525,177419,1780,94654,1641,80723,104,2042,2264,43552,1256,67780,2369,111332,California
Placer,2021-03-18,4151,181570,2357,97011,1755,82478,39,2081,2894,45235,1248,69028,2931,114263,California
Placer,2021-03-19,3498,185068,2090,99101,1141,83619,267,2348,2166,46342,1322,70350,2429,116692,California
Placer,2021-03-20,2237,187305,948,100049,1202,84821,87,2435,1344,46886,886,71236,1430,118122,California
Placer,2021-03-21,1322,188627,589,100638,723,85544,10,2445,802,47182,516,71752,812,118934,California
Placer,2021-03-22,3364,191991,2156,102794,1116,86660,92,2537,2158,48234,1199,72951,2251,121185,California
Placer,2021-03-23,3630,195621,2132,104926,1408,88068,90,2627,2578,49855,1046,73997,2667,123852,California
Placer,2021-03-24,3850,199471,2002,106928,1747,89815,101,2728,1925,49978,1905,75902,2028,125880,California
Placer,2021-03-25,3902,203373,1873,108801,1932,91747,97,2825,1688,49563,2199,78101,1784,127664,California
Placer,2021-03-26,3778,207151,1662,110463,1886,93633,230,3055,1487,49004,2275,80376,1716,129380,California
Placer,2021-03-27,1621,208772,475,110938,1126,94759,20,3075,626,48661,988,81364,645,130025,California
Placer,2021-03-28,1126,209898,536,111474,580,95339,10,3085,302,48168,806,82170,313,130338,California
Placer,2021-03-29,3569,213467,2007,113481,1525,96864,37,3122,1712,48073,1845,84015,1750,132088,California
Placer,2021-03-30,4014,217481,2117,115598,1853,98717,44,3166,2093,48301,1906,85921,2134,134222,California
Placer,2021-03-31,4162,221643,1851,117449,2232,100949,79,3245,1677,47580,2475,88396,1754,135976,California
Placer,2021-04-01,2992,224635,1440,118889,1502,102451,50,3295,1656,47960,1325,89721,1705,137681,California
Placer,2021-04-02,2853,227488,1485,120374,1301,103752,67,3362,1589,48356,1257,90978,1653,139334,California
Placer,2021-04-03,1851,229339,990,121364,731,104483,130,3492,884,48410,958,91936,1012,140346,California
Placer,2021-04-04,717,230056,366,121730,297,104780,54,3546,283,48319,427,92363,336,140682,California
Placer,2021-04-05,3034,233090,1905,123635,947,105727,182,3728,1750,48975,1276,93639,1932,142614,California
Placer,2021-04-06,4323,237413,2502,126137,1524,107251,297,4025,1504,47968,2807,96446,1800,144414,California
Placer,2021-04-07,4598,242011,2630,128767,1512,108763,456,4481,2069,47968,2522,98968,2522,146936,California
Placer,2021-04-08,4750,246761,2634,131401,1583,110346,533,5014,1573,46907,3166,102134,2105,149041,California
Placer,2021-04-09,4155,250916,2281,133682,1253,111599,621,5635,1241,45868,2903,105037,1864,150905,California
Placer,2021-04-10,2133,253049,906,134588,1040,112639,187,5822,911,45746,1219,106256,1097,152002,California
Placer,2021-04-11,1403,254452,533,135121,840,113479,30,5852,445,45266,954,107210,474,152476,California
Placer,2021-04-12,4129,258581,2658,137779,1081,114560,390,6242,2445,46425,1674,108884,2833,155309,California
Placer,2021-04-13,4409,262990,3029,140808,1379,115939,1,6243,2210,46445,2192,111076,2212,157521,California
Placer,2021-04-14,4199,267189,2584,143392,1614,117553,1,6244,1870,45998,2317,113393,1870,159391,California
Placer,2021-04-15,4523,271712,2519,145911,2003,119556,1,6245,2344,46174,2169,115562,2345,161736,California
Placer,2021-04-16,3712,275424,2197,148108,1515,121071,0,6245,1427,45323,2278,117840,1427,163163,California
Placer,2021-04-17,2650,278074,854,148962,1796,122867,0,6245,1725,46128,920,118760,1725,164888,California
Placer,2021-04-18,1283,279357,305,149267,978,123845,0,6245,439,45725,842,119602,439,165327,California
Placer,2021-04-19,2974,282331,1832,151099,1142,124987,0,6245,1142,45044,1824,121426,1143,166470,California
Placer,2021-04-20,3950,286281,2579,153678,1371,126358,0,6245,2433,45971,1506,122932,2433,168903,California
Placer,2021-04-21,3824,290105,2536,156214,1287,127645,1,6246,2461,47075,1358,124290,2462,171365,California
Placer,2021-04-22,3771,293876,2365,158579,1406,129051,0,6246,1786,46882,1979,126269,1786,173151,California
Placer,2021-04-23,3617,297493,2399,160978,1217,130268,1,6247,1400,46073,2210,128479,1401,174552,California
Placer,2021-04-24,2104,299597,1273,162251,830,131098,1,6248,1225,46431,867,129346,1225,175777,California
Placer,2021-04-25,941,300538,505,162756,436,131534,0,6248,556,46602,385,129731,556,176333,California
Placer,2021-04-26,2530,303068,1356,164112,1151,132685,23,6271,1226,46557,1294,131025,1249,177582,California
Placer,2021-04-27,2787,305855,1468,165580,1268,133953,51,6322,1570,46967,1213,132238,1623,179205,California
Placer,2021-04-28,3093,308948,1939,167519,1117,135070,37,6359,1620,47162,1463,133701,1658,180863,California
Placer,2021-04-29,3473,312421,2281,169800,1138,136208,54,6413,1446,46642,2020,135721,1500,182363,California
Placer,2021-04-30,3060,315481,1888,171688,1125,137333,47,6460,1238,46111,1816,137537,1285,183648,California
Placer,2021-05-01,1345,316826,941,172629,377,137710,27,6487,604,46006,735,138272,630,184278,California
Placer,2021-05-02,735,317561,576,173205,137,137847,22,6509,335,45964,399,138671,357,184635,California
Placer,2021-05-03,1618,319179,994,174199,556,138403,68,6577,428,45277,1184,139855,497,185132,California
Placer,2021-05-04,2396,321575,1381,175580,853,139256,162,6739,889,44827,1501,141356,1051,186183,California
Placer,2021-05-05,3774,325349,2570,178150,1101,140357,103,6842,988,43144,2774,144130,1091,187274,California
Placer,2021-05-06,3124,328473,1920,180070,1126,141483,78,6920,815,41756,2281,146411,893,188167,California
Placer,2021-05-07,2859,331332,1940,182010,824,142307,95,7015,798,40613,2047,148458,904,189071,California
Placer,2021-05-08,1413,332745,743,182753,628,142935,42,7057,413,40071,997,149455,455,189526,California
Placer,2021-05-09,458,333203,224,182977,213,143148,21,7078,215,40064,243,149698,236,189762,California
Placer,2021-05-10,1945,335148,1041,184018,808,143956,96,7174,432,39085,1507,151205,528,190290,California
Placer,2021-05-11,3078,338226,2228,186246,737,144693,113,7287,657,37453,2410,153615,778,191068,California
Placer,2021-05-12,2914,341140,2008,188254,849,145542,57,7344,693,35993,2213,155828,753,191821,California
Placer,2021-05-13,2881,344021,1866,190120,968,146510,47,7391,1021,35205,1857,157685,1069,192890,California
Placer,2021-05-14,2870,346891,1886,192006,846,147356,138,7529,1394,35272,1459,159144,1526,194416,California
Placer,2021-05-15,2119,349010,1373,193379,722,148078,24,7553,945,35075,1166,160310,969,195385,California
Placer,2021-05-16,1196,350206,531,193910,646,148724,19,7572,341,34583,852,161162,360,195745,California
Placer,2021-05-17,2364,352570,1577,195487,713,149437,74,7646,1015,34329,1344,162506,1090,196835,California
Placer,2021-05-18,2518,355088,1696,197183,744,150181,78,7724,1131,34158,1383,163889,1212,198047,California
Placer,2021-05-19,2548,357636,1611,198794,891,151072,46,7770,875,33413,1667,165556,922,198969,California
Placer,2021-05-20,2565,360201,1662,200456,853,151925,50,7820,874,32656,1683,167239,926,199895,California
Placer,2021-05-21,2465,362666,1537,201993,779,152704,149,7969,1055,32455,1402,168641,1201,201096,California
Placer,2021-05-22,1615,364281,1069,203062,504,153208,42,8011,764,32415,846,169487,806,201902,California
Placer,2021-05-23,700,364981,361,203423,322,153530,17,8028,282,32297,418,169905,300,202202,California
Placer,2021-05-24,1521,366502,773,204196,614,154144,134,8162,447,31808,1070,170975,581,202783,California
Placer,2021-05-25,1790,368292,946,205142,748,154892,96,8258,639,31399,1144,172119,735,203518,California
Placer,2021-05-26,1601,369893,917,206059,643,155535,41,8299,620,31087,975,173094,663,204181,California
Placer,2021-05-27,1445,371338,714,206773,687,156222,44,8343,663,31019,776,173870,708,204889,California
Placer,2021-05-28,1709,373047,865,207638,746,156968,98,8441,727,30869,975,174845,825,205714,California
Placer,2021-05-29,752,373799,408,208046,313,157281,31,8472,379,30908,370,175215,409,206123,California
Placer,2021-05-30,340,374139,232,208278,94,157375,14,8486,209,31001,130,175345,223,206346,California
Placer,2021-05-31,147,374286,69,208347,61,157436,17,8503,29,30930,116,175461,45,206391,California
Placer,2021-06-01,1692,375978,892,209239,728,158164,72,8575,591,30498,1095,176556,663,207054,California
Placer,2021-06-02,1515,377493,761,210000,686,158850,68,8643,483,30018,1031,177587,551,207605,California
Placer,2021-06-03,1712,379205,1045,211045,608,159458,59,8702,434,29237,1273,178860,492,208097,California
Placer,2021-06-04,1885,381090,1340,212385,491,159949,54,8756,457,28329,1417,180277,509,208606,California
Placer,2021-06-05,1099,382189,779,213164,279,160228,41,8797,271,27818,823,181100,312,208918,California
Placer,2021-06-06,500,382689,361,213525,122,160350,17,8814,123,27582,376,181476,140,209058,California
Placer,2021-06-07,1056,383745,722,214247,262,160612,72,8886,225,27050,827,182303,295,209353,California
Placer,2021-06-08,1749,385494,1333,215580,367,160979,49,8935,439,26230,1307,183610,487,209840,California
Placer,2021-06-09,1185,386679,858,216438,275,161254,52,8987,267,25636,914,184524,320,210160,California
Placer,2021-06-10,1257,387936,867,217305,314,161568,76,9063,310,25077,943,185467,384,210544,California
Placer,2021-06-11,1491,389427,1073,218378,359,161927,59,9122,341,24331,1145,186612,399,210943,California
Placer,2021-06-12,1026,390453,762,219140,238,162165,26,9148,220,23775,802,187414,246,211189,California
Placer,2021-06-13,396,390849,306,219446,79,162244,11,9159,92,23575,303,187717,103,211292,California
Placer,2021-06-14,774,391623,528,219974,201,162445,45,9204,225,23299,545,188262,269,211561,California
Placer,2021-06-15,1306,392929,868,220842,375,162820,63,9267,430,22919,872,189134,492,212053,California
Placer,2021-06-16,1040,393969,754,221596,231,163051,55,9322,332,22598,707,189841,386,212439,California
Placer,2021-06-17,878,394847,608,222204,234,163285,36,9358,269,22298,605,190446,305,212744,California
Placer,2021-06-18,1161,396008,765,222969,305,163590,91,9449,382,21993,778,191224,473,213217,California
Placer,2021-06-19,615,396623,444,223413,137,163727,34,9483,238,21890,374,191598,271,213488,California
Placer,2021-06-20,284,396907,233,223646,43,163770,8,9491,108,21831,174,191772,115,213603,California
Placer,2021-06-21,488,397395,285,223931,165,163935,38,9529,230,21841,258,192030,268,213871,California
Placer,2021-06-22,888,398283,626,224557,208,164143,54,9583,268,21550,613,192643,322,214193,California
Placer,2021-06-23,844,399127,611,225168,186,164329,47,9630,387,21528,456,193099,434,214627,California
Placer,2021-06-24,831,399958,526,225694,259,164588,46,9676,320,21386,508,193607,366,214993,California
Placer,2021-06-25,945,400903,670,226364,222,164810,53,9729,395,21289,544,194151,447,215440,California
Placer,2021-06-26,541,401444,383,226747,125,164935,33,9762,234,21251,305,194456,267,215707,California
Placer,2021-06-27,249,401693,183,226930,55,164990,11,9773,119,21251,129,194585,129,215836,California
Placer,2021-06-28,489,402182,359,227289,85,165075,45,9818,210,21228,278,194863,255,216091,California
Placer,2021-06-29,829,403011,583,227872,199,165274,47,9865,320,21087,508,195371,367,216458,California
Placer,2021-06-30,597,403608,415,228287,141,165415,41,9906,259,21050,337,195708,300,216758,California
Placer,2021-07-01,561,404169,381,228668,142,165557,38,9944,229,20988,329,196037,267,217025,California
Placer,2021-07-02,688,404857,505,229173,156,165713,27,9971,302,20936,381,196418,329,217354,California
Placer,2021-07-03,303,405160,209,229382,81,165794,13,9984,145,20939,154,196572,157,217511,California
Placer,2021-07-04,17,405177,3,229385,14,165808,0,9984,7,20936,10,196582,7,217518,California
Placer,2021-07-05,393,405570,260,229645,99,165907,34,10018,164,20909,225,196807,198,217716,California
Placer,2021-07-06,843,406413,637,230282,162,166069,44,10062,302,20717,538,197345,346,218062,California
Placer,2021-07-07,566,406979,429,230711,107,166176,30,10092,232,20646,333,197678,262,218324,California
Placer,2021-07-08,530,407509,361,231072,130,166306,39,10131,230,20618,297,197975,269,218593,California
Placer,2021-07-09,693,408202,486,231558,137,166443,70,10201,300,20596,391,198366,369,218962,California
Placer,2021-07-10,360,408562,263,231821,91,166534,6,10207,129,20501,230,198596,135,219097,California
Placer,2021-07-11,227,408789,176,231997,37,166571,14,10221,103,20494,124,198720,117,219214,California
Placer,2021-07-12,498,409287,379,232376,85,166656,34,10255,242,20516,254,198974,276,219490,California
Placer,2021-07-13,499,409786,378,232754,105,166761,16,10271,235,20504,263,199237,251,219741,California
Placer,2021-07-14,571,410357,434,233188,115,166876,22,10293,221,20401,345,199582,242,219983,California
Placer,2021-07-15,467,410824,338,233526,108,166984,21,10314,209,20374,257,199839,230,220213,California
Placer,2021-07-16,759,411583,555,234081,172,167156,32,10346,352,20355,403,200242,384,220597,California
Placer,2021-07-17,347,411930,252,234333,78,167234,17,10363,138,20301,209,200451,155,220752,California
Placer,2021-07-18,197,412127,146,234479,46,167280,5,10368,92,20296,102,200553,97,220849,California
Placer,2021-07-19,537,412664,389,234868,123,167403,25,10393,290,20368,243,200796,315,221164,California
Placer,2021-07-20,750,413414,545,235413,173,167576,32,10425,385,20423,361,201157,416,221580,California
Placer,2021-07-21,635,414049,449,235862,152,167728,34,10459,317,20461,312,201469,350,221930,California
Placer,2021-07-22,683,414732,446,236308,199,167927,38,10497,384,20589,292,201761,420,222350,California
Placer,2021-07-23,838,415570,597,236905,199,168126,42,10539,460,20719,372,202133,502,222852,California
Placer,2021-07-24,390,415960,280,237185,93,168219,17,10556,229,20805,160,202293,246,223098,California
Placer,2021-07-25,219,416179,148,237333,65,168284,6,10562,159,20913,57,202350,165,223263,California
Placer,2021-07-26,611,416790,430,237763,153,168437,28,10590,392,21117,216,202566,420,223683,California
Placer,2021-07-27,799,417589,582,238345,175,168612,42,10632,447,21257,348,202914,488,224171,California
Placer,2021-07-28,690,418279,514,238859,132,168744,44,10676,415,21448,268,203182,459,224630,California
Placer,2021-07-29,702,418981,498,239357,165,168909,39,10715,446,21680,253,203435,485,225115,California
Placer,2021-07-30,853,419834,625,239982,192,169101,36,10751,531,21932,314,203749,566,225681,California
Placer,2021-07-31,263,420097,153,240135,85,169186,25,10776,156,22009,104,203853,181,225862,California
Plumas,2020-12-18,3,3,3,3,0,0,0,0,3,3,0,0,3,3,California
Plumas,2020-12-19,1,4,1,4,0,0,0,0,1,4,0,0,1,4,California
Plumas,2020-12-21,45,49,45,49,0,0,0,0,45,49,0,0,45,49,California
Plumas,2020-12-22,95,144,95,144,0,0,0,0,95,144,0,0,95,144,California
Plumas,2020-12-23,50,194,50,194,0,0,0,0,50,194,0,0,50,194,California
Plumas,2020-12-24,7,201,7,201,0,0,0,0,7,201,0,0,7,201,California
Plumas,2020-12-28,9,210,1,202,8,8,0,0,9,210,0,0,9,210,California
Plumas,2020-12-29,33,243,23,225,10,18,0,0,33,243,0,0,33,243,California
Plumas,2020-12-30,24,267,2,227,22,40,0,0,24,267,0,0,24,267,California
Plumas,2020-12-31,4,271,1,228,3,43,0,0,4,271,0,0,4,271,California
Plumas,2021-01-01,1,272,0,228,1,44,0,0,1,272,0,0,1,272,California
Plumas,2021-01-02,1,273,0,228,1,45,0,0,1,273,0,0,1,273,California
Plumas,2021-01-04,10,283,3,231,7,52,0,0,10,283,0,0,10,283,California
Plumas,2021-01-05,23,306,1,232,22,74,0,0,23,306,0,0,23,306,California
Plumas,2021-01-06,118,424,4,236,114,188,0,0,118,424,0,0,118,424,California
Plumas,2021-01-07,52,476,2,238,50,238,0,0,51,474,1,1,51,475,California
Plumas,2021-01-08,11,487,4,242,7,245,0,0,8,479,3,4,8,483,California
Plumas,2021-01-09,1,488,1,243,0,245,0,0,0,478,1,5,0,483,California
Plumas,2021-01-11,59,547,50,293,9,254,0,0,12,443,47,52,12,495,California
Plumas,2021-01-12,157,704,88,381,69,323,0,0,71,428,86,138,71,566,California
Plumas,2021-01-13,56,760,51,432,5,328,0,0,9,390,47,185,9,575,California
Plumas,2021-01-14,99,859,15,447,84,412,0,0,93,477,6,191,93,668,California
Plumas,2021-01-15,61,920,7,454,54,466,0,0,59,534,2,193,59,727,California
Plumas,2021-01-16,57,977,1,455,56,522,0,0,57,591,0,193,57,784,California
Plumas,2021-01-18,3,980,2,457,1,523,0,0,3,594,0,193,3,787,California
Plumas,2021-01-19,38,1018,6,463,32,555,0,0,33,622,5,198,33,820,California
Plumas,2021-01-20,140,1158,4,467,136,691,0,0,136,754,4,202,136,956,California
Plumas,2021-01-21,113,1271,2,469,111,802,0,0,113,867,0,202,113,1069,California
Plumas,2021-01-22,4,1275,1,470,3,805,0,0,4,871,0,202,4,1073,California
Plumas,2021-01-23,97,1372,2,472,95,900,0,0,97,968,0,202,97,1170,California
Plumas,2021-01-24,1,1373,1,473,0,900,0,0,1,969,0,202,1,1171,California
Plumas,2021-01-25,10,1383,7,480,3,903,0,0,8,975,2,204,8,1179,California
Plumas,2021-01-26,62,1445,2,482,60,963,0,0,54,1021,8,212,54,1233,California
Plumas,2021-01-27,27,1472,21,503,6,969,0,0,7,1008,20,232,7,1240,California
Plumas,2021-01-28,27,1499,0,503,27,996,0,0,25,1031,2,234,25,1265,California
Plumas,2021-01-29,9,1508,3,506,6,1002,0,0,8,1038,1,235,8,1273,California
Plumas,2021-01-30,9,1517,3,509,6,1008,0,0,8,1045,1,236,8,1281,California
Plumas,2021-01-31,3,1520,3,512,0,1008,0,0,3,1048,0,236,3,1284,California
Plumas,2021-02-01,25,1545,4,516,21,1029,0,0,16,1055,9,245,16,1300,California
Plumas,2021-02-02,26,1571,4,520,22,1051,0,0,6,1041,20,265,6,1306,California
Plumas,2021-02-03,124,1695,6,526,118,1169,0,0,14,946,109,374,14,1320,California
Plumas,2021-02-04,104,1799,10,536,94,1263,0,0,25,892,79,453,25,1345,California
Plumas,2021-02-05,29,1828,13,549,16,1279,0,0,14,891,15,468,14,1359,California
Plumas,2021-02-06,8,1836,1,550,7,1286,0,0,8,899,0,468,8,1367,California
Plumas,2021-02-08,15,1851,5,555,10,1296,0,0,2,888,13,481,2,1369,California
Plumas,2021-02-09,173,2024,4,559,169,1465,0,0,111,937,62,543,111,1480,California
Plumas,2021-02-10,112,2136,8,567,104,1569,0,0,105,1036,7,550,106,1586,California
Plumas,2021-02-11,341,2477,5,572,336,1905,0,0,281,1257,60,610,281,1867,California
Plumas,2021-02-12,125,2602,4,576,121,2026,0,0,120,1372,5,615,120,1987,California
Plumas,2021-02-13,77,2679,8,584,69,2095,0,0,17,1329,60,675,17,2004,California
Plumas,2021-02-14,9,2688,5,589,4,2099,0,0,9,1338,0,675,9,2013,California
Plumas,2021-02-15,28,2716,5,594,23,2122,0,0,25,1360,3,678,25,2038,California
Plumas,2021-02-16,81,2797,5,599,76,2198,0,0,16,1311,65,743,16,2054,California
Plumas,2021-02-17,153,2950,5,604,148,2346,0,0,12,1182,141,884,12,2066,California
Plumas,2021-02-18,131,3081,6,610,125,2471,0,0,21,1094,110,994,22,2088,California
Plumas,2021-02-19,44,3125,7,617,37,2508,0,0,8,1066,36,1030,8,2096,California
Plumas,2021-02-20,107,3232,7,624,100,2608,0,0,13,985,94,1124,13,2109,California
Plumas,2021-02-21,5,3237,4,628,1,2609,0,0,2,984,3,1127,2,2111,California
Plumas,2021-02-22,9,3246,3,631,6,2615,0,0,1,977,8,1135,1,2112,California
Plumas,2021-02-23,25,3271,3,634,22,2637,0,0,17,986,8,1143,17,2129,California
Plumas,2021-02-24,486,3757,8,642,478,3115,0,0,473,1446,13,1156,473,2602,California
Plumas,2021-02-25,242,3999,12,654,230,3345,0,0,176,1556,66,1222,176,2778,California
Plumas,2021-02-26,266,4265,9,663,257,3602,0,0,256,1803,10,1232,257,3035,California
Plumas,2021-02-27,44,4309,5,668,39,3641,0,0,36,1831,8,1240,36,3071,California
Plumas,2021-02-28,6,4315,0,668,6,3647,0,0,4,1833,2,1242,4,3075,California
Plumas,2021-03-01,31,4346,8,676,22,3669,1,1,15,1835,14,1256,16,3091,California
Plumas,2021-03-02,14,4360,1,677,13,3682,0,1,8,1838,5,1261,8,3099,California
Plumas,2021-03-03,181,4541,10,687,171,3853,0,1,165,1987,16,1277,165,3264,California
Plumas,2021-03-04,253,4794,8,695,245,4098,0,1,231,2196,22,1299,231,3495,California
Plumas,2021-03-05,396,5190,5,700,386,4484,5,6,384,2573,12,1311,389,3884,California
Plumas,2021-03-06,23,5213,4,704,11,4495,8,14,4,2566,19,1330,12,3896,California
Plumas,2021-03-07,13,5226,2,706,2,4497,9,23,4,2569,9,1339,12,3908,California
Plumas,2021-03-08,35,5261,4,710,6,4503,25,48,6,2573,28,1367,32,3940,California
Plumas,2021-03-09,134,5395,4,714,115,4618,15,63,18,2490,116,1483,33,3973,California
Plumas,2021-03-10,303,5698,4,718,285,4903,14,77,111,2425,190,1673,125,4098,California
Plumas,2021-03-11,190,5888,10,728,175,5078,5,82,154,2548,36,1709,159,4257,California
Plumas,2021-03-12,597,6485,7,735,303,5381,287,369,24,2286,573,2282,311,4568,California
Plumas,2021-03-13,27,6512,5,740,11,5392,11,380,6,2282,21,2303,17,4585,California
Plumas,2021-03-14,13,6525,3,743,5,5397,5,385,1,2277,11,2314,6,4591,California
Plumas,2021-03-15,37,6562,3,746,26,5423,8,393,8,2264,29,2343,16,4607,California
Plumas,2021-03-16,63,6625,3,749,59,5482,1,394,49,2302,12,2355,50,4657,California
Plumas,2021-03-17,72,6697,7,756,64,5546,1,395,56,2344,15,2370,57,4714,California
Plumas,2021-03-18,60,6757,6,762,38,5584,16,411,12,2324,48,2418,28,4742,California
Plumas,2021-03-19,161,6918,4,766,155,5739,2,413,153,2474,6,2424,156,4898,California
Plumas,2021-03-20,716,7634,5,771,710,6449,1,414,693,3147,21,2445,694,5592,California
Plumas,2021-03-21,2,7636,1,772,1,6450,0,414,1,3148,0,2445,1,5593,California
Plumas,2021-03-22,205,7841,2,774,203,6653,0,414,197,3338,7,2452,197,5790,California
Plumas,2021-03-23,28,7869,2,776,26,6679,0,414,14,3338,14,2466,14,5804,California
Plumas,2021-03-24,697,8566,5,781,691,7370,1,415,231,3106,465,2931,233,6037,California
Plumas,2021-03-25,322,8888,8,789,312,7682,2,417,177,3138,145,3076,177,6214,California
Plumas,2021-03-26,314,9202,8,797,305,7987,1,418,46,2918,267,3343,47,6261,California
Plumas,2021-03-27,14,9216,1,798,12,7999,1,419,4,2913,10,3353,5,6266,California
Plumas,2021-03-28,9,9225,3,801,5,8004,1,420,3,2911,6,3359,4,6270,California
Plumas,2021-03-29,10,9235,3,804,6,8010,1,421,3,2908,7,3366,4,6274,California
Plumas,2021-03-30,183,9418,4,808,175,8185,4,425,26,2781,157,3523,30,6304,California
Plumas,2021-03-31,299,9717,3,811,294,8479,2,427,275,3034,24,3547,277,6581,California
Plumas,2021-04-01,317,10034,14,825,300,8779,3,430,67,2856,247,3794,69,6650,California
Plumas,2021-04-02,377,10411,3,828,370,9149,4,434,29,2553,336,4130,33,6683,California
Plumas,2021-04-03,14,10425,3,831,5,9154,6,440,1,2547,13,4143,7,6690,California
Plumas,2021-04-04,3,10428,1,832,1,9155,1,441,0,2545,3,4146,1,6691,California
Plumas,2021-04-05,17,10445,6,838,9,9164,2,443,4,2540,11,4157,6,6697,California
Plumas,2021-04-06,138,10583,7,845,103,9267,28,471,17,2464,120,4277,44,6741,California
Plumas,2021-04-07,296,10879,9,854,102,9369,185,656,29,2411,267,4544,214,6955,California
Plumas,2021-04-08,158,11037,4,858,134,9503,20,676,40,2352,118,4662,59,7014,California
Plumas,2021-04-09,50,11087,9,867,24,9527,17,693,18,2354,32,4694,34,7048,California
Plumas,2021-04-10,22,11109,1,868,4,9531,17,710,3,2355,19,4713,20,7068,California
Plumas,2021-04-11,5,11114,3,871,1,9532,1,711,3,2358,1,4714,4,7072,California
Plumas,2021-04-12,13,11127,4,875,6,9538,3,714,6,2361,6,4720,9,7081,California
Plumas,2021-04-13,224,11351,5,880,219,9757,0,714,157,2451,67,4787,157,7238,California
Plumas,2021-04-14,108,11459,6,886,102,9859,0,714,54,2452,53,4840,54,7292,California
Plumas,2021-04-15,55,11514,4,890,51,9910,0,714,34,2466,20,4860,34,7326,California
Plumas,2021-04-16,144,11658,3,893,141,10051,0,714,4,2330,140,5000,4,7330,California
Plumas,2021-04-17,687,12345,2,895,685,10736,0,714,19,1685,664,5664,19,7349,California
Plumas,2021-04-18,3,12348,3,898,0,10736,0,714,0,1682,3,5667,0,7349,California
Plumas,2021-04-19,39,12387,2,900,37,10773,0,714,5,1653,34,5701,5,7354,California
Plumas,2021-04-20,47,12434,5,905,42,10815,0,714,30,1667,16,5717,30,7384,California
Plumas,2021-04-21,342,12776,6,911,335,11150,1,715,15,1355,327,6044,15,7399,California
Plumas,2021-04-22,283,13059,7,918,276,11426,0,715,132,1336,151,6195,132,7531,California
Plumas,2021-04-23,73,13132,3,921,70,11496,0,715,16,1295,57,6252,16,7547,California
Plumas,2021-04-24,171,13303,4,925,167,11663,0,715,145,1415,25,6277,145,7692,California
Plumas,2021-04-26,31,13334,3,928,28,11691,0,715,8,1401,22,6299,8,7700,California
Plumas,2021-04-27,109,13443,4,932,105,11796,0,715,70,1432,39,6338,70,7770,California
Plumas,2021-04-28,287,13730,5,937,282,12078,0,715,35,1217,250,6588,35,7805,California
Plumas,2021-04-29,178,13908,71,1008,107,12185,0,715,123,1285,55,6643,123,7928,California
Plumas,2021-04-30,23,13931,12,1020,11,12196,0,715,7,1276,16,6659,7,7935,California
Plumas,2021-05-01,9,13940,1,1021,7,12203,1,716,1,1272,6,6665,2,7937,California
Plumas,2021-05-02,4,13944,4,1025,0,12203,0,716,2,1272,2,6667,2,7939,California
Plumas,2021-05-03,19,13963,5,1030,7,12210,7,723,5,1272,12,6679,12,7951,California
Plumas,2021-05-04,34,13997,5,1035,21,12231,8,731,18,1283,15,6694,26,7977,California
Plumas,2021-05-05,53,14050,3,1038,49,12280,1,732,26,1284,26,6720,27,8004,California
Plumas,2021-05-06,69,14119,2,1040,62,12342,5,737,20,1260,49,6769,25,8029,California
Plumas,2021-05-07,23,14142,6,1046,16,12358,1,738,8,1254,15,6784,9,8038,California
Plumas,2021-05-08,7,14149,0,1046,4,12362,3,741,4,1258,3,6787,7,8045,California
Plumas,2021-05-09,1,14150,0,1046,0,12362,1,742,0,1258,1,6788,1,8046,California
Plumas,2021-05-10,50,14200,0,1046,28,12390,22,764,24,1278,26,6814,46,8092,California
Plumas,2021-05-11,182,14382,2,1048,161,12551,19,783,15,1146,166,6980,34,8126,California
Plumas,2021-05-12,101,14483,1,1049,92,12643,8,791,37,1128,63,7043,45,8171,California
Plumas,2021-05-13,43,14526,3,1052,38,12681,2,793,14,1115,29,7072,16,8187,California
Plumas,2021-05-14,21,14547,3,1055,13,12694,5,798,10,1119,11,7083,15,8202,California
Plumas,2021-05-15,12,14559,4,1059,5,12699,3,801,4,1118,8,7091,7,8209,California
Plumas,2021-05-16,1,14560,1,1060,0,12699,0,801,1,1119,0,7091,1,8210,California
Plumas,2021-05-17,15,14575,0,1060,6,12705,9,810,5,1123,10,7101,14,8224,California
Plumas,2021-05-18,49,14624,8,1068,40,12745,1,811,27,1129,22,7123,28,8252,California
Plumas,2021-05-19,52,14676,4,1072,30,12775,18,829,12,1120,39,7162,30,8282,California
Plumas,2021-05-20,194,14870,138,1210,45,12820,11,840,80,1099,112,7274,91,8373,California
Plumas,2021-05-21,30,14900,9,1219,14,12834,7,847,14,1104,16,7290,21,8394,California
Plumas,2021-05-22,137,15037,1,1220,136,12970,0,847,7,983,128,7418,7,8401,California
Plumas,2021-05-23,2,15039,2,1222,0,12970,0,847,0,981,2,7420,0,8401,California
Plumas,2021-05-24,49,15088,35,1257,13,12983,1,848,40,1014,8,7428,41,8442,California
Plumas,2021-05-25,84,15172,3,1260,80,13063,1,849,18,967,66,7494,19,8461,California
Plumas,2021-05-26,41,15213,6,1266,27,13090,8,857,17,969,23,7517,25,8486,California
Plumas,2021-05-27,100,15313,25,1291,62,13152,13,870,41,965,58,7575,54,8540,California
Plumas,2021-05-28,44,15357,16,1307,26,13178,2,872,24,972,19,7594,26,8566,California
Plumas,2021-05-29,8,15365,0,1307,8,13186,0,872,6,977,2,7596,7,8573,California
Plumas,2021-05-30,1,15366,0,1307,1,13187,0,872,0,977,0,7596,0,8573,California
Plumas,2021-05-31,7,15373,0,1307,4,13191,3,875,0,975,5,7601,3,8576,California
Plumas,2021-06-01,34,15407,8,1315,20,13211,6,881,9,966,25,7626,16,8592,California
Plumas,2021-06-02,66,15473,5,1320,38,13249,23,904,12,947,54,7680,35,8627,California
Plumas,2021-06-03,67,15540,17,1337,40,13289,10,914,28,946,39,7719,38,8665,California
Plumas,2021-06-04,15,15555,3,1340,11,13300,1,915,8,950,5,7724,9,8674,California
Plumas,2021-06-05,7,15562,3,1343,4,13304,0,915,2,947,5,7729,2,8676,California
Plumas,2021-06-06,3,15565,1,1344,2,13306,0,915,0,944,3,7732,0,8676,California
Plumas,2021-06-07,37,15602,5,1349,24,13330,8,923,8,931,29,7761,16,8692,California
Plumas,2021-06-08,31,15633,9,1358,20,13350,2,925,8,918,23,7784,10,8702,California
Plumas,2021-06-09,43,15676,6,1364,34,13384,3,928,10,898,33,7817,13,8715,California
Plumas,2021-06-10,39,15715,15,1379,20,13404,4,932,14,893,23,7840,18,8733,California
Plumas,2021-06-11,25,15740,13,1392,9,13413,3,935,7,885,18,7858,10,8743,California
Plumas,2021-06-12,11,15751,3,1395,7,13420,1,936,6,887,5,7863,7,8750,California
Plumas,2021-06-13,3,15754,1,1396,2,13422,0,936,3,890,0,7863,3,8753,California
Plumas,2021-06-14,97,15851,88,1484,6,13428,3,939,12,820,85,7948,15,8768,California
Plumas,2021-06-15,30,15881,7,1491,21,13449,2,941,9,810,21,7969,11,8779,California
Plumas,2021-06-16,34,15915,11,1502,13,13462,10,951,9,804,25,7994,19,8798,California
Plumas,2021-06-17,50,15965,31,1533,15,13477,4,955,11,781,38,8032,15,8813,California
Plumas,2021-06-18,39,16004,17,1550,14,13491,8,963,13,775,26,8058,20,8833,California
Plumas,2021-06-19,9,16013,2,1552,7,13498,0,963,2,770,7,8065,2,8835,California
Plumas,2021-06-20,1,16014,1,1553,0,13498,0,963,1,771,0,8065,1,8836,California
Plumas,2021-06-21,10,16024,5,1558,4,13502,1,964,6,774,4,8069,7,8843,California
Plumas,2021-06-22,30,16054,11,1569,17,13519,2,966,10,766,20,8089,12,8855,California
Plumas,2021-06-23,29,16083,15,1584,10,13529,4,970,15,772,13,8102,19,8874,California
Plumas,2021-06-24,31,16114,20,1604,8,13537,3,973,15,774,15,8117,17,8891,California
Plumas,2021-06-25,22,16136,9,1613,11,13548,2,975,8,772,12,8129,10,8901,California
Plumas,2021-06-26,13,16149,4,1617,8,13556,1,976,3,766,10,8139,4,8905,California
Plumas,2021-06-28,11,16160,5,1622,2,13558,4,980,2,763,9,8148,6,8911,California
Plumas,2021-06-29,24,16184,16,1638,7,13565,1,981,11,762,13,8161,12,8923,California
Plumas,2021-06-30,23,16207,9,1647,10,13575,4,985,9,761,14,8175,13,8936,California
Plumas,2021-07-01,45,16252,30,1677,11,13586,4,989,23,766,22,8197,27,8963,California
Plumas,2021-07-02,18,16270,13,1690,4,13590,1,990,4,757,13,8210,4,8967,California
Plumas,2021-07-03,1,16271,0,1690,1,13591,0,990,1,758,0,8210,1,8968,California
Plumas,2021-07-06,32,16303,17,1707,12,13603,3,993,10,748,22,8232,12,8980,California
Plumas,2021-07-07,22,16325,13,1720,8,13611,1,994,10,747,12,8244,11,8991,California
Plumas,2021-07-08,31,16356,8,1728,13,13624,10,1004,13,752,18,8262,23,9014,California
Plumas,2021-07-09,15,16371,10,1738,2,13626,3,1007,7,754,8,8270,10,9024,California
Plumas,2021-07-10,9,16380,1,1739,7,13633,1,1008,2,750,7,8277,3,9027,California
Plumas,2021-07-11,3,16383,1,1740,2,13635,0,1008,2,751,1,8278,2,9029,California
Plumas,2021-07-12,8,16391,5,1745,3,13638,0,1008,4,751,4,8282,4,9033,California
Plumas,2021-07-13,21,16412,12,1757,7,13645,2,1010,11,754,10,8292,13,9046,California
Plumas,2021-07-14,30,16442,16,1773,11,13656,3,1013,14,756,15,8307,17,9063,California
Plumas,2021-07-15,37,16479,26,1799,10,13666,1,1014,21,763,16,8323,23,9086,California
Plumas,2021-07-16,29,16508,13,1812,14,13680,2,1016,12,760,17,8340,14,9100,California
Plumas,2021-07-17,7,16515,4,1816,3,13683,0,1016,2,757,5,8345,2,9102,California
Plumas,2021-07-19,6,16521,3,1819,3,13686,0,1016,2,755,4,8349,2,9104,California
Plumas,2021-07-20,36,16557,20,1839,10,13696,6,1022,9,743,27,8376,15,9119,California
Plumas,2021-07-21,20,16577,13,1852,1,13697,6,1028,12,753,8,8384,18,9137,California
Plumas,2021-07-22,37,16614,26,1878,8,13705,3,1031,13,745,24,8408,16,9153,California
Plumas,2021-07-23,13,16627,8,1886,5,13710,0,1031,7,746,6,8414,7,9160,California
Plumas,2021-07-24,3,16630,0,1886,3,13713,0,1031,2,747,1,8415,2,9162,California
Plumas,2021-07-25,1,16631,1,1887,0,13713,0,1031,1,748,0,8415,1,9163,California
Plumas,2021-07-26,7,16638,5,1892,0,13713,2,1033,5,753,2,8417,7,9170,California
Plumas,2021-07-27,19,16657,13,1905,5,13718,1,1034,10,755,9,8426,11,9181,California
Plumas,2021-07-28,18,16675,8,1913,8,13726,2,1036,7,753,11,8437,9,9190,California
Plumas,2021-07-29,27,16702,14,1927,9,13735,4,1040,14,758,13,8450,18,9208,California
Plumas,2021-07-30,30,16732,19,1946,4,13739,7,1047,17,770,11,8461,23,9231,California
Riverside,2020-12-15,7,7,7,7,0,0,0,0,7,7,0,0,7,7,California
Riverside,2020-12-16,97,104,97,104,0,0,0,0,97,104,0,0,97,104,California
Riverside,2020-12-17,851,955,851,955,0,0,0,0,851,955,0,0,851,955,California
Riverside,2020-12-18,1803,2758,1802,2757,1,1,0,0,1803,2758,0,0,1803,2758,California
Riverside,2020-12-19,1068,3826,1065,3822,3,4,0,0,1066,3823,1,1,1066,3824,California
Riverside,2020-12-20,1119,4945,1118,4940,1,5,0,0,1119,4942,0,1,1119,4943,California
Riverside,2020-12-21,2355,7300,2354,7294,1,6,0,0,2355,7297,0,1,2355,7298,California
Riverside,2020-12-22,2339,9639,2290,9584,49,55,0,0,2339,9636,0,1,2339,9637,California
Riverside,2020-12-23,2187,11826,1823,11407,364,419,0,0,2188,11824,0,1,2188,11825,California
Riverside,2020-12-24,860,12686,652,12059,208,627,0,0,860,12684,0,1,860,12685,California
Riverside,2020-12-25,42,12728,18,12077,24,651,0,0,41,12725,0,1,41,12726,California
Riverside,2020-12-26,500,13228,278,12355,222,873,0,0,500,13225,0,1,500,13226,California
Riverside,2020-12-27,398,13626,268,12623,130,1003,0,0,397,13621,1,2,397,13623,California
Riverside,2020-12-28,1738,15364,1208,13831,530,1533,0,0,1738,15359,0,2,1738,15361,California
Riverside,2020-12-29,1845,17209,1041,14872,804,2337,0,0,1845,17204,0,2,1845,17206,California
Riverside,2020-12-30,2705,19914,1752,16624,953,3290,0,0,2704,19907,1,3,2704,19910,California
Riverside,2020-12-31,1089,21003,426,17050,663,3953,0,0,1090,20996,1,4,1090,21000,California
Riverside,2021-01-01,147,21150,62,17112,85,4038,0,0,147,21143,0,4,147,21147,California
Riverside,2021-01-02,928,22078,721,17833,207,4245,0,0,928,22071,0,4,928,22075,California
Riverside,2021-01-03,368,22446,309,18142,59,4304,0,0,367,22438,0,4,367,22442,California
Riverside,2021-01-04,1337,23783,826,18968,511,4815,0,0,1335,23772,1,5,1335,23777,California
Riverside,2021-01-05,2088,25871,1422,20390,666,5481,0,0,1964,25618,118,123,1964,25741,California
Riverside,2021-01-06,2631,28502,1172,21562,1459,6940,0,0,2283,27560,341,464,2283,28024,California
Riverside,2021-01-07,2954,31456,1909,23471,1045,7985,0,0,1823,28264,1122,1586,1826,29850,California
Riverside,2021-01-08,4215,35671,3021,26492,1194,9179,0,0,2323,28701,1887,3473,2324,32174,California
Riverside,2021-01-09,2170,37841,888,27380,1282,10461,0,0,1788,30109,380,3853,1788,33962,California
Riverside,2021-01-10,1704,39545,754,28134,950,11411,0,0,1085,30575,619,4472,1085,35047,California
Riverside,2021-01-11,4693,44238,3210,31344,1483,12894,0,0,2873,31630,1819,6291,2874,37921,California
Riverside,2021-01-12,3586,47824,2827,34171,759,13653,0,0,1847,31750,1734,8025,1854,39775,California
Riverside,2021-01-13,4635,52459,3033,37204,1602,15255,0,0,2987,33093,1644,9669,2987,42762,California
Riverside,2021-01-14,5845,58304,2072,39276,3773,19028,0,0,5227,37706,616,10285,5229,47991,California
Riverside,2021-01-15,6281,64585,2069,41345,4212,23240,0,0,5945,43318,334,10619,5946,53937,California
Riverside,2021-01-16,3749,68334,1050,42395,2699,25939,0,0,3479,46528,270,10889,3480,57417,California
Riverside,2021-01-17,3672,72006,615,43010,3057,28996,0,0,3462,49782,208,11097,3462,60879,California
Riverside,2021-01-18,3916,75922,2145,45155,1771,30767,0,0,2851,51570,1064,12161,2852,63731,California
Riverside,2021-01-19,7591,83513,2719,47874,4872,35639,0,0,6425,56837,1163,13324,6430,70161,California
Riverside,2021-01-20,8577,92090,3323,51197,5254,40893,0,0,6858,61996,1705,15029,6864,77025,California
Riverside,2021-01-21,8598,100688,3581,54778,5017,45910,0,0,7886,69171,712,15741,7887,84912,California
Riverside,2021-01-22,9041,109729,3071,57849,5970,51880,0,0,8558,77251,480,16221,8560,93472,California
Riverside,2021-01-23,6123,115852,2395,60244,3728,55608,0,0,5297,81725,825,17046,5299,98771,California
Riverside,2021-01-24,3139,118991,1452,61696,1687,57295,0,0,2909,84408,227,17273,2910,101681,California
Riverside,2021-01-25,8092,127083,4622,66318,3470,60765,0,0,6898,90117,1191,18464,6900,108581,California
Riverside,2021-01-26,9301,136384,5757,72075,3544,64309,0,0,7737,96294,1561,20025,7738,116319,California
Riverside,2021-01-27,11189,147573,6457,78532,4732,69041,0,0,9521,104155,1663,21688,9524,125843,California
Riverside,2021-01-28,11787,159360,6841,85373,4946,73987,0,0,10576,113531,1203,22891,10579,136422,California
Riverside,2021-01-29,12112,171472,7308,92681,4804,78791,0,0,10696,122841,1392,24283,10702,147124,California
Riverside,2021-01-30,9145,180617,4534,97215,4611,83402,0,0,8618,130939,523,24806,8621,155745,California
Riverside,2021-01-31,5345,185962,4364,101579,981,84383,0,0,5196,135994,146,24952,5201,160946,California
Riverside,2021-02-01,11572,197534,7190,108769,4382,88765,0,0,9523,143480,2041,26993,9527,170473,California
Riverside,2021-02-02,9906,207440,5051,113820,4855,93620,0,0,8332,150259,1560,28553,8339,178812,California
Riverside,2021-02-03,12635,220075,5367,119187,7268,100888,0,0,10112,157864,2513,31066,10118,188930,California
Riverside,2021-02-04,13842,233917,6068,125255,7774,108662,0,0,11605,167257,2227,33293,11620,200550,California
Riverside,2021-02-05,14733,248650,5520,130775,9213,117875,0,0,11463,175469,3261,36554,11473,212023,California
Riverside,2021-02-06,7404,256054,4290,135065,3114,120989,0,0,5717,179514,1676,38230,5721,217744,California
Riverside,2021-02-07,2246,258300,823,135888,1423,122412,0,0,1897,181071,347,38577,1904,219648,California
Riverside,2021-02-08,12706,271006,5630,141518,7076,129488,0,0,10265,188929,2422,40999,10280,229928,California
Riverside,2021-02-09,9979,280985,4688,146206,5291,134779,0,0,7899,194782,2067,43066,7920,237848,California
Riverside,2021-02-10,12508,293493,7200,153406,5308,140087,0,0,9147,200602,3348,46414,9168,247016,California
Riverside,2021-02-11,17045,310538,9158,162564,7887,147974,0,0,12323,208265,4697,51111,12360,259376,California
Riverside,2021-02-12,18124,328662,10910,173474,7214,155188,0,0,12968,216155,5107,56218,12997,272373,California
Riverside,2021-02-13,6523,335185,2214,175688,4309,159497,0,0,3170,216017,3339,59557,3201,275574,California
Riverside,2021-02-14,5081,340266,1199,176887,3882,163379,0,0,2291,215539,2784,62341,2306,277880,California
Riverside,2021-02-15,10082,350348,5109,181996,4973,168352,0,0,5586,216670,4476,66817,5607,283487,California
Riverside,2021-02-16,16491,366839,10290,192286,6201,174553,0,0,9454,219131,7020,73837,9481,292968,California
Riverside,2021-02-17,15474,382313,8473,200759,7001,181554,0,0,7652,219032,7806,81643,7707,300675,California
Riverside,2021-02-18,15920,398233,9125,209884,6795,188349,0,0,8164,219511,7731,89374,8210,308885,California
Riverside,2021-02-19,15798,414031,8442,218326,7356,195705,0,0,7446,218664,8320,97694,7473,316358,California
Riverside,2021-02-20,8628,422659,4649,222975,3979,199684,0,0,2281,214635,6321,104015,2292,318650,California
Riverside,2021-02-21,4657,427316,4095,227070,562,200246,0,0,1291,212599,3341,107356,1305,319955,California
Riverside,2021-02-22,13165,440481,8288,235358,4877,205123,0,0,5178,209833,7956,115312,5190,325145,California
Riverside,2021-02-23,12109,452590,8248,243606,3861,208984,0,0,5855,209503,6217,121529,5887,331032,California
Riverside,2021-02-24,15771,468361,8643,252249,7128,216112,0,0,6610,207066,9107,130636,6670,337702,California
Riverside,2021-02-25,18384,486745,7911,260160,10473,226585,0,0,8422,205635,9924,140560,8493,346195,California
Riverside,2021-02-26,19782,506527,7181,267341,12601,239186,0,0,9825,205648,9884,150444,9897,356092,California
Riverside,2021-02-27,12856,519383,5943,273284,6913,246099,0,0,6094,205083,6718,157162,6153,362245,California
Riverside,2021-02-28,5249,524632,3474,276758,1775,247874,0,0,2577,205045,2647,159809,2609,364854,California
Riverside,2021-03-01,14918,539550,6368,283126,8544,256418,6,6,8771,207784,6093,165902,8832,373686,California
Riverside,2021-03-02,16131,555681,7931,291057,8198,264616,2,8,9377,210508,6715,172617,9439,383125,California
Riverside,2021-03-03,17705,573386,8790,299847,8914,273530,1,9,7687,208404,9960,182577,7856,390981,California
Riverside,2021-03-04,19321,592707,7726,307573,11591,285121,4,13,9155,207655,10114,192691,9365,400346,California
Riverside,2021-03-05,19371,612078,7820,315393,11505,296626,46,59,9517,207749,9799,202490,9893,410239,California
Riverside,2021-03-06,9802,621880,5205,320598,4115,300741,482,541,4841,208171,4945,207435,5367,415606,California
Riverside,2021-03-07,4510,626390,2842,323440,1205,301946,463,1004,2074,208319,2424,209859,2572,418178,California
Riverside,2021-03-08,12248,638638,4868,328308,6946,308892,434,1438,5465,207540,6760,216619,5981,424159,California
Riverside,2021-03-09,15070,653708,7029,335337,7521,316413,520,1958,5946,205062,9096,225715,6618,430777,California
Riverside,2021-03-10,16270,669978,8701,344038,6618,323031,951,2909,6310,202600,9913,235628,7451,438228,California
Riverside,2021-03-11,19659,689637,9623,353661,8154,331185,1882,4791,7657,200409,11956,247584,9765,447993,California
Riverside,2021-03-12,21412,711049,7984,361645,8656,339841,4772,9563,7055,198250,14309,261893,12150,460143,California
Riverside,2021-03-13,8710,719759,2584,364229,4869,344710,1257,10820,4420,199770,4260,266153,5780,465923,California
Riverside,2021-03-14,4876,724635,1674,365903,1834,346544,1368,12188,2124,200535,2736,268889,3501,469424,California
Riverside,2021-03-15,18889,743524,7943,373846,9274,355818,1672,13860,9169,201823,9669,278558,10957,480381,California
Riverside,2021-03-16,21174,764698,10305,384151,10050,365868,819,14679,11362,204353,9768,288326,12298,492679,California
Riverside,2021-03-17,21702,786400,11118,395269,9514,375382,1070,15749,12898,209639,8744,297070,14030,506709,California
Riverside,2021-03-18,23208,809608,12016,407285,9509,384891,1683,17432,12617,213426,10528,307598,14315,521024,California
Riverside,2021-03-19,24512,834120,12850,420135,10680,395571,982,18414,14119,218570,10323,317921,15467,536491,California
Riverside,2021-03-20,11058,845178,6983,427118,2862,398433,1213,19627,6958,222714,4057,321978,8201,544692,California
Riverside,2021-03-21,3953,849131,3040,430158,633,399066,280,19907,2600,224270,1327,323305,2883,547575,California
Riverside,2021-03-22,16838,865969,10055,440213,6230,405296,553,20460,10540,229127,6235,329540,11092,558667,California
Riverside,2021-03-23,18868,884837,10667,450880,7775,413071,426,20886,11894,234567,6907,336447,12347,571014,California
Riverside,2021-03-24,19017,903854,10584,461464,8313,421384,120,21006,12832,241425,6125,342572,12983,583997,California
Riverside,2021-03-25,21428,925282,11821,473285,9425,430809,182,21188,14158,248601,7183,349755,14359,598356,California
Riverside,2021-03-26,24441,949723,12079,485364,12202,443011,160,21348,14950,254343,9380,359135,15122,613478,California
Riverside,2021-03-27,9521,959244,4991,490355,3475,446486,1055,22403,4853,255625,4632,363767,5914,619392,California
Riverside,2021-03-28,4877,964121,3190,493545,1590,448076,97,22500,2854,256571,2009,365776,2955,622347,California
Riverside,2021-03-29,17881,982002,8537,502082,9215,457291,129,22629,10870,260638,6959,372735,11026,633373,California
Riverside,2021-03-30,18546,1000548,9658,511740,8675,465966,213,22842,11690,265739,6807,379542,11908,645281,California
Riverside,2021-03-31,18405,1018953,8544,520284,9529,475495,332,23174,11372,270482,6976,386518,11719,657000,California
Riverside,2021-04-01,25814,1044767,12596,532880,12415,487910,803,23977,16502,278575,9214,395732,17307,674307,California
Riverside,2021-04-02,26419,1071186,14179,547059,11252,499162,988,24965,16450,286335,9899,405631,17659,691966,California
Riverside,2021-04-03,9493,1080679,6006,553065,2862,502024,625,25590,6083,289655,3386,409017,6706,698672,California
Riverside,2021-04-04,3461,1084140,2081,555146,1113,503137,267,25857,1730,289937,1716,410733,1998,700670,California
Riverside,2021-04-05,18700,1102840,9523,564669,7277,510414,1900,27757,9994,293177,8661,419394,11901,712571,California
Riverside,2021-04-06,24020,1126860,12478,577147,9363,519777,2179,29936,13344,298069,10620,430014,15512,728083,California
Riverside,2021-04-07,25156,1152016,13519,590666,9081,528858,2556,32492,13936,303394,11161,441175,16486,744569,California
Riverside,2021-04-08,27726,1179742,15265,605931,9407,538265,3054,35546,16849,312488,10798,451973,19892,764461,California
Riverside,2021-04-09,26670,1206412,15620,621551,8515,546780,2535,38081,16200,320845,10408,462381,18765,783226,California
Riverside,2021-04-10,12232,1218644,6803,628354,4006,550786,1423,39504,5367,320809,6818,469199,6782,790008,California
Riverside,2021-04-11,4723,1223367,2805,631159,1281,552067,637,40141,2215,321173,2493,471692,2857,792865,California
Riverside,2021-04-12,20395,1243762,9062,640221,8651,560718,2682,42823,10150,323813,10198,481890,12838,805703,California
Riverside,2021-04-13,20316,1264078,11358,651579,8930,569648,28,42851,11593,326765,8678,490568,11630,817333,California
Riverside,2021-04-14,22564,1286642,12404,663983,10145,579793,15,42866,11050,326414,11439,502007,11088,828421,California
Riverside,2021-04-15,22371,1309013,12645,676628,9718,589511,8,42874,11751,327644,10543,512550,11773,840194,California
Riverside,2021-04-16,25523,1334536,14695,691323,10821,600332,7,42881,11782,325774,13674,526224,11804,851998,California
Riverside,2021-04-17,10016,1344552,6631,697954,3385,603717,0,42881,4992,325783,4994,531218,5003,857001,California
Riverside,2021-04-18,4247,1348799,3147,701101,1093,604810,7,42888,1949,325470,2280,533498,1967,858968,California
Riverside,2021-04-19,19763,1368562,11720,712821,8040,612850,3,42891,7039,319858,12669,546167,7057,866025,California
Riverside,2021-04-20,19729,1388291,10617,723438,9103,621953,9,42900,8023,316246,11651,557818,8039,874064,California
Riverside,2021-04-21,21042,1409333,12433,735871,8598,630551,11,42911,8420,312151,12540,570358,8445,882509,California
Riverside,2021-04-22,24153,1433486,14311,750182,9837,640388,5,42916,9028,306146,15049,585407,9044,891553,California
Riverside,2021-04-23,24239,1457725,14388,764570,9836,650224,15,42931,9489,300994,14680,600087,9528,901081,California
Riverside,2021-04-24,10674,1468399,7405,771975,3260,653484,9,42940,4878,300132,5751,605838,4889,905970,California
Riverside,2021-04-25,4287,1472686,2876,774851,1404,654888,7,42947,2214,300301,2054,607892,2223,908193,California
Riverside,2021-04-26,17649,1490335,11076,785927,6514,661402,59,43006,6014,294805,11586,619478,6090,914283,California
Riverside,2021-04-27,18813,1509148,10813,796740,7792,669194,208,43214,6571,289405,12190,631668,6790,921073,California
Riverside,2021-04-28,17135,1526283,9338,806078,7528,676722,269,43483,5837,284296,11225,642893,6116,927189,California
Riverside,2021-04-29,19475,1545758,12014,818092,7104,683826,357,43840,5665,276596,13726,656619,6026,933215,California
Riverside,2021-04-30,20745,1566503,12031,830123,8318,692144,396,44236,6798,269911,13879,670498,7194,940409,California
Riverside,2021-05-01,6989,1573492,4981,835104,1822,693966,186,44422,2398,267936,4557,675055,2582,942991,California
Riverside,2021-05-02,3381,1576873,2267,837371,901,694867,213,44635,1106,267009,2255,677310,1328,944319,California
Riverside,2021-05-03,18351,1595224,11302,848673,6549,701416,500,45135,4262,257762,14010,691320,4763,949082,California
Riverside,2021-05-04,17947,1613171,11471,860144,6007,707423,469,45604,5068,250516,12797,704117,5551,954633,California
Riverside,2021-05-05,16584,1629755,9557,869701,6652,714075,375,45979,4789,243974,11731,715848,5189,959822,California
Riverside,2021-05-06,18588,1648343,10586,880287,7583,721658,419,46398,4767,235472,13730,729578,5228,965050,California
Riverside,2021-05-07,21048,1669391,12036,892323,8561,730219,451,46849,5621,226212,15335,744913,6075,971125,California
Riverside,2021-05-08,7168,1676559,4756,897079,2145,732364,267,47116,2674,224702,4459,749372,2949,974074,California
Riverside,2021-05-09,2501,1679060,1698,898777,644,733008,159,47275,925,224227,1567,750939,1092,975166,California
Riverside,2021-05-10,10356,1689416,5336,904113,4618,737626,402,47677,2935,220205,7363,758302,3341,978507,California
Riverside,2021-05-11,14512,1703928,8871,912984,5113,742739,528,48205,4053,214437,10367,768669,4599,983106,California
Riverside,2021-05-12,13179,1717107,6765,919749,6076,748815,338,48543,3957,209567,9169,777838,4299,987405,California
Riverside,2021-05-13,15407,1732514,9435,929184,5688,754503,284,48827,5479,205472,9871,787709,5776,993181,California
Riverside,2021-05-14,18543,1751057,11767,940951,5981,760484,795,49622,7226,202249,11242,798951,8019,1001200,California
Riverside,2021-05-15,10039,1761096,7239,948190,2397,762881,403,50025,5176,203006,4824,803775,5581,1006781,California
Riverside,2021-05-16,3729,1764825,2770,950960,842,763723,117,50142,1859,203128,1853,805628,1975,1008756,California
Riverside,2021-05-17,11921,1776746,7651,958611,3915,767638,355,50497,5151,201903,6736,812364,5511,1014267,California
Riverside,2021-05-18,15322,1792068,9527,968138,5438,773076,357,50854,6195,199381,9077,821441,6555,1020822,California
Riverside,2021-05-19,12301,1804369,7772,975910,4283,777359,246,51100,5917,199217,6329,827770,6165,1026987,California
Riverside,2021-05-20,12088,1816457,7575,983485,4253,781612,260,51360,5354,198150,6684,834454,5617,1032604,California
Riverside,2021-05-21,14581,1831038,8981,992466,5272,786884,328,51688,6093,196161,8414,842868,6425,1039029,California
Riverside,2021-05-22,7291,1838329,4960,997426,2130,789014,201,51889,3902,196923,3343,846211,4105,1043134,California
Riverside,2021-05-23,2746,1841075,1861,999287,808,789822,77,51966,1301,196871,1430,847641,1378,1044512,California
Riverside,2021-05-24,8987,1850062,5860,1005147,2814,792636,313,52279,3993,196218,4961,852602,4308,1048820,California
Riverside,2021-05-25,9792,1859854,5811,1010958,3702,796338,279,52558,3897,194541,5855,858457,4178,1052998,California
Riverside,2021-05-26,8969,1868823,5564,1016522,3077,799415,328,52886,3909,193783,5005,863462,4247,1057245,California
Riverside,2021-05-27,8597,1877420,5152,1021674,3207,802622,238,53124,3882,193244,4665,868127,4126,1061371,California
Riverside,2021-05-28,10860,1888280,6558,1028232,3986,806608,316,53440,4979,192732,5817,873944,5305,1066676,California
Riverside,2021-05-29,5052,1893332,3459,1031691,1465,808073,128,53568,2830,193496,2197,876141,2961,1069637,California
Riverside,2021-05-30,1994,1895326,1430,1033121,493,808566,71,53639,1025,193631,962,877103,1097,1070734,California
Riverside,2021-05-31,896,1896222,505,1033626,357,808923,34,53673,340,193453,552,877655,374,1071108,California
Riverside,2021-06-01,9253,1905475,5708,1039334,3304,812227,241,53914,3468,191432,5730,883385,3709,1074817,California
Riverside,2021-06-02,7177,1912652,4383,1043717,2514,814741,280,54194,2759,190103,4371,887756,3042,1077859,California
Riverside,2021-06-03,8019,1920671,5328,1049045,2419,817160,272,54466,2728,187857,5244,893000,2998,1080857,California
Riverside,2021-06-04,10837,1931508,7708,1056753,2869,820029,260,54726,3730,184797,7053,900053,3993,1084850,California
Riverside,2021-06-05,7036,1938544,5189,1061942,1290,821319,557,55283,2199,182744,4814,904867,2761,1087611,California
Riverside,2021-06-06,2230,1940774,1891,1063833,288,821607,51,55334,693,181962,1528,906395,746,1088357,California
Riverside,2021-06-07,7019,1947793,5313,1069146,1474,823081,232,55566,2299,179807,4687,911082,2532,1090889,California
Riverside,2021-06-08,9161,1956954,6626,1075772,2256,825337,279,55845,2993,176971,6112,917194,3276,1094165,California
Riverside,2021-06-09,7825,1964779,5679,1081451,1847,827184,299,56144,2405,174304,5370,922564,2703,1096868,California
Riverside,2021-06-10,7658,1972437,5370,1086821,2049,829233,239,56383,2368,171657,5260,927824,2613,1099481,California
Riverside,2021-06-11,9096,1981533,6195,1093016,2603,831836,298,56681,3148,169213,5891,933715,3447,1102928,California
Riverside,2021-06-12,5389,1986922,3986,1097002,1277,833113,126,56807,1673,167335,3684,937399,1806,1104734,California
Riverside,2021-06-13,1809,1988731,1342,1098344,422,833535,45,56852,499,166581,1297,938696,543,1105277,California
Riverside,2021-06-14,6444,1995175,4620,1102964,1516,835051,308,57160,2121,164716,4291,942987,2426,1107703,California
Riverside,2021-06-15,7154,2002329,4868,1107832,1972,837023,314,57474,2672,163276,4432,947419,2992,1110695,California
Riverside,2021-06-16,6895,2009224,4751,1112583,1829,838852,315,57789,2447,161634,4404,951823,2762,1113457,California
Riverside,2021-06-17,6456,2015680,4515,1117098,1696,840548,245,58034,2408,160278,4014,955837,2658,1116115,California
Riverside,2021-06-18,8259,2023939,5949,1123047,2027,842575,283,58317,3375,159103,4836,960673,3661,1119776,California
Riverside,2021-06-19,4314,2028253,3303,1126350,858,843433,153,58470,1803,158577,2488,963161,1962,1121738,California
Riverside,2021-06-20,1522,2029775,1154,1127504,330,843763,38,58508,587,158277,926,964087,626,1122364,California
Riverside,2021-06-21,4322,2034097,2855,1130359,1187,844950,280,58788,2236,158725,2068,966155,2516,1124880,California
Riverside,2021-06-22,6392,2040489,4500,1134859,1641,846591,251,59039,2754,158129,3599,969754,3003,1127883,California
Riverside,2021-06-23,5591,2046080,3966,1138825,1368,847959,257,59296,2597,158024,2961,972715,2856,1130739,California
Riverside,2021-06-24,5504,2051584,3747,1142572,1511,849470,246,59542,2393,157589,3075,975790,2640,1133379,California
Riverside,2021-06-25,6888,2058472,4937,1147509,1669,851139,282,59824,2985,156991,3869,979659,3271,1136650,California
Riverside,2021-06-26,3845,2062317,2961,1150470,758,851897,126,59950,1774,156841,2050,981709,1900,1138550,California
Riverside,2021-06-27,1504,2063821,1211,1151681,248,852145,45,59995,693,156779,800,982509,738,1139288,California
Riverside,2021-06-28,4316,2068137,3361,1155042,728,852873,227,60222,2026,156775,2259,984768,2255,1141543,California
Riverside,2021-06-29,5676,2073813,4207,1159249,1296,854169,173,60395,2599,156508,3041,987809,2774,1144317,California
Riverside,2021-06-30,5000,2078813,3684,1162933,1144,855313,172,60567,2427,156604,2502,990311,2598,1146915,California
Riverside,2021-07-01,4760,2083573,3306,1166239,1147,856460,307,60874,2224,156638,2505,992816,2539,1149454,California
Riverside,2021-07-02,5923,2089496,4432,1170671,1292,857752,199,61073,2782,156520,3099,995915,2981,1152435,California
Riverside,2021-07-03,2883,2092379,2155,1172826,648,858400,80,61153,1418,156584,1435,997350,1499,1153934,California
Riverside,2021-07-04,244,2092623,140,1172966,95,858495,9,61162,97,156546,144,997494,106,1154040,California
Riverside,2021-07-05,2597,2095220,2027,1174993,509,859004,61,61223,1263,156546,1324,998818,1324,1155364,California
Riverside,2021-07-06,5547,2100767,4091,1179084,1229,860233,227,61450,2261,155793,3242,1002060,2489,1157853,California
Riverside,2021-07-07,4580,2105347,3337,1182421,1044,861277,199,61649,2026,155504,2518,1004578,2229,1160082,California
Riverside,2021-07-08,4281,2109628,3048,1185469,1017,862294,216,61865,2014,155479,2251,1006829,2226,1162308,California
Riverside,2021-07-09,5547,2115175,4138,1189607,1159,863453,250,62115,2459,155131,3050,1009879,2702,1165010,California
Riverside,2021-07-10,3080,2118255,2317,1191924,682,864135,81,62196,1541,155238,1515,1011394,1622,1166632,California
Riverside,2021-07-11,1168,2119423,902,1192826,232,864367,34,62230,607,155325,554,1011948,641,1167273,California
Riverside,2021-07-12,3898,2123321,3031,1195857,712,865079,155,62385,1786,155174,2088,1014036,1937,1169210,California
Riverside,2021-07-13,4801,2128122,3581,1199438,1082,866161,138,62523,2367,155277,2404,1016440,2507,1171717,California
Riverside,2021-07-14,4673,2132795,3439,1202877,1106,867267,128,62651,2233,155220,2417,1018857,2360,1174077,California
Riverside,2021-07-15,4578,2137373,3331,1206208,1064,868331,183,62834,2229,155326,2309,1021166,2415,1176492,California
Riverside,2021-07-16,5826,2143199,4401,1210609,1255,869586,170,63004,2943,155598,2843,1024009,3115,1179607,California
Riverside,2021-07-17,3616,2146815,2778,1213387,762,870348,76,63080,1994,156069,1602,1025611,2073,1181680,California
Riverside,2021-07-18,1503,2148318,1152,1214539,292,870640,59,63139,789,156214,704,1026315,849,1182529,California
Riverside,2021-07-19,4307,2152625,3369,1217908,812,871452,126,63265,2274,156608,2008,1028323,2402,1184931,California
Riverside,2021-07-20,5310,2157935,3801,1221709,1270,872722,239,63504,2725,157023,2548,1030871,2963,1187894,California
Riverside,2021-07-21,4995,2162930,3641,1225350,1161,873883,193,63697,2565,157379,2407,1033278,2763,1190657,California
Riverside,2021-07-22,4940,2167870,3547,1228897,1269,875152,124,63821,2705,158010,2199,1035477,2830,1193487,California
Riverside,2021-07-23,6682,2174552,5054,1233951,1471,876623,157,63978,3918,159371,2718,1038195,4079,1197566,California
Riverside,2021-07-24,3827,2178379,2932,1236883,820,877443,75,64053,2238,160112,1575,1039770,2316,1199882,California
Riverside,2021-07-25,1634,2180013,1277,1238160,348,877791,9,64062,1262,161024,362,1040132,1274,1201156,California
Riverside,2021-07-26,4808,2184821,3595,1241755,1095,878886,118,64180,3169,162713,1599,1041731,3288,1204444,California
Riverside,2021-07-27,5673,2190494,4294,1246049,1207,880093,172,64352,3392,164042,2239,1043970,3568,1208012,California
Riverside,2021-07-28,5544,2196038,4062,1250111,1297,881390,185,64537,3396,165504,2117,1046087,3579,1211591,California
Riverside,2021-07-29,5375,2201413,4009,1254120,1246,882636,120,64657,3388,167078,1940,1048027,3514,1215105,California
Riverside,2021-07-30,6469,2207882,4963,1259083,1376,884012,130,64787,3918,168624,2506,1050533,4052,1219157,California
Riverside,2021-07-31,2060,2209942,1476,1260559,491,884503,93,64880,1239,169153,801,1051334,1330,1220487,California
Sacramento,2020-12-15,314,314,314,314,0,0,0,0,314,314,0,0,314,314,California
Sacramento,2020-12-16,682,996,682,996,0,0,0,0,682,996,0,0,682,996,California
Sacramento,2020-12-17,721,1717,721,1717,0,0,0,0,721,1717,0,0,721,1717,California
Sacramento,2020-12-18,1122,2839,1121,2838,1,1,0,0,1122,2839,0,0,1122,2839,California
Sacramento,2020-12-19,622,3461,622,3460,0,1,0,0,622,3461,0,0,622,3461,California
Sacramento,2020-12-20,639,4100,639,4099,0,1,0,0,639,4100,0,0,639,4100,California
Sacramento,2020-12-21,1671,5771,1671,5770,0,1,0,0,1672,5772,0,0,1672,5772,California
Sacramento,2020-12-22,2120,7891,2079,7849,41,42,0,0,2120,7892,0,0,2120,7892,California
Sacramento,2020-12-23,2256,10147,2080,9929,176,218,0,0,2256,10148,0,0,2256,10148,California
Sacramento,2020-12-24,1048,11195,829,10758,219,437,0,0,1048,11196,0,0,1048,11196,California
Sacramento,2020-12-25,5,11200,4,10762,1,438,0,0,5,11201,0,0,5,11201,California
Sacramento,2020-12-26,506,11706,287,11049,219,657,0,0,506,11707,0,0,506,11707,California
Sacramento,2020-12-27,356,12062,249,11298,107,764,0,0,356,12063,0,0,356,12063,California
Sacramento,2020-12-28,1915,13977,1335,12633,580,1344,0,0,1914,13976,1,1,1914,13977,California
Sacramento,2020-12-29,1970,15947,1203,13836,767,2111,0,0,1970,15946,0,1,1970,15947,California
Sacramento,2020-12-30,2560,18507,1460,15296,1100,3211,0,0,2561,18507,0,1,2561,18508,California
Sacramento,2020-12-31,1225,19732,689,15985,536,3747,0,0,1226,19733,0,1,1226,19734,California
Sacramento,2021-01-01,104,19836,81,16066,23,3770,0,0,104,19837,0,1,104,19838,California
Sacramento,2021-01-02,574,20410,370,16436,204,3974,0,0,574,20411,0,1,574,20412,California
Sacramento,2021-01-03,414,20824,225,16661,189,4163,0,0,413,20823,1,2,413,20825,California
Sacramento,2021-01-04,1943,22767,838,17499,1105,5268,0,0,1941,22763,1,3,1941,22766,California
Sacramento,2021-01-05,2244,25011,1008,18507,1236,6504,0,0,1860,24246,384,387,1867,24633,California
Sacramento,2021-01-06,2752,27763,1635,20142,1117,7621,0,0,1938,25377,808,1195,1939,26572,California
Sacramento,2021-01-07,2857,30620,1530,21672,1327,8948,0,0,1910,26346,941,2136,1910,28482,California
Sacramento,2021-01-08,3312,33932,2101,23773,1211,10159,0,0,2183,27406,1125,3261,2185,30667,California
Sacramento,2021-01-09,1279,35211,798,24571,481,10640,0,0,887,27902,391,3652,887,31554,California
Sacramento,2021-01-10,1226,36437,717,25288,509,11149,0,0,756,28189,470,4122,757,32311,California
Sacramento,2021-01-11,4368,40805,2964,28252,1404,12553,0,0,2432,28698,1935,6057,2444,34755,California
Sacramento,2021-01-12,4706,45511,3305,31557,1401,13954,0,0,2642,29284,2063,8120,2649,37404,California
Sacramento,2021-01-13,3862,49373,2229,33786,1633,15587,0,0,2441,30306,1420,9540,2442,39846,California
Sacramento,2021-01-14,4755,54128,2421,36207,2334,17921,0,0,3847,33247,906,10446,3847,43693,California
Sacramento,2021-01-15,4476,58604,2250,38457,2226,20147,0,0,3762,36297,713,11159,3763,47456,California
Sacramento,2021-01-16,2241,60845,1283,39740,958,21105,0,0,2022,38101,218,11377,2022,49478,California
Sacramento,2021-01-17,1678,62523,984,40724,694,21799,0,0,1495,39416,183,11560,1498,50976,California
Sacramento,2021-01-18,2833,65356,1735,42459,1098,22897,0,0,2248,41081,584,12144,2249,53225,California
Sacramento,2021-01-19,5006,70362,3025,45484,1981,24878,0,0,3750,43580,1254,13398,3753,56978,California
Sacramento,2021-01-20,4981,75343,2989,48473,1992,26870,0,0,3674,45953,1307,14705,3680,60658,California
Sacramento,2021-01-21,5265,80608,3033,51506,2232,29102,0,0,4283,49264,974,15679,4285,64943,California
Sacramento,2021-01-22,5066,85674,2711,54217,2355,31457,0,0,4759,53718,306,15985,4760,69703,California
Sacramento,2021-01-23,3881,89555,1569,55786,2312,33769,0,0,3415,56667,466,16451,3415,73118,California
Sacramento,2021-01-24,1658,91213,1032,56818,626,34395,0,0,1408,57829,248,16699,1410,74528,California
Sacramento,2021-01-25,4418,95631,2167,58985,2251,36646,0,0,2946,59305,1472,18171,2948,77476,California
Sacramento,2021-01-26,4774,100405,2180,61165,2594,39240,0,0,3562,61662,1207,19378,3564,81040,California
Sacramento,2021-01-27,5905,106310,3055,64220,2850,42090,0,0,4270,64306,1628,21006,4272,85312,California
Sacramento,2021-01-28,5499,111809,2749,66969,2750,44840,0,0,4393,67596,1104,22110,4394,89706,California
Sacramento,2021-01-29,5449,117258,2930,69899,2519,47359,0,0,4423,71001,1018,23128,4423,94129,California
Sacramento,2021-01-30,4875,122133,2201,72100,2674,50033,0,0,4441,75011,431,23559,4441,98570,California
Sacramento,2021-01-31,2435,124568,2133,74233,302,50335,0,0,2080,76740,353,23912,2082,100652,California
Sacramento,2021-02-01,5958,130526,3037,77270,2921,53256,0,0,4269,79328,1682,25594,4270,104922,California
Sacramento,2021-02-02,7114,137640,3857,81127,3257,56513,0,0,4991,82219,2102,27696,4993,109915,California
Sacramento,2021-02-03,7152,144792,3600,84727,3552,60065,0,0,5270,85621,1870,29566,5272,115187,California
Sacramento,2021-02-04,7790,152582,3686,88413,4104,64169,0,0,5536,88912,2245,31811,5536,120723,California
Sacramento,2021-02-05,7903,160485,4492,92905,3411,67580,0,0,4841,90723,3038,34849,4849,125572,California
Sacramento,2021-02-06,8857,169342,3492,96397,5365,72945,0,0,7497,96864,1358,36207,7499,133071,California
Sacramento,2021-02-07,4105,173447,2235,98632,1870,74815,0,0,2917,98600,1183,37390,2919,135990,California
Sacramento,2021-02-08,6297,179744,3273,101905,3024,77839,0,0,3926,100161,2365,39755,3926,139916,California
Sacramento,2021-02-09,6830,186574,3581,105486,3249,81088,0,0,4026,101399,2790,42545,4028,143944,California
Sacramento,2021-02-10,7768,194342,4250,109736,3518,84606,0,0,4532,102715,3217,45762,4533,148477,California
Sacramento,2021-02-11,9657,203999,5765,115501,3892,88498,0,0,5520,104114,4123,49885,5522,153999,California
Sacramento,2021-02-12,10787,214786,4199,119700,6588,95086,0,0,6437,106278,4277,54162,6441,160440,California
Sacramento,2021-02-13,8151,222937,3031,122731,5120,100206,0,0,6330,110796,1813,55975,6331,166771,California
Sacramento,2021-02-14,3275,226212,2016,124747,1259,101465,0,0,2124,111777,1148,57123,2129,168900,California
Sacramento,2021-02-15,6070,232282,2080,126827,3990,105455,0,0,4217,114156,1842,58965,4221,173121,California
Sacramento,2021-02-16,9378,241660,4258,131085,5120,110575,0,0,5384,115563,3983,62948,5390,178511,California
Sacramento,2021-02-17,8982,250642,5049,136134,3933,114508,0,0,5203,117006,3766,66714,5209,183720,California
Sacramento,2021-02-18,9700,260342,5816,141950,3884,118392,0,0,5777,118878,3908,70622,5780,189500,California
Sacramento,2021-02-19,10172,270514,6242,148192,3930,122322,0,0,6001,120735,4154,74776,6011,195511,California
Sacramento,2021-02-20,8250,278764,5879,154071,2371,124693,0,0,4819,122135,3422,78198,4822,200333,California
Sacramento,2021-02-21,5001,283765,2548,156619,2453,127146,0,0,2908,122959,2084,80282,2908,203241,California
Sacramento,2021-02-22,6555,290320,3981,160600,2574,129720,0,0,2835,122102,3696,83978,2839,206080,California
Sacramento,2021-02-23,7737,298057,4821,165421,2916,132636,0,0,3561,121513,4154,88132,3565,209645,California
Sacramento,2021-02-24,10218,308275,5653,171074,4565,137201,0,0,5495,122317,4699,92831,5503,215148,California
Sacramento,2021-02-25,11669,319944,6686,177760,4983,142184,0,0,6765,124202,4881,97712,6766,221914,California
Sacramento,2021-02-26,14905,334849,7053,184813,7852,150036,0,0,10160,129664,4704,102416,10166,232080,California
Sacramento,2021-02-27,11485,346334,7043,191856,4439,154475,3,3,8480,135173,2975,105391,8484,240564,California
Sacramento,2021-02-28,6841,353175,2453,194309,4388,158863,0,3,3195,134743,3628,109019,3198,243762,California
Sacramento,2021-03-01,8954,362129,3758,198067,5192,164055,4,7,4836,135503,4083,113102,4843,248605,California
Sacramento,2021-03-02,9777,371906,4384,202451,5392,169447,1,8,5839,137431,3916,117018,5844,254449,California
Sacramento,2021-03-03,11534,383440,5326,207777,6204,175651,4,12,6857,139644,4651,121669,6864,261313,California
Sacramento,2021-03-04,13959,397399,6491,214268,7464,183115,4,16,7697,141137,6216,127885,7709,269022,California
Sacramento,2021-03-05,10966,408365,5141,219409,5795,188910,30,46,7145,144522,3791,131676,7176,276198,California
Sacramento,2021-03-06,8330,416695,3267,222676,4938,193848,125,171,4147,144631,4162,135838,4271,280469,California
Sacramento,2021-03-07,8170,424865,2277,224953,5749,199597,144,315,3794,144209,4357,140195,3935,284404,California
Sacramento,2021-03-08,9308,434173,4404,229357,4664,204261,240,555,5998,147149,3294,143489,6234,290638,California
Sacramento,2021-03-09,9873,444046,4654,234011,4922,209183,297,852,5599,148792,4249,147738,5892,296530,California
Sacramento,2021-03-10,11885,455931,7554,241565,3979,213162,352,1204,6938,151178,4906,152644,7292,303822,California
Sacramento,2021-03-11,15238,471169,10132,251697,4277,217439,829,2033,8978,154766,6212,158856,9800,313622,California
Sacramento,2021-03-12,18140,489309,8377,260074,8893,226332,870,2903,8876,155318,9195,168051,9747,323369,California
Sacramento,2021-03-13,13683,502992,3595,263669,9655,235987,433,3336,8457,158992,5212,173263,8886,332255,California
Sacramento,2021-03-14,9489,512481,3498,267167,5367,241354,624,3960,4480,159118,4976,178239,5102,337357,California
Sacramento,2021-03-15,12329,524810,4934,272101,6741,248095,654,4614,7092,161661,5205,183444,7748,345105,California
Sacramento,2021-03-16,14316,539126,6453,278554,7210,255305,653,5267,8788,165606,5487,188931,9432,354537,California
Sacramento,2021-03-17,14091,553217,6866,285420,6590,261895,635,5902,9007,170187,5056,193987,9637,364174,California
Sacramento,2021-03-18,15849,569066,8329,293749,6909,268804,611,6513,9989,174962,5821,199808,10596,374770,California
Sacramento,2021-03-19,15770,584836,8053,301802,6328,275132,1389,7902,7874,176352,7863,207671,9253,384023,California
Sacramento,2021-03-20,13410,598246,7568,309370,5497,280629,345,8247,8428,180180,4944,212615,8772,392795,California
Sacramento,2021-03-21,5843,604089,2779,312149,3024,283653,40,8287,3351,181100,2475,215090,3395,396190,California
Sacramento,2021-03-22,9459,613548,4874,317023,3734,287387,851,9138,6222,184965,3203,218293,7068,403258,California
Sacramento,2021-03-23,11507,625055,6856,323879,3845,291232,806,9944,7315,188942,4142,222435,8119,411377,California
Sacramento,2021-03-24,11983,637038,7306,331185,4050,295282,627,10571,6644,190962,5250,227685,7270,418647,California
Sacramento,2021-03-25,14356,651394,8434,339619,5084,300366,838,11409,8498,194479,5811,233496,9328,427975,California
Sacramento,2021-03-26,18464,669858,8979,348598,8972,309338,513,11922,9107,194820,9278,242774,9619,437594,California
Sacramento,2021-03-27,10244,680102,3611,352209,6341,315679,292,12214,5548,195996,4657,247431,5833,443427,California
Sacramento,2021-03-28,6662,686764,3251,355460,3159,318838,252,12466,2639,194878,4012,251443,2894,446321,California
Sacramento,2021-03-29,11104,697868,5921,361381,4794,323632,389,12855,4902,194000,6169,257612,5291,451612,California
Sacramento,2021-03-30,11956,709824,6099,367480,5451,329083,406,13261,5990,194460,5934,263546,6394,458006,California
Sacramento,2021-03-31,13522,723346,7889,375369,5225,334308,408,13669,5556,192483,7933,271479,5956,463962,California
Sacramento,2021-04-01,17566,740912,10493,385862,6819,341127,254,13923,7303,189833,10208,281687,7558,471520,California
Sacramento,2021-04-02,17238,758150,9732,395594,6762,347889,744,14667,9011,191398,8188,289875,9753,481273,California
Sacramento,2021-04-03,10493,768643,6257,401851,3685,351574,551,15218,6421,194320,4043,293918,6965,488238,California
Sacramento,2021-04-04,3745,772388,1548,403399,1995,353569,202,15420,1457,193695,2280,296198,1655,489893,California
Sacramento,2021-04-05,12090,784478,7571,410970,3684,357253,835,16255,5327,193127,6723,302921,6155,496048,California
Sacramento,2021-04-06,15734,800212,8880,419850,5514,362767,1340,17595,6784,192332,8914,311835,8119,504167,California
Sacramento,2021-04-07,14968,815180,8054,427904,5296,368063,1618,19213,6985,192992,7930,319765,8590,512757,California
Sacramento,2021-04-08,15125,830305,6786,434690,5340,373403,2999,22212,6008,192887,9079,328844,8974,521731,California
Sacramento,2021-04-09,18411,848716,9397,444087,6785,380188,2229,24441,7456,191650,10905,339749,9668,531399,California
Sacramento,2021-04-10,13466,862182,3851,447938,8385,388573,1230,25671,5862,191143,7570,347319,7063,538462,California
Sacramento,2021-04-11,11212,873394,4388,452326,6595,395168,229,25900,3648,187481,7536,354855,3874,542336,California
Sacramento,2021-04-12,13035,886429,5050,457376,6075,401243,1910,27810,4912,186231,8054,362909,6804,549140,California
Sacramento,2021-04-13,16346,902775,9978,467354,6363,407606,5,27815,7574,185075,8738,371647,7582,556722,California
Sacramento,2021-04-14,15098,917873,8031,475385,7064,414670,3,27818,5934,181887,9127,380774,5939,562661,California
Sacramento,2021-04-15,16457,934330,8436,483821,8018,422688,3,27821,6623,178729,9786,390560,6628,569289,California
Sacramento,2021-04-16,17643,951973,9747,493568,7896,430584,0,27821,7972,177084,9619,400179,7974,577263,California
Sacramento,2021-04-17,15916,967889,6206,499774,9710,440294,0,27821,11598,184397,4290,404469,11603,588866,California
Sacramento,2021-04-18,9085,976974,3277,503051,5808,446102,0,27821,3882,183099,5182,409651,3884,592750,California
Sacramento,2021-04-19,10661,987635,5754,508805,4902,451004,5,27826,4698,181867,5937,415588,4705,597455,California
Sacramento,2021-04-20,11531,999166,7105,515910,4422,455426,4,27830,6041,182454,5462,421050,6049,603504,California
Sacramento,2021-04-21,12388,1011554,7414,523324,4971,460397,3,27833,6638,183380,5716,426766,6642,610146,California
Sacramento,2021-04-22,15390,1026944,10335,533659,5050,465447,5,27838,7054,182146,8295,435061,7061,617207,California
Sacramento,2021-04-23,16490,1043434,10422,544081,6068,471515,0,27838,7648,180996,8800,443861,7650,624857,California
Sacramento,2021-04-24,11771,1055205,7119,551200,4650,476165,2,27840,6265,181802,5460,449321,6266,631123,California
Sacramento,2021-04-25,8575,1063780,4538,555738,4037,480202,0,27840,4215,181680,4339,453660,4217,635340,California
Sacramento,2021-04-26,10889,1074669,6859,562597,4006,484208,24,27864,5180,181210,5676,459336,5206,640546,California
Sacramento,2021-04-27,12362,1087031,8142,570739,4061,488269,159,28023,6065,181174,6262,465598,6226,646772,California
Sacramento,2021-04-28,10903,1097934,6180,576919,4517,492786,206,28229,6043,182598,4828,470426,6252,653024,California
Sacramento,2021-04-29,11277,1109211,7651,584570,3320,496106,306,28535,6193,184060,5040,475466,6502,659526,California
Sacramento,2021-04-30,12827,1122038,8124,592694,4441,500547,262,28797,6075,183701,6697,482163,6338,665864,California
Sacramento,2021-05-01,7699,1129737,5532,598226,1989,502536,178,28975,2824,181873,4832,486995,3004,668868,California
Sacramento,2021-05-02,5019,1134756,4324,602550,544,503080,151,29126,2233,181498,2758,489753,2383,671251,California
Sacramento,2021-05-03,9245,1144001,7391,609941,1575,504655,279,29405,4017,180587,5204,494957,4293,675544,California
Sacramento,2021-05-04,9756,1153757,6005,615946,3439,508094,312,29717,3875,178940,5831,500788,4184,679728,California
Sacramento,2021-05-05,11433,1165190,6256,622202,4712,512806,465,30182,4663,177341,6720,507508,5121,684849,California
Sacramento,2021-05-06,11539,1176729,6457,628659,4773,517579,309,30491,4697,175864,6480,513988,5003,689852,California
Sacramento,2021-05-07,10879,1187608,6351,635010,4157,521736,371,30862,4581,174574,6242,520230,4952,694804,California
Sacramento,2021-05-08,9031,1196639,4019,639029,4781,526517,231,31093,2843,171499,6141,526371,3066,697870,California
Sacramento,2021-05-09,3290,1199929,1795,640824,1383,527900,112,31205,1205,170742,2074,528445,1317,699187,California
Sacramento,2021-05-10,8358,1208287,3916,644740,4169,532069,273,31478,2008,166709,6315,534760,2282,701469,California
Sacramento,2021-05-11,8707,1216994,5504,650244,2940,535009,263,31741,3034,164367,5640,540400,3298,704767,California
Sacramento,2021-05-12,8819,1225813,5309,655553,3254,538263,256,31997,2958,161752,5826,546226,3211,707978,California
Sacramento,2021-05-13,12058,1237871,7714,663267,4066,542329,278,32275,4568,159151,7446,553672,4845,712823,California
Sacramento,2021-05-14,12599,1250470,7146,670413,5160,547489,293,32568,5078,157061,7460,561132,5370,718193,California
Sacramento,2021-05-15,13306,1263776,8049,678462,5113,552602,144,32712,5887,155705,7383,568515,6027,724220,California
Sacramento,2021-05-16,8507,1272283,4291,682753,4103,556705,113,32825,2242,151830,6233,574748,2358,726578,California
Sacramento,2021-05-17,10526,1282809,6413,689166,3811,560516,302,33127,3915,149478,6571,581319,4219,730797,California
Sacramento,2021-05-18,9943,1292752,6231,695397,3495,564011,217,33344,3715,147228,6187,587506,3937,734734,California
Sacramento,2021-05-19,9919,1302671,6301,701698,3353,567364,265,33609,4445,146515,5429,592935,4716,739450,California
Sacramento,2021-05-20,10348,1313019,6813,708511,3273,570637,262,33871,3854,144191,6441,599376,4117,743567,California
Sacramento,2021-05-21,10788,1323807,6828,715339,3637,574274,323,34194,4467,142710,6277,605653,4796,748363,California
Sacramento,2021-05-22,7463,1331270,4610,719949,2679,576953,174,34368,3332,142120,4099,609752,3509,751872,California
Sacramento,2021-05-23,5308,1336578,3020,722969,2184,579137,104,34472,1969,140876,3318,613070,2074,753946,California
Sacramento,2021-05-24,7890,1344468,4755,727724,2803,581940,332,34804,2505,138370,5342,618412,2836,756782,California
Sacramento,2021-05-25,6756,1351224,3901,731625,2561,584501,294,35098,2398,136731,4328,622740,2689,759471,California
Sacramento,2021-05-26,8604,1359828,4743,736368,3521,588022,340,35438,2810,134132,5745,628485,3146,762617,California
Sacramento,2021-05-27,6711,1366539,3659,740027,2809,590831,243,35681,2941,133593,3723,632208,3184,765801,California
Sacramento,2021-05-28,8474,1375013,4783,744810,3321,594152,370,36051,3622,132776,4808,637016,3991,769792,California
Sacramento,2021-05-29,4448,1379461,2707,747517,1580,595732,161,36212,2227,132968,2195,639211,2387,772179,California
Sacramento,2021-05-30,1688,1381149,1073,748590,577,596309,38,36250,754,132834,927,640138,793,772972,California
Sacramento,2021-05-31,887,1382036,448,749038,426,596735,13,36263,316,132596,568,640706,330,773302,California
Sacramento,2021-06-01,6973,1389009,4179,753217,2587,599322,207,36470,2524,130918,4406,645112,2728,776030,California
Sacramento,2021-06-02,6113,1395122,3360,756577,2541,601863,212,36682,2266,129589,3806,648918,2477,778507,California
Sacramento,2021-06-03,7477,1402599,5078,761655,2212,604075,187,36869,2138,126612,5298,654216,2321,780828,California
Sacramento,2021-06-04,7099,1409698,4535,766190,2351,606426,213,37082,2214,124190,4849,659065,2427,783255,California
Sacramento,2021-06-05,6226,1415924,4562,770752,1524,607950,140,37222,1752,121638,4445,663510,1893,785148,California
Sacramento,2021-06-06,2465,1418389,1948,772700,460,608410,57,37279,790,120819,1667,665177,848,785996,California
Sacramento,2021-06-07,5595,1423984,3916,776616,1501,609911,178,37457,1561,118552,4003,669180,1736,787732,California
Sacramento,2021-06-08,5415,1429399,3690,780306,1547,611458,178,37635,1719,116782,3669,672849,1899,789631,California
Sacramento,2021-06-09,6197,1435596,4287,784593,1725,613183,185,37820,1623,114067,4522,677371,1807,791438,California
Sacramento,2021-06-10,5435,1441031,3467,788060,1756,614939,212,38032,1620,112134,3765,681136,1832,793270,California
Sacramento,2021-06-11,7741,1448772,5403,793463,2144,617083,194,38226,2200,109021,5505,686641,2392,795662,California
Sacramento,2021-06-12,4733,1453505,3063,796526,1553,618636,117,38343,1276,106976,3439,690080,1394,797056,California
Sacramento,2021-06-13,1937,1455442,1423,797949,470,619106,44,38387,396,105884,1530,691610,438,797494,California
Sacramento,2021-06-14,4349,1459791,2812,800761,1375,620481,162,38549,1342,104398,2989,694599,1503,798997,California
Sacramento,2021-06-15,4929,1464720,2963,803724,1739,622220,227,38776,1709,103131,3202,697801,1935,800932,California
Sacramento,2021-06-16,4504,1469224,3020,806744,1265,623485,219,38995,1556,101977,2921,700722,1767,802699,California
Sacramento,2021-06-17,4083,1473307,2649,809393,1267,624752,167,39162,1393,100874,2658,703380,1555,804254,California
Sacramento,2021-06-18,5296,1478603,3527,812920,1530,626282,239,39401,1832,99505,3439,706819,2070,806324,California
Sacramento,2021-06-19,3361,1481964,2280,815200,937,627219,144,39545,1198,98703,2142,708961,1340,807664,California
Sacramento,2021-06-20,1242,1483206,923,816123,291,627510,28,39573,568,98636,663,709624,596,808260,California
Sacramento,2021-06-21,2541,1485747,1347,817470,1032,628542,162,39735,1239,98746,1288,710912,1398,809658,California
Sacramento,2021-06-22,3923,1489670,2696,820166,1026,629568,201,39936,1535,98112,2364,713276,1730,811388,California
Sacramento,2021-06-23,4105,1493775,2829,822995,1068,630636,208,40144,1533,97297,2552,715828,1737,813125,California
Sacramento,2021-06-24,3486,1497261,2248,825243,1041,631677,197,40341,1390,96808,2076,717904,1587,814712,California
Sacramento,2021-06-25,4293,1501554,2931,828174,1146,632823,216,40557,1776,96302,2496,720400,1990,816702,California
Sacramento,2021-06-26,2860,1504414,2042,830216,693,633516,125,40682,1202,95988,1638,722038,1324,818026,California
Sacramento,2021-06-27,1243,1505657,914,831130,298,633814,31,40713,451,95682,788,722826,482,818508,California
Sacramento,2021-06-28,2635,1508292,1957,833087,537,634351,141,40854,1147,95498,1471,724297,1287,819795,California
Sacramento,2021-06-29,3313,1511605,2209,835296,964,635315,140,40994,1342,95041,1942,726239,1485,821280,California
Sacramento,2021-06-30,3292,1514897,2242,837538,915,636230,135,41129,1555,95014,1718,727957,1691,822971,California
Sacramento,2021-07-01,2878,1517775,1915,839453,800,637030,163,41292,1233,94783,1625,729582,1394,824365,California
Sacramento,2021-07-02,3428,1521203,2291,841744,984,638014,153,41445,1458,94445,1945,731527,1607,825972,California
Sacramento,2021-07-03,1849,1523052,1253,842997,563,638577,33,41478,796,94236,1039,732566,830,826802,California
Sacramento,2021-07-04,157,1523209,62,843059,85,638662,10,41488,66,94222,90,732656,76,826878,California
Sacramento,2021-07-05,1433,1524642,974,844033,424,639086,35,41523,708,94250,715,733371,743,827621,California
Sacramento,2021-07-06,3472,1528114,2436,846469,861,639947,175,41698,1284,93535,2165,735536,1450,829071,California
Sacramento,2021-07-07,3227,1531341,2247,848716,831,640778,149,41847,1368,93207,1839,737375,1511,830582,California
Sacramento,2021-07-08,2743,1534084,1766,850482,803,641581,174,42021,1136,92919,1593,738968,1305,831887,California
Sacramento,2021-07-09,3359,1537443,2186,852668,976,642557,197,42218,1418,92615,1915,740883,1611,833498,California
Sacramento,2021-07-10,2021,1539464,1415,854083,538,643095,68,42286,876,92429,1130,742013,944,834442,California
Sacramento,2021-07-11,809,1540273,567,854650,217,643312,25,42311,375,92401,428,742441,400,834842,California
Sacramento,2021-07-12,2628,1542901,1914,856564,592,643904,122,42433,1228,92370,1382,743823,1351,836193,California
Sacramento,2021-07-13,2896,1545797,1963,858527,795,644699,138,42571,1346,92309,1542,745365,1481,837674,California
Sacramento,2021-07-14,2816,1548613,1895,860422,777,645476,144,42715,1235,92117,1569,746934,1377,839051,California
Sacramento,2021-07-15,2555,1551168,1728,862150,714,646190,113,42828,1163,92010,1381,748315,1274,840325,California
Sacramento,2021-07-16,3337,1554505,2189,864339,975,647165,173,43001,1564,91993,1753,750068,1736,842061,California
Sacramento,2021-07-17,2198,1556703,1493,865832,645,647810,60,43061,1033,91937,1147,751215,1091,843152,California
Sacramento,2021-07-18,935,1557638,686,866518,220,648030,29,43090,462,91956,471,751686,490,843642,California
Sacramento,2021-07-19,2584,1560222,1859,868377,608,648638,117,43207,1311,92117,1266,752952,1427,845069,California
Sacramento,2021-07-20,2960,1563182,1980,870357,840,649478,140,43347,1544,92406,1393,754345,1682,846751,California
Sacramento,2021-07-21,3183,1566365,2191,872548,830,650308,162,43509,1549,92497,1616,755961,1707,848458,California
Sacramento,2021-07-22,2969,1569334,2031,874579,801,651109,137,43646,1524,92736,1422,757383,1661,850119,California
Sacramento,2021-07-23,3617,1572951,2528,877107,959,652068,130,43776,2028,93320,1571,758954,2155,852274,California
Sacramento,2021-07-24,2264,1575215,1530,878637,663,652731,71,43847,1248,93638,1002,759956,1320,853594,California
Sacramento,2021-07-25,904,1576119,658,879295,231,652962,15,43862,663,94082,235,760191,679,854273,California
Sacramento,2021-07-26,2828,1578947,1959,881254,765,653727,104,43966,1786,94956,1020,761211,1894,856167,California
Sacramento,2021-07-27,3340,1582287,2348,883602,864,654591,128,44094,1984,95736,1329,762540,2109,858276,California
Sacramento,2021-07-28,3360,1585647,2413,886015,808,655399,139,44233,1914,96367,1423,763963,2054,860330,California
Sacramento,2021-07-29,3105,1588752,2215,888230,757,656156,133,44366,1857,97131,1226,765189,1990,862320,California
Sacramento,2021-07-30,3786,1592538,2592,890822,1003,657159,191,44557,2300,98163,1456,766645,2488,864808,California
Sacramento,2021-07-31,1648,1594186,1165,891987,374,657533,109,44666,1003,98643,630,767275,1110,865918,California
San Benito,2020-12-16,29,29,29,29,0,0,0,0,29,29,0,0,29,29,California
San Benito,2020-12-17,47,76,47,76,0,0,0,0,47,76,0,0,47,76,California
San Benito,2020-12-18,76,152,76,152,0,0,0,0,76,152,0,0,76,152,California
San Benito,2020-12-19,46,198,46,198,0,0,0,0,46,198,0,0,46,198,California
San Benito,2020-12-20,24,222,24,222,0,0,0,0,24,222,0,0,24,222,California
San Benito,2020-12-21,80,302,80,302,0,0,0,0,80,302,0,0,80,302,California
San Benito,2020-12-22,100,402,100,402,0,0,0,0,100,402,0,0,100,402,California
San Benito,2020-12-23,85,487,75,477,10,10,0,0,85,487,0,0,85,487,California
San Benito,2020-12-24,13,500,6,483,7,17,0,0,13,500,0,0,13,500,California
San Benito,2020-12-25,3,503,3,486,0,17,0,0,3,503,0,0,3,503,California
San Benito,2020-12-26,13,516,5,491,8,25,0,0,13,516,0,0,13,516,California
San Benito,2020-12-27,9,525,8,499,1,26,0,0,9,525,0,0,9,525,California
San Benito,2020-12-28,68,593,38,537,30,56,0,0,68,593,0,0,68,593,California
San Benito,2020-12-29,51,644,21,558,30,86,0,0,51,644,0,0,51,644,California
San Benito,2020-12-30,60,704,38,596,22,108,0,0,60,704,0,0,60,704,California
San Benito,2020-12-31,17,721,2,598,15,123,0,0,17,721,0,0,17,721,California
San Benito,2021-01-02,23,744,22,620,1,124,0,0,23,744,0,0,23,744,California
San Benito,2021-01-03,4,748,2,622,2,126,0,0,3,747,0,0,3,747,California
San Benito,2021-01-04,68,816,24,646,44,170,0,0,68,815,0,0,68,815,California
San Benito,2021-01-05,127,943,38,684,89,259,0,0,124,936,3,3,124,939,California
San Benito,2021-01-06,108,1051,47,731,61,320,0,0,88,1004,20,23,88,1027,California
San Benito,2021-01-07,111,1162,70,801,41,361,0,0,58,1009,53,76,58,1085,California
San Benito,2021-01-08,183,1345,88,889,95,456,0,0,119,1064,64,140,119,1204,California
San Benito,2021-01-09,43,1388,32,921,11,467,0,0,29,1079,14,154,29,1233,California
San Benito,2021-01-10,16,1404,14,935,2,469,0,0,5,1073,11,165,5,1238,California
San Benito,2021-01-11,179,1583,113,1048,66,535,0,0,73,1040,106,271,73,1311,California
San Benito,2021-01-12,162,1745,55,1103,107,642,0,0,124,1126,38,309,124,1435,California
San Benito,2021-01-13,243,1988,69,1172,174,816,0,0,192,1267,51,360,192,1627,California
San Benito,2021-01-14,134,2122,24,1196,110,926,0,0,115,1363,19,379,115,1742,California
San Benito,2021-01-15,220,2342,22,1218,198,1124,0,0,204,1551,16,395,204,1946,California
San Benito,2021-01-16,26,2368,8,1226,18,1142,0,0,21,1567,5,400,21,1967,California
San Benito,2021-01-17,11,2379,4,1230,7,1149,0,0,9,1574,2,402,9,1976,California
San Benito,2021-01-18,36,2415,23,1253,13,1162,0,0,20,1578,16,418,20,1996,California
San Benito,2021-01-19,189,2604,82,1335,107,1269,0,0,150,1689,39,457,150,2146,California
San Benito,2021-01-20,343,2947,106,1441,237,1506,0,0,296,1939,46,503,296,2442,California
San Benito,2021-01-21,145,3092,32,1473,113,1619,0,0,120,2034,25,528,120,2562,California
San Benito,2021-01-22,243,3335,19,1492,224,1843,0,0,233,2257,10,538,233,2795,California
San Benito,2021-01-23,28,3363,15,1507,13,1856,0,0,12,2253,16,554,12,2807,California
San Benito,2021-01-24,27,3390,3,1510,24,1880,0,0,23,2272,4,558,23,2830,California
San Benito,2021-01-25,93,3483,24,1534,69,1949,0,0,45,2269,48,606,45,2875,California
San Benito,2021-01-26,143,3626,44,1578,99,2048,0,0,87,2300,56,662,87,2962,California
San Benito,2021-01-27,232,3858,70,1648,162,2210,0,0,191,2450,41,703,191,3153,California
San Benito,2021-01-28,154,4012,32,1680,122,2332,0,0,124,2545,29,732,124,3277,California
San Benito,2021-01-29,299,4311,37,1717,262,2594,0,0,273,2793,25,757,273,3550,California
San Benito,2021-01-30,53,4364,34,1751,19,2613,0,0,29,2798,24,781,29,3579,California
San Benito,2021-01-31,15,4379,4,1755,11,2624,0,0,10,2803,5,786,10,3589,California
San Benito,2021-02-01,141,4520,29,1784,112,2736,0,0,98,2858,43,829,98,3687,California
San Benito,2021-02-02,232,4752,49,1833,183,2919,0,0,140,2906,92,921,140,3827,California
San Benito,2021-02-03,345,5097,44,1877,301,3220,0,0,276,3113,69,990,276,4103,California
San Benito,2021-02-04,170,5267,24,1901,146,3366,0,0,122,3187,48,1038,122,4225,California
San Benito,2021-02-05,309,5576,45,1946,264,3630,0,0,241,3360,68,1106,241,4466,California
San Benito,2021-02-06,49,5625,8,1954,41,3671,0,0,34,3379,15,1121,34,4500,California
San Benito,2021-02-07,19,5644,9,1963,10,3681,0,0,17,3394,2,1123,17,4517,California
San Benito,2021-02-08,143,5787,17,1980,126,3807,0,0,95,3441,48,1171,95,4612,California
San Benito,2021-02-09,333,6120,64,2044,269,4076,0,0,196,3500,137,1308,196,4808,California
San Benito,2021-02-10,329,6449,89,2133,240,4316,0,0,109,3390,219,1527,109,4917,California
San Benito,2021-02-11,300,6749,31,2164,269,4585,0,0,198,3486,102,1629,198,5115,California
San Benito,2021-02-12,422,7171,30,2194,392,4977,0,0,214,3493,207,1836,214,5329,California
San Benito,2021-02-13,60,7231,7,2201,53,5030,0,0,49,3531,11,1847,49,5378,California
San Benito,2021-02-14,41,7272,5,2206,36,5066,0,0,31,3552,10,1857,31,5409,California
San Benito,2021-02-15,110,7382,10,2216,100,5166,0,0,100,3642,10,1867,100,5509,California
San Benito,2021-02-16,214,7596,11,2227,203,5369,0,0,106,3641,108,1975,107,5616,California
San Benito,2021-02-17,333,7929,31,2258,302,5671,0,0,282,3872,51,2026,282,5898,California
San Benito,2021-02-18,299,8228,39,2297,260,5931,0,0,70,3713,229,2255,70,5968,California
San Benito,2021-02-19,361,8589,53,2350,308,6239,0,0,188,3728,173,2428,188,6156,California
San Benito,2021-02-20,52,8641,27,2377,25,6264,0,0,40,3756,12,2440,40,6196,California
San Benito,2021-02-21,27,8668,12,2389,15,6279,0,0,19,3767,8,2448,19,6215,California
San Benito,2021-02-22,141,8809,35,2424,106,6385,0,0,101,3829,39,2487,101,6316,California
San Benito,2021-02-23,388,9197,98,2522,290,6675,0,0,267,3976,121,2608,268,6584,California
San Benito,2021-02-24,406,9603,81,2603,325,7000,0,0,256,4082,150,2758,256,6840,California
San Benito,2021-02-25,404,10007,71,2674,333,7333,0,0,278,4232,128,2886,278,7118,California
San Benito,2021-02-26,682,10689,84,2758,598,7931,0,0,425,4400,257,3143,425,7543,California
San Benito,2021-02-27,115,10804,45,2803,70,8001,0,0,96,4477,19,3162,96,7639,California
San Benito,2021-02-28,260,11064,31,2834,229,8230,0,0,248,4713,12,3174,248,7887,California
San Benito,2021-03-01,241,11305,63,2897,178,8408,0,0,166,4804,75,3249,166,8053,California
San Benito,2021-03-02,300,11605,98,2995,202,8610,0,0,223,4950,77,3326,223,8276,California
San Benito,2021-03-03,417,12022,62,3057,355,8965,0,0,234,5003,181,3507,234,8510,California
San Benito,2021-03-04,622,12644,129,3186,478,9443,15,15,434,5252,188,3695,437,8947,California
San Benito,2021-03-05,603,13247,316,3502,275,9718,12,27,384,5431,217,3912,396,9343,California
San Benito,2021-03-06,213,13460,78,3580,121,9839,14,41,157,5546,56,3968,171,9514,California
San Benito,2021-03-07,649,14109,599,4179,21,9860,29,70,611,6148,38,4006,640,10154,California
San Benito,2021-03-08,294,14403,68,4247,179,10039,47,117,169,6239,125,4131,216,10370,California
San Benito,2021-03-09,436,14839,86,4333,248,10287,102,219,143,6166,291,4422,218,10588,California
San Benito,2021-03-10,420,15259,125,4458,197,10484,98,317,242,6328,178,4600,340,10928,California
San Benito,2021-03-11,481,15740,128,4586,199,10683,154,471,212,6425,269,4869,366,11294,California
San Benito,2021-03-12,535,16275,128,4714,311,10994,96,567,230,6449,302,5171,326,11620,California
San Benito,2021-03-13,206,16481,102,4816,84,11078,20,587,132,6530,71,5242,152,11772,California
San Benito,2021-03-14,232,16713,39,4855,173,11251,20,607,180,6679,51,5293,200,11972,California
San Benito,2021-03-15,325,17038,97,4952,209,11460,19,626,193,6759,132,5425,212,12184,California
San Benito,2021-03-16,512,17550,223,5175,257,11717,32,658,359,6996,152,5577,389,12573,California
San Benito,2021-03-17,801,18351,481,5656,298,12015,22,680,561,7337,234,5811,575,13148,California
San Benito,2021-03-18,790,19141,532,6188,204,12219,54,734,578,7747,211,6022,621,13769,California
San Benito,2021-03-19,781,19922,405,6593,352,12571,24,758,572,8133,209,6231,595,14364,California
San Benito,2021-03-20,248,20170,151,6744,86,12657,11,769,184,8264,64,6295,195,14559,California
San Benito,2021-03-21,111,20281,58,6802,49,12706,4,773,82,8321,29,6324,86,14645,California
San Benito,2021-03-22,365,20646,179,6981,161,12867,25,798,230,8443,133,6457,255,14900,California
San Benito,2021-03-23,482,21128,203,7184,269,13136,10,808,214,8398,268,6725,223,15123,California
San Benito,2021-03-24,592,21720,312,7496,273,13409,7,815,353,8521,237,6962,360,15483,California
San Benito,2021-03-25,755,22475,448,7944,303,13712,4,819,445,8664,306,7268,449,15932,California
San Benito,2021-03-26,1037,23512,536,8480,497,14209,4,823,337,8305,700,7968,341,16273,California
San Benito,2021-03-27,361,23873,203,8683,123,14332,35,858,230,8439,131,8099,265,16538,California
San Benito,2021-03-28,742,24615,610,9293,126,14458,6,864,135,7973,607,8706,141,16679,California
San Benito,2021-03-29,349,24964,111,9404,217,14675,21,885,142,7929,206,8912,162,16841,California
San Benito,2021-03-30,604,25568,289,9693,218,14893,97,982,302,8026,302,9214,399,17240,California
San Benito,2021-03-31,607,26175,373,10066,210,15103,24,1006,339,8124,265,9479,363,17603,California
San Benito,2021-04-01,972,27147,393,10459,539,15642,40,1046,575,8339,394,9873,609,18212,California
San Benito,2021-04-02,548,27695,264,10723,148,15790,136,1182,274,8476,273,10146,410,18622,California
San Benito,2021-04-03,264,27959,89,10812,110,15900,65,1247,74,8425,189,10335,138,18760,California
San Benito,2021-04-04,145,28104,108,10920,31,15931,6,1253,106,8498,39,10374,112,18872,California
San Benito,2021-04-05,362,28466,174,11094,145,16076,43,1296,150,8478,212,10586,192,19064,California
San Benito,2021-04-06,473,28939,164,11258,127,16203,182,1478,164,8514,309,10895,345,19409,California
San Benito,2021-04-07,951,29890,527,11785,234,16437,190,1668,270,8296,678,11573,460,19869,California
San Benito,2021-04-08,873,30763,435,12220,180,16617,258,1926,228,8139,643,12216,486,20355,California
San Benito,2021-04-09,858,31621,505,12725,260,16877,93,2019,297,7969,560,12776,390,20745,California
San Benito,2021-04-10,361,31982,219,12944,80,16957,62,2081,203,8076,158,12934,265,21010,California
San Benito,2021-04-11,485,32467,278,13222,172,17129,35,2116,276,8156,209,13143,289,21299,California
San Benito,2021-04-12,546,33013,293,13515,135,17264,118,2234,283,8291,262,13405,397,21696,California
San Benito,2021-04-13,761,33774,296,13811,443,17707,22,2256,526,8606,234,13639,549,22245,California
San Benito,2021-04-14,863,34637,678,14489,185,17892,0,2256,406,8562,450,14089,406,22651,California
San Benito,2021-04-15,965,35602,749,15238,215,18107,1,2257,482,8565,481,14570,484,23135,California
San Benito,2021-04-16,720,36322,375,15613,334,18441,11,2268,303,8466,414,14984,315,23450,California
San Benito,2021-04-17,325,36647,228,15841,97,18538,0,2268,133,8405,194,15178,133,23583,California
San Benito,2021-04-18,521,37168,438,16279,83,18621,0,2268,253,8392,268,15446,255,23838,California
San Benito,2021-04-19,761,37929,608,16887,153,18774,0,2268,431,8496,328,15774,432,24270,California
San Benito,2021-04-20,816,38745,441,17328,373,19147,2,2270,508,8702,303,16077,509,24779,California
San Benito,2021-04-21,1000,39745,732,18060,268,19415,0,2270,543,8805,440,16517,543,25322,California
San Benito,2021-04-22,937,40682,713,18773,224,19639,0,2270,585,9046,344,16861,585,25907,California
San Benito,2021-04-23,667,41349,422,19195,245,19884,0,2270,358,9144,260,17121,358,26265,California
San Benito,2021-04-24,369,41718,204,19399,165,20049,0,2270,171,9158,157,17278,171,26436,California
San Benito,2021-04-25,209,41927,129,19528,80,20129,0,2270,97,9162,93,17371,97,26533,California
San Benito,2021-04-26,518,42445,413,19941,105,20234,0,2270,271,9249,184,17555,271,26804,California
San Benito,2021-04-27,578,43023,298,20239,272,20506,8,2278,418,9526,149,17704,426,27230,California
San Benito,2021-04-28,577,43600,407,20646,161,20667,9,2287,408,9778,164,17868,416,27646,California
San Benito,2021-04-29,643,44243,243,20889,390,21057,10,2297,260,9684,381,18249,287,27933,California
San Benito,2021-04-30,393,44636,222,21111,163,21220,8,2305,213,9727,178,18427,221,28154,California
San Benito,2021-05-01,207,44843,151,21262,47,21267,9,2314,65,9662,139,18566,74,28228,California
San Benito,2021-05-02,199,45042,169,21431,26,21293,4,2318,59,9585,140,18706,63,28291,California
San Benito,2021-05-03,380,45422,298,21729,70,21363,12,2330,92,9404,287,18993,106,28397,California
San Benito,2021-05-04,429,45851,264,21993,157,21520,8,2338,153,9290,274,19267,160,28557,California
San Benito,2021-05-05,631,46482,446,22439,168,21688,17,2355,221,9121,407,19674,238,28795,California
San Benito,2021-05-06,648,47130,515,22954,117,21805,16,2371,228,8948,417,20091,244,29039,California
San Benito,2021-05-07,466,47596,296,23250,159,21964,11,2382,181,8858,283,20374,193,29232,California
San Benito,2021-05-08,288,47884,231,23481,51,22015,6,2388,155,8886,133,20507,161,29393,California
San Benito,2021-05-09,114,47998,88,23569,23,22038,3,2391,47,8870,66,20573,50,29443,California
San Benito,2021-05-10,433,48431,340,23909,68,22106,25,2416,53,8569,380,20953,79,29522,California
San Benito,2021-05-11,859,49290,446,24355,397,22503,16,2432,196,8121,661,21614,213,29735,California
San Benito,2021-05-12,527,49817,418,24773,96,22599,13,2445,126,7861,400,22014,140,29875,California
San Benito,2021-05-13,749,50566,641,25414,92,22691,16,2461,215,7559,532,22546,230,30105,California
San Benito,2021-05-14,609,51175,451,25865,151,22842,7,2468,235,7428,373,22919,242,30347,California
San Benito,2021-05-15,232,51407,173,26038,53,22895,6,2474,128,7458,104,23023,134,30481,California
San Benito,2021-05-16,172,51579,144,26182,26,22921,2,2476,97,7482,75,23098,99,30580,California
San Benito,2021-05-17,397,51976,317,26499,70,22991,10,2486,175,7448,219,23317,185,30765,California
San Benito,2021-05-18,687,52663,365,26864,317,23308,5,2491,213,7193,474,23791,219,30984,California
San Benito,2021-05-19,584,53247,421,27285,155,23463,8,2499,227,7071,357,24148,235,31219,California
San Benito,2021-05-20,608,53855,477,27762,120,23583,11,2510,320,7115,287,24435,331,31550,California
San Benito,2021-05-21,480,54335,283,28045,180,23763,17,2527,218,7090,260,24695,235,31785,California
San Benito,2021-05-22,306,54641,228,28273,73,23836,5,2532,186,7164,118,24813,192,31977,California
San Benito,2021-05-23,100,54741,62,28335,34,23870,4,2536,37,7141,63,24876,40,32017,California
San Benito,2021-05-24,310,55051,261,28596,42,23912,7,2543,188,7214,122,24998,195,32212,California
San Benito,2021-05-25,531,55582,244,28840,280,24192,7,2550,173,7038,356,25354,180,32392,California
San Benito,2021-05-26,318,55900,195,29035,115,24307,8,2558,126,6980,191,25545,133,32525,California
San Benito,2021-05-27,413,56313,316,29351,74,24381,23,2581,153,6899,260,25805,179,32704,California
San Benito,2021-05-28,295,56608,180,29531,107,24488,8,2589,112,6837,182,25987,120,32824,California
San Benito,2021-05-29,151,56759,129,29660,20,24508,2,2591,66,6820,85,26072,68,32892,California
San Benito,2021-05-30,268,57027,251,29911,17,24525,0,2591,93,6738,175,26247,93,32985,California
San Benito,2021-05-31,101,57128,88,29999,11,24536,2,2593,44,6728,56,26303,46,33031,California
San Benito,2021-06-01,270,57398,124,30123,120,24656,26,2619,85,6655,183,26486,110,33141,California
San Benito,2021-06-02,324,57722,245,30368,77,24733,2,2621,111,6557,212,26698,114,33255,California
San Benito,2021-06-03,343,58065,292,30660,46,24779,5,2626,101,6424,239,26937,106,33361,California
San Benito,2021-06-04,278,58343,209,30869,69,24848,0,2626,86,6319,191,27128,86,33447,California
San Benito,2021-06-05,101,58444,82,30951,18,24866,1,2627,24,6268,76,27204,25,33472,California
San Benito,2021-06-06,61,58505,50,31001,8,24874,3,2630,13,6236,48,27252,16,33488,California
San Benito,2021-06-07,336,58841,297,31298,34,24908,5,2635,85,6077,249,27501,90,33578,California
San Benito,2021-06-08,311,59152,219,31517,77,24985,15,2650,95,5972,215,27716,110,33688,California
San Benito,2021-06-09,244,59396,188,31705,48,25033,8,2658,69,5875,174,27890,77,33765,California
San Benito,2021-06-10,363,59759,332,32037,24,25057,7,2665,73,5668,287,28177,80,33845,California
San Benito,2021-06-11,262,60021,234,32271,23,25080,5,2670,95,5602,166,28343,100,33945,California
San Benito,2021-06-12,162,60183,148,32419,10,25090,4,2674,48,5555,99,28442,52,33997,California
San Benito,2021-06-13,55,60238,43,32462,10,25100,2,2676,17,5543,31,28473,19,34016,California
San Benito,2021-06-14,183,60421,153,32615,26,25126,4,2680,63,5491,118,28591,66,34082,California
San Benito,2021-06-15,225,60646,131,32746,88,25214,6,2686,79,5433,144,28735,86,34168,California
San Benito,2021-06-16,214,60860,170,32916,31,25245,13,2699,72,5377,141,28876,85,34253,California
San Benito,2021-06-17,255,61115,210,33126,17,25262,28,2727,78,5307,177,29053,107,34360,California
San Benito,2021-06-18,163,61278,106,33232,50,25312,7,2734,67,5285,96,29149,74,34434,California
San Benito,2021-06-19,115,61393,109,33341,6,25318,0,2734,48,5267,66,29215,48,34482,California
San Benito,2021-06-20,38,61431,36,33377,2,25320,0,2734,18,5265,20,29235,18,34500,California
San Benito,2021-06-21,117,61548,87,33464,15,25335,15,2749,63,5289,53,29288,77,34577,California
San Benito,2021-06-22,225,61773,125,33589,60,25395,40,2789,75,5254,149,29437,114,34691,California
San Benito,2021-06-23,150,61923,112,33701,28,25423,10,2799,60,5234,90,29527,70,34761,California
San Benito,2021-06-24,190,62113,163,33864,14,25437,13,2812,80,5218,109,29636,93,34854,California
San Benito,2021-06-25,154,62267,121,33985,30,25467,3,2815,65,5198,89,29725,69,34923,California
San Benito,2021-06-26,78,62345,61,34046,15,25482,2,2817,34,5191,43,29768,36,34959,California
San Benito,2021-06-27,58,62403,51,34097,2,25484,5,2822,24,5186,34,29802,29,34988,California
San Benito,2021-06-28,123,62526,100,34197,19,25503,4,2826,51,5169,72,29874,55,35043,California
San Benito,2021-06-29,112,62638,58,34255,42,25545,12,2838,41,5152,71,29945,54,35097,California
San Benito,2021-06-30,138,62776,113,34368,18,25563,7,2845,54,5130,83,30028,61,35158,California
San Benito,2021-07-01,132,62908,103,34471,20,25583,9,2854,53,5112,78,30106,60,35218,California
San Benito,2021-07-02,130,63038,74,34545,44,25627,12,2866,52,5098,78,30184,64,35282,California
San Benito,2021-07-03,103,63141,97,34642,5,25632,1,2867,56,5108,47,30231,57,35339,California
San Benito,2021-07-04,14,63155,13,34655,1,25633,0,2867,6,5106,8,30239,6,35345,California
San Benito,2021-07-05,93,63248,79,34734,13,25646,1,2868,45,5104,48,30287,46,35391,California
San Benito,2021-07-06,121,63369,60,34794,52,25698,9,2877,46,5084,75,30362,55,35446,California
San Benito,2021-07-07,144,63513,107,34901,35,25733,2,2879,49,5043,92,30454,51,35497,California
San Benito,2021-07-08,101,63614,82,34983,15,25748,4,2883,45,5038,54,30508,49,35546,California
San Benito,2021-07-09,85,63699,57,35040,25,25773,3,2886,44,5044,41,30549,47,35593,California
San Benito,2021-07-10,162,63861,101,35141,9,25782,52,2938,45,5024,117,30666,97,35690,California
San Benito,2021-07-11,44,63905,37,35178,7,25789,0,2938,10,5000,34,30700,10,35700,California
San Benito,2021-07-12,91,63996,60,35238,27,25816,4,2942,36,4984,55,30755,39,35739,California
San Benito,2021-07-13,136,64132,73,35311,60,25876,3,2945,54,4959,82,30837,57,35796,California
San Benito,2021-07-14,125,64257,92,35403,26,25902,7,2952,44,4930,80,30917,51,35847,California
San Benito,2021-07-15,152,64409,127,35530,21,25923,4,2956,71,4925,80,30997,75,35922,California
San Benito,2021-07-16,99,64508,74,35604,18,25941,7,2963,52,4937,47,31044,59,35981,California
San Benito,2021-07-17,82,64590,65,35669,16,25957,1,2964,38,4932,44,31088,39,36020,California
San Benito,2021-07-18,26,64616,18,35687,6,25963,2,2966,11,4930,15,31103,13,36033,California
San Benito,2021-07-19,123,64739,97,35784,19,25982,7,2973,70,4953,53,31156,76,36109,California
San Benito,2021-07-20,83,64822,41,35825,37,26019,5,2978,42,4959,41,31197,47,36156,California
San Benito,2021-07-21,157,64979,123,35948,33,26052,1,2979,84,4971,73,31270,85,36241,California
San Benito,2021-07-22,93,65072,70,36018,19,26071,4,2983,49,4980,44,31314,53,36294,California
San Benito,2021-07-23,145,65217,99,36117,39,26110,7,2990,79,5002,64,31378,86,36380,California
San Benito,2021-07-24,105,65322,82,36199,19,26129,4,2994,55,5011,50,31428,59,36439,California
San Benito,2021-07-25,63,65385,55,36254,8,26137,0,2994,40,5029,22,31450,40,36479,California
San Benito,2021-07-26,94,65479,71,36325,19,26156,4,2998,58,5055,36,31486,62,36541,California
San Benito,2021-07-27,124,65603,91,36416,29,26185,4,3002,84,5103,40,31526,88,36629,California
San Benito,2021-07-28,163,65766,133,36549,22,26207,8,3010,110,5167,53,31579,117,36746,California
San Benito,2021-07-29,144,65910,123,36672,15,26222,6,3016,85,5202,56,31635,91,36837,California
San Benito,2021-07-30,116,66026,73,36745,37,26259,6,3022,73,5238,43,31678,79,36916,California
San Benito,2021-07-31,31,66057,7,36752,18,26277,6,3028,15,5244,15,31693,21,36937,California
San Bernardino,2020-12-15,13,13,13,13,0,0,0,0,13,13,0,0,13,13,California
San Bernardino,2020-12-16,115,128,115,128,0,0,0,0,115,128,0,0,115,128,California
San Bernardino,2020-12-17,2386,2514,2386,2514,0,0,0,0,2386,2514,0,0,2386,2514,California
San Bernardino,2020-12-18,3287,5801,3283,5797,4,4,0,0,3288,5802,0,0,3288,5802,California
San Bernardino,2020-12-19,1154,6955,1153,6950,1,5,0,0,1155,6957,0,0,1155,6957,California
San Bernardino,2020-12-20,1214,8169,1210,8160,4,9,0,0,1214,8171,0,0,1214,8171,California
San Bernardino,2020-12-21,2477,10646,2470,10630,7,16,0,0,2477,10648,0,0,2477,10648,California
San Bernardino,2020-12-22,2298,12944,2167,12797,131,147,0,0,2298,12946,0,0,2298,12946,California
San Bernardino,2020-12-23,2697,15641,1490,14287,1207,1354,0,0,2696,15642,0,0,2696,15642,California
San Bernardino,2020-12-24,1180,16821,599,14886,581,1935,0,0,1180,16821,1,1,1180,16822,California
San Bernardino,2020-12-25,77,16898,17,14903,60,1995,0,0,77,16898,0,1,77,16899,California
San Bernardino,2020-12-26,464,17362,254,15157,210,2205,0,0,464,17362,0,1,464,17363,California
San Bernardino,2020-12-27,350,17712,164,15321,186,2391,0,0,349,17710,1,2,349,17712,California
San Bernardino,2020-12-28,1602,19314,703,16024,899,3290,0,0,1603,19313,0,2,1603,19315,California
San Bernardino,2020-12-29,2271,21585,1049,17073,1222,4512,0,0,2271,21584,0,2,2271,21586,California
San Bernardino,2020-12-30,2939,24524,1468,18541,1471,5983,0,0,2938,24522,0,2,2938,24524,California
San Bernardino,2020-12-31,1393,25917,446,18987,947,6930,0,0,1391,25913,0,2,1391,25915,California
San Bernardino,2021-01-01,260,26177,153,19140,107,7037,0,0,259,26172,0,2,259,26174,California
San Bernardino,2021-01-02,496,26673,348,19488,148,7185,0,0,496,26668,0,2,496,26670,California
San Bernardino,2021-01-03,173,26846,88,19576,85,7270,0,0,173,26841,0,2,173,26843,California
San Bernardino,2021-01-04,2162,29008,1302,20878,860,8130,0,0,2161,29002,0,2,2161,29004,California
San Bernardino,2021-01-05,2368,31376,1480,22358,888,9018,0,0,2254,31144,112,114,2254,31258,California
San Bernardino,2021-01-06,3560,34936,2450,24808,1110,10128,0,0,2983,33558,570,684,2984,34242,California
San Bernardino,2021-01-07,5522,40458,4578,29386,944,11072,0,0,2508,33071,2995,3679,2508,36750,California
San Bernardino,2021-01-08,5463,45921,4518,33904,945,12017,0,0,2315,32243,3144,6823,2316,39066,California
San Bernardino,2021-01-09,1421,47342,1110,35014,311,12328,0,0,912,32646,509,7332,912,39978,California
San Bernardino,2021-01-10,1029,48371,602,35616,427,12755,0,0,578,32773,451,7783,578,40556,California
San Bernardino,2021-01-11,5012,53383,4098,39714,914,13669,0,0,2782,33329,2226,10009,2782,43338,California
San Bernardino,2021-01-12,4267,57650,3233,42947,1034,14703,0,0,2529,34124,1734,11743,2529,45867,California
San Bernardino,2021-01-13,4658,62308,2865,45812,1793,16496,0,0,3410,36298,1237,12980,3411,49278,California
San Bernardino,2021-01-14,4902,67210,2825,48637,2077,18573,0,0,4298,39996,600,13580,4298,53576,California
San Bernardino,2021-01-15,6076,73286,3021,51658,3055,21628,0,0,5676,45282,393,13973,5679,59255,California
San Bernardino,2021-01-16,2280,75566,1295,52953,985,22613,0,0,2133,47268,147,14120,2133,61388,California
San Bernardino,2021-01-17,1186,76752,504,53457,682,23295,0,0,1103,48290,82,14202,1104,62492,California
San Bernardino,2021-01-18,4302,81054,2638,56095,1664,24959,0,0,3671,51333,631,14833,3674,66166,California
San Bernardino,2021-01-19,6397,87451,3465,59560,2932,27891,0,0,5292,55524,1103,15936,5294,71460,California
San Bernardino,2021-01-20,6934,94385,3791,63351,3143,31034,0,0,4958,58519,1965,17901,4960,76420,California
San Bernardino,2021-01-21,6070,100455,3117,66468,2953,33987,0,0,4937,62334,1125,19026,4940,81360,California
San Bernardino,2021-01-22,6623,107078,3066,69534,3557,37544,0,0,5889,67492,732,19758,5890,87250,California
San Bernardino,2021-01-23,3152,110230,1897,71431,1255,38799,0,0,2745,69831,406,20164,2745,89995,California
San Bernardino,2021-01-24,1215,111445,463,71894,752,39551,0,0,1109,70834,106,20270,1109,91104,California
San Bernardino,2021-01-25,6989,118434,3424,75318,3565,43116,0,0,5108,74069,1877,22147,5112,96216,California
San Bernardino,2021-01-26,7181,125615,3507,78825,3674,46790,0,0,4978,76846,2203,24350,4980,101196,California
San Bernardino,2021-01-27,8704,134319,4182,83007,4522,51312,0,0,5808,79766,2888,27238,5808,107004,California
San Bernardino,2021-01-28,8687,143006,4093,87100,4594,55906,0,0,6329,83746,2349,29587,6329,113333,California
San Bernardino,2021-01-29,8267,151273,3771,90871,4496,60402,0,0,6246,87991,2002,31589,6247,119580,California
San Bernardino,2021-01-30,3092,154365,1860,92731,1232,61634,0,0,2791,90484,299,31888,2792,122372,California
San Bernardino,2021-01-31,940,155305,488,93219,452,62086,0,0,881,91307,58,31946,881,123253,California
San Bernardino,2021-02-01,7652,162957,4259,97478,3393,65479,0,0,4951,93563,2696,34642,4952,128205,California
San Bernardino,2021-02-02,10604,173561,3677,101155,6927,72406,0,0,8479,99923,2121,36763,8481,136686,California
San Bernardino,2021-02-03,9127,182688,4162,105317,4965,77371,0,0,6568,103942,2551,39314,6570,143256,California
San Bernardino,2021-02-04,10588,193276,5185,110502,5403,82774,0,0,7443,108252,3134,42448,7444,150700,California
San Bernardino,2021-02-05,11207,204483,5989,116491,5218,87992,0,0,7557,112172,3638,46086,7558,158258,California
San Bernardino,2021-02-06,5311,209794,2219,118710,3092,91084,0,0,3662,114218,1619,47705,3665,161923,California
San Bernardino,2021-02-07,855,210649,496,119206,359,91443,0,0,471,114310,380,48085,472,162395,California
San Bernardino,2021-02-08,7385,218034,3937,123143,3448,94891,0,0,5679,118286,1703,49788,5679,168074,California
San Bernardino,2021-02-09,10277,228311,5678,128821,4599,99490,0,0,6906,122106,3090,52878,6910,174984,California
San Bernardino,2021-02-10,12285,240596,6531,135352,5754,105244,0,0,8100,126033,4174,57052,8101,183085,California
San Bernardino,2021-02-11,12605,253201,7230,142582,5375,110619,0,0,7989,129438,4588,61640,7993,191078,California
San Bernardino,2021-02-12,10650,263851,5980,148562,4670,115289,0,0,5791,130438,4795,66435,5795,196873,California
San Bernardino,2021-02-13,6161,270012,4095,152657,2066,117355,0,0,3863,132025,2281,68716,3868,200741,California
San Bernardino,2021-02-14,1597,271609,677,153334,920,118275,0,0,903,132242,687,69403,904,201645,California
San Bernardino,2021-02-15,5574,277183,3031,156365,2543,120818,0,0,3115,132911,2446,71849,3115,204760,California
San Bernardino,2021-02-16,12762,289945,7418,163783,5344,126162,0,0,8057,136283,4690,76539,8062,212822,California
San Bernardino,2021-02-17,12008,301953,6567,170350,5441,131603,0,0,7217,138737,4768,81307,7222,220044,California
San Bernardino,2021-02-18,12693,314646,7688,178038,5005,136608,0,0,7831,141730,4841,86148,7834,227878,California
San Bernardino,2021-02-19,11868,326514,6092,184130,5776,142384,0,0,6997,143882,4847,90995,6999,234877,California
San Bernardino,2021-02-20,4655,331169,3567,187697,1088,143472,0,0,2085,143410,2560,93555,2088,236965,California
San Bernardino,2021-02-21,1211,332380,734,188431,477,143949,0,0,421,143042,790,94345,422,237387,California
San Bernardino,2021-02-22,9160,341540,5649,194080,3511,147460,0,0,4201,142310,4934,99279,4202,241589,California
San Bernardino,2021-02-23,9936,351476,6024,200104,3912,151372,0,0,5014,142444,4887,104166,5021,246610,California
San Bernardino,2021-02-24,13100,364576,7544,207648,5556,156928,0,0,6372,142123,6700,110866,6379,252989,California
San Bernardino,2021-02-25,13787,378363,6655,214303,7132,164060,0,0,7948,144264,5812,116678,7953,260942,California
San Bernardino,2021-02-26,14377,392740,6749,221052,7628,171688,0,0,7985,145940,6318,122996,7994,268936,California
San Bernardino,2021-02-27,6992,399732,3901,224953,3089,174777,2,2,5008,148985,1969,124965,5014,273950,California
San Bernardino,2021-02-28,1881,401613,796,225749,1085,175862,0,2,1197,149513,671,125636,1199,275149,California
San Bernardino,2021-03-01,8834,410447,4573,230322,4256,180118,5,7,4000,148731,4798,130434,4016,279165,California
San Bernardino,2021-03-02,14424,424871,5714,236036,8710,188828,0,7,6722,147801,7662,138096,6732,285897,California
San Bernardino,2021-03-03,13460,438331,6871,242907,6585,195413,4,11,6323,147029,7108,145204,6336,292233,California
San Bernardino,2021-03-04,14275,452606,7003,249910,7271,202684,1,12,6164,145120,8083,153287,6174,298407,California
San Bernardino,2021-03-05,14672,467278,7566,257476,7104,209788,2,14,7082,144673,7551,160838,7104,305511,California
San Bernardino,2021-03-06,9837,477115,5508,262984,4095,213883,234,248,4560,144208,5255,166093,4790,310301,California
San Bernardino,2021-03-07,1794,478909,1040,264024,618,214501,136,384,1093,144742,697,166790,1231,311532,California
San Bernardino,2021-03-08,8249,487158,3633,267657,4427,218928,189,573,3665,144024,4575,171365,3857,315389,California
San Bernardino,2021-03-09,13211,500369,7537,275194,5413,224341,261,834,5279,141651,7914,179279,5541,320930,California
San Bernardino,2021-03-10,14317,514686,7892,283086,5869,230210,556,1390,6372,140663,7915,187194,6927,327857,California
San Bernardino,2021-03-11,15786,530472,7331,290417,6842,237052,1613,3003,7433,141370,8330,195524,9037,336894,California
San Bernardino,2021-03-12,15694,546166,7001,297418,6641,243693,2052,5055,7367,142539,8290,203814,9459,346353,California
San Bernardino,2021-03-13,8471,554637,4598,302016,3343,247036,530,5585,4987,144590,3468,207282,5519,351872,California
San Bernardino,2021-03-14,3342,557979,1697,303713,1058,248094,587,6172,1851,145542,1481,208763,2433,354305,California
San Bernardino,2021-03-15,11509,569488,5413,309126,4067,252161,2029,8201,5418,146905,6071,214834,7434,361739,California
San Bernardino,2021-03-16,16348,585836,8093,317219,7312,259473,943,9144,9846,151234,6466,221300,10795,372534,California
San Bernardino,2021-03-17,17592,603428,8747,325966,8100,267573,745,9889,10538,155488,7025,228325,11279,383813,California
San Bernardino,2021-03-18,16888,620316,8362,334328,8134,275707,392,10281,9827,158679,7025,235350,10216,394029,California
San Bernardino,2021-03-19,17207,637523,8532,342860,8072,283779,603,10884,9713,161585,7458,242808,10364,404393,California
San Bernardino,2021-03-20,9654,647177,6052,348912,2990,286769,612,11496,5651,163866,3973,246781,6254,410647,California
San Bernardino,2021-03-21,2878,650055,2324,351236,501,287270,53,11549,2277,165612,584,247365,2330,412977,California
San Bernardino,2021-03-22,9791,659846,4632,355868,4720,291990,439,11988,7047,170384,2714,250079,7486,420463,California
San Bernardino,2021-03-23,15814,675660,8956,364824,6231,298221,627,12615,9629,174479,6156,256235,10251,430714,California
San Bernardino,2021-03-24,15363,691023,7903,372727,7147,305368,313,12928,10016,179506,5303,261538,10330,441044,California
San Bernardino,2021-03-25,17264,708287,8456,381183,8500,313868,308,13236,10786,184182,6413,267951,11089,452133,California
San Bernardino,2021-03-26,18520,726807,8775,389958,8974,322842,771,14007,10936,188343,7547,275498,11708,463841,California
San Bernardino,2021-03-27,10987,737794,7065,397023,3159,326001,763,14770,6210,190566,4748,280246,6971,470812,California
San Bernardino,2021-03-28,3696,741490,2589,399612,989,326990,118,14888,2548,192094,1137,281383,2665,473477,California
San Bernardino,2021-03-29,12181,753671,6200,405812,5579,332569,402,15290,7989,196317,4167,285550,8390,481867,California
San Bernardino,2021-03-30,17139,770810,9561,415373,6856,339425,722,16012,10545,201023,6550,292100,11256,493123,California
San Bernardino,2021-03-31,16758,787568,9433,424806,6682,346107,643,16655,10928,206801,5790,297890,11568,504691,California
San Bernardino,2021-04-01,20018,807586,10580,435386,8003,354110,1435,18090,12781,213822,7184,305074,14205,518896,California
San Bernardino,2021-04-02,19050,826636,9564,444950,8189,362299,1297,19387,11474,219091,7541,312615,12810,531706,California
San Bernardino,2021-04-03,11242,837878,7026,451976,3070,365369,1146,20533,6111,221226,5111,317726,7246,538952,California
San Bernardino,2021-04-04,2539,840417,1532,453508,753,366122,254,20787,1271,221494,1257,318983,1525,540477,California
San Bernardino,2021-04-05,11966,852383,5353,458861,4813,370935,1800,22587,6046,223438,5892,324875,7836,548313,California
San Bernardino,2021-04-06,19969,872352,11239,470100,6605,377540,2125,24712,10515,226660,9404,334279,12626,560939,California
San Bernardino,2021-04-07,21333,893685,11467,481567,7352,384892,2514,27226,11565,230989,9732,344011,14061,575000,California
San Bernardino,2021-04-08,22210,915895,11398,492965,8160,393052,2652,29878,12144,235737,10031,354042,14779,589779,California
San Bernardino,2021-04-09,22084,937979,11243,504208,8198,401250,2643,32521,11951,240227,10083,364125,14573,604352,California
San Bernardino,2021-04-10,15875,953854,8224,512432,3897,405147,3754,36275,7875,243861,7975,372100,11609,615961,California
San Bernardino,2021-04-11,4526,958380,2632,515064,907,406054,987,37262,2071,244461,2447,374547,3047,619008,California
San Bernardino,2021-04-12,13644,972024,6306,521370,5669,411723,1669,38931,6477,245458,7138,381685,8135,627143,California
San Bernardino,2021-04-13,19615,991639,11183,532553,8413,420136,19,38950,11236,248373,8343,390028,11258,638401,California
San Bernardino,2021-04-14,19666,1011305,10486,543039,9177,429313,3,38953,11034,250824,8589,398617,11040,649441,California
San Bernardino,2021-04-15,20707,1032012,11545,554584,9156,438469,6,38959,10910,251994,9747,408364,10917,660358,California
San Bernardino,2021-04-16,19045,1051057,10771,565355,8273,446742,1,38960,9270,251540,9726,418090,9272,669630,California
San Bernardino,2021-04-17,12171,1063228,8026,573381,4144,450886,1,38961,6293,252005,5828,423918,6293,675923,California
San Bernardino,2021-04-18,3284,1066512,2352,575733,932,451818,0,38961,1404,251545,1864,425782,1404,677327,California
San Bernardino,2021-04-19,12756,1079268,6811,582544,5944,457762,1,38962,4892,248612,7831,433613,4898,682225,California
San Bernardino,2021-04-20,18377,1097645,10394,592938,7980,465742,3,38965,8256,246790,10083,443696,8261,690486,California
San Bernardino,2021-04-21,19276,1116921,11351,604289,7920,473662,5,38970,8360,244315,10842,454538,8367,698853,California
San Bernardino,2021-04-22,20021,1136942,11628,615917,8389,482051,4,38974,8066,240497,11893,466431,8075,706928,California
San Bernardino,2021-04-23,19254,1156196,11173,627090,8080,490131,1,38975,8276,237857,10920,477351,8280,715208,California
San Bernardino,2021-04-24,13132,1169328,9659,636749,3471,493602,2,38977,7044,238838,6065,483416,7046,722254,California
San Bernardino,2021-04-25,3484,1172812,2277,639026,1207,494809,0,38977,1708,238793,1756,485172,1711,723965,California
San Bernardino,2021-04-26,11534,1184346,6304,645330,5139,499948,91,39068,4907,237210,6581,491753,4998,728963,California
San Bernardino,2021-04-27,16997,1201343,10309,655639,6474,506422,214,39282,6952,234387,9990,501743,7167,736130,California
San Bernardino,2021-04-28,15372,1216715,9274,664913,5820,512242,278,39560,5542,230398,9800,511543,5811,741941,California
San Bernardino,2021-04-29,16901,1233616,9861,674774,6770,519012,270,39830,5673,225148,11190,522733,5940,747881,California
San Bernardino,2021-04-30,17195,1250811,10948,685722,5961,524973,286,40116,6372,221031,10775,533508,6658,754539,California
San Bernardino,2021-05-01,10997,1261808,8583,694305,2097,527070,317,40433,3797,217956,7182,540690,4107,758646,California
San Bernardino,2021-05-02,3003,1264811,2177,696482,695,527765,131,40564,1070,217237,1919,542609,1200,759846,California
San Bernardino,2021-05-03,10257,1275068,5925,702407,3922,531687,410,40974,2939,213284,7303,549912,3350,763196,California
San Bernardino,2021-05-04,16284,1291352,10014,712421,5804,537491,466,41440,4750,207011,11486,561398,5213,768409,California
San Bernardino,2021-05-05,15972,1307324,9372,721793,6187,543678,413,41853,4510,200519,11408,572806,4916,773325,California
San Bernardino,2021-05-06,16353,1323677,9464,731257,6466,550144,423,42276,4482,193606,11817,584623,4904,778229,California
San Bernardino,2021-05-07,15861,1339538,8985,740242,6502,556646,374,42650,4699,187586,11087,595710,5067,783296,California
San Bernardino,2021-05-08,9713,1349251,6509,746751,2933,559579,271,42921,3341,184865,6334,602044,3613,786909,California
San Bernardino,2021-05-09,2099,1351350,1400,748151,609,560188,90,43011,833,184530,1258,603302,923,787832,California
San Bernardino,2021-05-10,7839,1359189,3619,751770,3902,564090,318,43329,2387,181830,5403,608705,2703,790535,California
San Bernardino,2021-05-11,12889,1372078,7209,758979,5317,569407,363,43692,4141,177635,8699,617404,4504,795039,California
San Bernardino,2021-05-12,13063,1385141,7125,766104,5607,575014,331,44023,3717,172391,9290,626694,4046,799085,California
San Bernardino,2021-05-13,13735,1398876,8305,774409,5070,580084,360,44383,5347,169756,8335,635029,5700,804785,California
San Bernardino,2021-05-14,14217,1413093,9467,783876,4404,584488,346,44729,5896,167733,8265,643294,6242,811027,California
San Bernardino,2021-05-15,11561,1424654,8615,792491,2754,587242,192,44921,4688,165777,6829,650123,4873,815900,California
San Bernardino,2021-05-16,3150,1427804,2395,794886,691,587933,64,44985,1569,165848,1562,651685,1633,817533,California
San Bernardino,2021-05-17,10163,1437967,6835,801721,3048,590981,280,45265,4489,164979,5634,657319,4765,822298,California
San Bernardino,2021-05-18,13948,1451915,9245,810966,4443,595424,260,45525,6238,163800,7673,664992,6494,828792,California
San Bernardino,2021-05-19,11664,1463579,7307,818273,3983,599407,374,45899,5245,163038,6376,671368,5614,834406,California
San Bernardino,2021-05-20,11748,1475327,7041,825314,4393,603800,314,46213,5071,161792,6632,678000,5386,839792,California
San Bernardino,2021-05-21,12668,1487995,8397,833711,3895,607695,376,46589,5333,160219,7278,685278,5705,845497,California
San Bernardino,2021-05-22,9048,1497043,6730,840441,2108,609803,210,46799,4299,160022,4702,689980,4505,850002,California
San Bernardino,2021-05-23,2462,1499505,1569,842010,798,610601,95,46894,1139,159948,1309,691289,1235,851237,California
San Bernardino,2021-05-24,7040,1506545,4480,846490,2247,612848,313,47207,3101,159480,3881,695170,3413,854650,California
San Bernardino,2021-05-25,9436,1515981,5755,852245,3410,616258,271,47478,4144,158639,5251,700421,4410,859060,California
San Bernardino,2021-05-26,8270,1524251,5242,857487,2772,619030,256,47734,3742,158148,4481,704902,3990,863050,California
San Bernardino,2021-05-27,7703,1531954,4682,862169,2788,621818,233,47967,3450,157621,4210,709112,3683,866733,California
San Bernardino,2021-05-28,8898,1540852,5510,867679,3108,624926,280,48247,4415,157880,4434,713546,4693,871426,California
San Bernardino,2021-05-29,5118,1545970,3417,871096,1581,626507,120,48367,2591,158082,2508,716054,2710,874136,California
San Bernardino,2021-05-30,1775,1547745,1249,872345,443,626950,83,48450,855,158108,911,716965,937,875073,California
San Bernardino,2021-05-31,902,1548647,573,872918,312,627262,17,48467,322,157873,575,717540,340,875413,California
San Bernardino,2021-06-01,8763,1557410,5633,878551,2882,630144,248,48715,3400,156227,5292,722832,3646,879059,California
San Bernardino,2021-06-02,6928,1564338,4358,882909,2321,632465,249,48964,2922,155431,3963,726795,3167,882226,California
San Bernardino,2021-06-03,8071,1572409,5458,888367,2415,634880,198,49162,2742,153065,5306,732101,2940,885166,California
San Bernardino,2021-06-04,9272,1581681,6282,894649,2692,637572,298,49460,3171,150492,6043,738144,3470,888636,California
San Bernardino,2021-06-05,6646,1588327,5066,899715,1452,639024,128,49588,2275,148541,4351,742495,2400,891036,California
San Bernardino,2021-06-06,2055,1590382,1720,901435,271,639295,64,49652,681,147921,1365,743860,745,891781,California
San Bernardino,2021-06-07,6345,1596727,4926,906361,1206,640501,213,49865,1979,145772,4339,748199,2190,893971,California
San Bernardino,2021-06-08,8501,1605228,6172,912533,2105,642606,224,50089,2620,142804,5807,754006,2839,896810,California
San Bernardino,2021-06-09,7066,1612294,5031,917564,1844,644450,191,50280,2286,140557,4727,758733,2480,899290,California
San Bernardino,2021-06-10,7182,1619476,5063,922627,1913,646363,206,50486,2238,138108,4891,763624,2442,901732,California
San Bernardino,2021-06-11,8133,1627609,5672,928299,2225,648588,236,50722,2937,136129,5147,768771,3168,904900,California
San Bernardino,2021-06-12,5957,1633566,4678,932977,1156,649744,123,50845,1728,133779,4204,772975,1854,906754,California
San Bernardino,2021-06-13,1504,1635070,1068,934045,363,650107,73,50918,405,133162,1094,774069,477,907231,California
San Bernardino,2021-06-14,4968,1640038,3589,937634,1155,651262,224,51142,1817,132080,3121,777190,2039,909270,California
San Bernardino,2021-06-15,7225,1647263,5111,942745,1865,653127,249,51391,2568,130291,4603,781793,2814,912084,California
San Bernardino,2021-06-16,6423,1653686,4574,947319,1622,654749,227,51618,2349,128853,4013,785806,2575,914659,California
San Bernardino,2021-06-17,5740,1659426,4013,951332,1566,656315,161,51779,2230,127772,3472,789278,2391,917050,California
San Bernardino,2021-06-18,6987,1666413,4699,956031,2045,658360,243,52022,2626,126322,4316,793594,2866,919916,California
San Bernardino,2021-06-19,4093,1670506,3054,959085,903,659263,136,52158,1758,125901,2311,795905,1890,921806,California
San Bernardino,2021-06-20,1475,1671981,1133,960218,282,659545,60,52218,591,125675,876,796781,650,922456,California
San Bernardino,2021-06-21,3611,1675592,2342,962560,1039,660584,230,52448,1996,126299,1599,798380,2223,924679,California
San Bernardino,2021-06-22,5759,1681351,3920,966480,1622,662206,217,52665,2285,125363,3439,801819,2503,927182,California
San Bernardino,2021-06-23,5095,1686446,3611,970091,1281,663487,203,52868,2125,124748,2937,804756,2322,929504,California
San Bernardino,2021-06-24,4978,1691424,3461,973552,1304,664791,213,53081,2097,124224,2830,807586,2306,931810,California
San Bernardino,2021-06-25,5895,1697319,4155,977707,1532,666323,208,53289,2558,123684,3304,810890,2764,934574,California
San Bernardino,2021-06-26,3603,1700922,2749,980456,776,667099,78,53367,1678,123534,1905,812795,1755,936329,California
San Bernardino,2021-06-27,1469,1702391,1170,981626,247,667346,52,53419,690,123504,772,813567,742,937071,California
San Bernardino,2021-06-28,3576,1705967,2813,984439,609,667955,154,53573,1725,123581,1798,815365,1875,938946,California
San Bernardino,2021-06-29,5238,1711205,3792,988231,1261,669216,185,53758,2373,123297,2837,818202,2553,941499,California
San Bernardino,2021-06-30,4684,1715889,3294,991525,1216,670432,174,53932,2336,123496,2307,820509,2506,944005,California
San Bernardino,2021-07-01,4245,1720134,3030,994555,1045,671477,170,54102,2086,123617,2136,822645,2257,946262,California
San Bernardino,2021-07-02,5205,1725339,3711,998266,1325,672802,169,54271,2442,123501,2725,825370,2609,948871,California
San Bernardino,2021-07-03,2565,1727904,1930,1000196,579,673381,56,54327,1235,123478,1313,826683,1290,950161,California
San Bernardino,2021-07-04,211,1728115,145,1000341,62,673443,4,54331,114,123500,96,826779,118,950279,California
San Bernardino,2021-07-05,2312,1730427,1786,1002127,473,673916,53,54384,1130,123517,1167,827946,1184,951463,California
San Bernardino,2021-07-06,5169,1735596,3822,1005949,1182,675098,165,54549,2247,123029,2902,830848,2414,953877,California
San Bernardino,2021-07-07,4273,1739869,3149,1009098,994,676092,130,54679,1988,122882,2263,833111,2116,955993,California
San Bernardino,2021-07-08,4078,1743947,2973,1012071,951,677043,154,54833,1850,122678,2209,835320,2005,957998,California
San Bernardino,2021-07-09,4804,1748751,3467,1015538,1148,678191,189,55022,2206,122498,2571,837891,2391,960389,California
San Bernardino,2021-07-10,2933,1751684,2189,1017727,635,678826,109,55131,1458,122601,1463,839354,1566,961955,California
San Bernardino,2021-07-11,1285,1752969,963,1018690,282,679108,40,55171,640,122645,638,839992,682,962637,California
San Bernardino,2021-07-12,3509,1756478,2646,1021336,701,679809,162,55333,1611,122529,1887,841879,1771,964408,California
San Bernardino,2021-07-13,4592,1761070,3369,1024705,1074,680883,149,55482,2150,122414,2415,844294,2300,966708,California
San Bernardino,2021-07-14,4046,1765116,2936,1027641,965,681848,145,55627,1926,122387,2095,846389,2068,968776,California
San Bernardino,2021-07-15,4060,1769176,3009,1030650,927,682775,124,55751,1987,122459,2039,848428,2111,970887,California
San Bernardino,2021-07-16,5059,1774235,3713,1034363,1204,683979,142,55893,2602,122779,2422,850850,2742,973629,California
San Bernardino,2021-07-17,3446,1777681,2643,1037006,753,684732,50,55943,1793,122992,1629,852479,1842,975471,California
San Bernardino,2021-07-18,1426,1779107,1131,1038137,273,685005,22,55965,771,123138,647,853126,793,976264,California
San Bernardino,2021-07-19,3747,1782854,2887,1041024,715,685720,145,56110,1940,123441,1780,854906,2083,978347,California
San Bernardino,2021-07-20,4931,1787785,3586,1044610,1164,686884,181,56291,2639,123997,2262,857168,2818,981165,California
San Bernardino,2021-07-21,4580,1792365,3438,1048048,1013,687897,129,56420,2428,124427,2126,859294,2556,983721,California
San Bernardino,2021-07-22,4767,1797132,3578,1051626,1071,688968,118,56538,2679,125166,2059,861353,2798,986519,California
San Bernardino,2021-07-23,5585,1802717,4115,1055741,1317,690285,153,56691,3213,126188,2344,863697,3366,989885,California
San Bernardino,2021-07-24,3505,1806222,2647,1058388,775,691060,83,56774,2051,126893,1430,865127,2135,992020,California
San Bernardino,2021-07-25,1579,1807801,1200,1059588,364,691424,15,56789,1161,127658,411,865538,1176,993196,California
San Bernardino,2021-07-26,4059,1811860,2924,1062512,1020,692444,115,56904,2660,129055,1379,866917,2776,995972,California
San Bernardino,2021-07-27,5462,1817322,4074,1066586,1213,693657,175,57079,3225,130253,2201,869118,3399,999371,California
San Bernardino,2021-07-28,5283,1822605,3942,1070528,1199,694856,142,57221,3135,131421,2110,871228,3278,1002649,California
San Bernardino,2021-07-29,4896,1827501,3535,1074063,1195,696051,166,57387,3038,132787,1837,873065,3203,1005852,California
San Bernardino,2021-07-30,5834,1833335,4327,1078390,1322,697373,185,57572,3623,134425,2169,875234,3807,1009659,California
San Bernardino,2021-07-31,2113,1835448,1693,1080083,378,697751,42,57614,1310,134983,794,876028,1352,1011011,California
San Diego,2020-12-15,135,135,135,135,0,0,0,0,135,135,0,0,135,135,California
San Diego,2020-12-16,1094,1229,1094,1229,0,0,0,0,1094,1229,0,0,1094,1229,California
San Diego,2020-12-17,2315,3544,2315,3544,0,0,0,0,2315,3544,0,0,2315,3544,California
San Diego,2020-12-18,3595,7139,3594,7138,1,1,0,0,3595,7139,0,0,3595,7139,California
San Diego,2020-12-19,2257,9396,2257,9395,0,1,0,0,2257,9396,0,0,2257,9396,California
San Diego,2020-12-20,1145,10541,1144,10539,1,2,0,0,1145,10541,0,0,1145,10541,California
San Diego,2020-12-21,3434,13975,3432,13971,2,4,0,0,3434,13975,0,0,3434,13975,California
San Diego,2020-12-22,3994,17969,3350,17321,644,648,0,0,3994,17969,0,0,3994,17969,California
San Diego,2020-12-23,3127,21096,1946,19267,1181,1829,0,0,3127,21096,0,0,3127,21096,California
San Diego,2020-12-24,2691,23787,2183,21450,508,2337,0,0,2691,23787,0,0,2691,23787,California
San Diego,2020-12-25,857,24644,856,22306,1,2338,0,0,857,24644,0,0,857,24644,California
San Diego,2020-12-26,3184,27828,2118,24424,1066,3404,0,0,3184,27828,0,0,3184,27828,California
San Diego,2020-12-27,2482,30310,1596,26020,886,4290,0,0,2481,30308,1,1,2481,30309,California
San Diego,2020-12-28,5786,36096,4122,30142,1664,5954,0,0,5786,36094,0,1,5786,36095,California
San Diego,2020-12-29,5455,41551,2914,33056,2541,8495,0,0,5455,41549,0,1,5455,41550,California
San Diego,2020-12-30,5768,47319,2991,36047,2777,11272,0,0,5768,47317,0,1,5768,47318,California
San Diego,2020-12-31,2964,50283,1027,37074,1937,13209,0,0,2963,50280,0,1,2963,50281,California
San Diego,2021-01-01,987,51270,443,37517,544,13753,0,0,987,51267,0,1,987,51268,California
San Diego,2021-01-02,3616,54886,1260,38777,2356,16109,0,0,3616,54883,0,1,3616,54884,California
San Diego,2021-01-03,831,55717,619,39396,212,16321,0,0,830,55713,0,1,830,55714,California
San Diego,2021-01-04,3629,59346,2013,41409,1616,17937,0,0,3623,59336,0,1,3623,59337,California
San Diego,2021-01-05,4263,63609,2130,43539,2133,20070,0,0,3678,62445,582,583,3691,63028,California
San Diego,2021-01-06,4791,68400,2227,45766,2564,22634,0,0,3596,64871,1174,1757,3600,66628,California
San Diego,2021-01-07,5500,73900,2907,48673,2593,25227,0,0,3401,66188,2093,3850,3410,70038,California
San Diego,2021-01-08,7745,81645,4867,53540,2878,28105,0,0,4029,66536,3700,7550,4048,74086,California
San Diego,2021-01-09,3392,85037,1897,55437,1495,29600,0,0,1874,66912,1508,9058,1884,75970,California
San Diego,2021-01-10,1844,86881,1278,56715,566,30166,0,0,754,66599,1078,10136,765,76735,California
San Diego,2021-01-11,10119,97000,5721,62436,4398,34564,0,0,6675,69855,3437,13573,6693,83428,California
San Diego,2021-01-12,10971,107971,5233,67669,5738,40302,0,0,7652,74306,3310,16883,7761,91189,California
San Diego,2021-01-13,11225,119196,4937,72606,6288,46590,0,0,8719,80557,2495,19378,8746,99935,California
San Diego,2021-01-14,11917,131113,4486,77092,7431,54021,0,0,9792,88264,2118,21496,9825,109760,California
San Diego,2021-01-15,14731,145844,5216,82308,9515,63536,0,0,12127,97868,2584,24080,12188,121948,California
San Diego,2021-01-16,10485,156329,3526,85834,6959,70495,0,0,9062,105543,1419,25499,9094,131042,California
San Diego,2021-01-17,8456,164785,2415,88249,6041,76536,0,0,7631,112368,825,26324,7650,138692,California
San Diego,2021-01-18,12587,177372,6156,94405,6431,82967,0,0,9804,119484,2753,29077,9869,148561,California
San Diego,2021-01-19,14323,191695,5565,99970,8758,91725,0,0,11265,127959,3050,32127,11525,160086,California
San Diego,2021-01-20,17936,209631,6258,106228,11678,103403,0,0,14690,139606,3228,35355,14875,174961,California
San Diego,2021-01-21,16965,226596,5697,111925,11268,114671,0,0,15601,153997,1357,36712,15748,190709,California
San Diego,2021-01-22,17150,243746,4560,116485,12590,127261,0,0,15148,167242,1988,38700,15233,205942,California
San Diego,2021-01-23,13979,257725,5133,121618,8846,136107,0,0,11754,176840,2215,40915,11813,217755,California
San Diego,2021-01-24,11551,269276,3233,124851,8318,144425,0,0,10589,186514,960,41875,10634,228389,California
San Diego,2021-01-25,11946,281222,5650,130501,6296,150721,0,0,8987,192715,2949,44824,9150,237539,California
San Diego,2021-01-26,14796,296018,7669,138170,7127,157848,0,0,11435,200985,3359,48183,11629,249168,California
San Diego,2021-01-27,20082,316100,7779,145949,12303,170151,0,0,17120,215303,2952,51135,17270,266438,California
San Diego,2021-01-28,20820,336920,7526,153475,13294,183445,0,0,18572,231725,2237,53372,18659,285097,California
San Diego,2021-01-29,19164,356084,6266,159741,12898,196343,0,0,16752,246127,2401,55773,16803,301900,California
San Diego,2021-01-30,15392,371476,3495,163236,11897,208240,0,0,12769,256394,2612,58385,12879,314779,California
San Diego,2021-01-31,14441,385917,5644,168880,8797,217037,0,0,14090,270174,348,58733,14128,328907,California
San Diego,2021-02-01,20288,406205,7330,176210,12958,229995,0,0,16833,283629,3447,62180,16902,345809,California
San Diego,2021-02-02,22475,428680,8260,184470,14215,244210,0,0,19244,299815,3220,65400,19406,365215,California
San Diego,2021-02-03,26817,455497,11342,195812,15475,259685,0,0,22643,318481,4155,69555,22821,388036,California
San Diego,2021-02-04,23587,479084,9614,205426,13973,273658,0,0,19114,333406,4460,74015,19385,407421,California
San Diego,2021-02-05,24133,503217,8529,213955,15604,289262,0,0,17756,345274,6353,80368,18221,425642,California
San Diego,2021-02-06,20303,523520,8385,222340,11918,301180,0,0,17120,359437,3180,83548,17343,442985,California
San Diego,2021-02-07,11877,535397,5289,227629,6588,307768,0,0,10046,367918,1819,85367,10300,453285,California
San Diego,2021-02-08,19726,555123,8377,236006,11349,319117,0,0,12395,373678,7317,92684,13077,466362,California
San Diego,2021-02-09,20141,575264,8247,244253,11894,331011,0,0,12925,380536,7197,99881,14055,480417,California
San Diego,2021-02-10,22527,597791,9206,253459,13321,344332,0,0,13587,386587,8899,108780,14950,495367,California
San Diego,2021-02-11,23388,621179,10020,263479,13368,357700,0,0,12507,389909,10859,119639,14181,509548,California
San Diego,2021-02-12,23090,644269,7242,270721,15848,373548,0,0,11432,391942,11639,131278,13672,523220,California
San Diego,2021-02-13,19477,663746,8892,279613,10585,384133,0,0,10500,394641,8972,140250,11671,534891,California
San Diego,2021-02-14,10759,674505,7300,286913,3459,387592,0,0,5887,397147,4868,145118,7374,542265,California
San Diego,2021-02-15,14689,689194,7480,294393,7209,394801,0,0,7344,400195,7324,152442,10372,552637,California
San Diego,2021-02-16,18787,707981,11041,305434,7746,402547,0,0,8878,402073,9893,162335,11771,564408,California
San Diego,2021-02-17,22848,730829,10664,316098,12184,414731,0,0,7805,397829,15027,177362,10783,575191,California
San Diego,2021-02-18,23166,753995,11830,327928,11336,426067,0,0,7597,393885,15555,192917,11611,586802,California
San Diego,2021-02-19,15522,769517,10820,338748,4702,430769,0,0,6312,392945,9188,202105,8248,595050,California
San Diego,2021-02-20,10013,779530,6316,345064,3697,434466,0,0,5539,395877,4472,206577,7404,602454,California
San Diego,2021-02-21,11407,790937,10010,355074,1397,435863,0,0,5027,396025,6373,212950,6521,608975,California
San Diego,2021-02-22,12354,803291,10537,365611,1817,437680,0,0,5561,396423,6784,219734,7182,616157,California
San Diego,2021-02-23,25177,828468,14068,379679,11109,448789,0,0,9187,395447,15982,235716,15006,631163,California
San Diego,2021-02-24,28568,857036,12708,392387,15860,464649,0,0,6569,387377,21978,257694,13908,645071,California
San Diego,2021-02-25,32421,889457,14367,406754,18054,482703,0,0,9638,382548,22763,280457,17934,663005,California
San Diego,2021-02-26,32425,921882,12023,418777,20402,503105,0,0,11399,379966,20992,301449,18410,681415,California
San Diego,2021-02-27,20568,942450,9300,428077,11267,514372,1,1,10895,385374,9664,311113,15072,696487,California
San Diego,2021-02-28,14694,957144,9668,437745,5026,519398,0,1,9035,391481,5654,316767,11761,708248,California
San Diego,2021-03-01,23786,980930,14049,451794,9735,529133,2,3,14341,400261,9368,326135,18148,726396,California
San Diego,2021-03-02,25535,1006465,13724,465518,11811,540944,0,3,12300,405944,13222,339357,18905,745301,California
San Diego,2021-03-03,33221,1039686,15639,481157,17579,558523,3,6,13527,406659,19668,359025,20383,765684,California
San Diego,2021-03-04,27606,1067292,13773,494930,13832,572355,1,7,12167,410041,15417,374442,18799,784483,California
San Diego,2021-03-05,28223,1095515,14538,509468,13604,585959,81,88,13061,414632,15136,389578,19727,804210,California
San Diego,2021-03-06,22791,1118306,9263,518731,12849,598808,679,767,9951,417030,12825,402403,15223,819433,California
San Diego,2021-03-07,17833,1136139,9036,527767,8180,606988,617,1384,6657,416735,11161,413564,10866,830299,California
San Diego,2021-03-08,22412,1158551,10849,538616,10687,617675,876,2260,11011,422015,11375,424939,16655,846954,California
San Diego,2021-03-09,25235,1183786,11579,550195,11935,629610,1721,3981,9836,422042,15383,440322,15410,862364,California
San Diego,2021-03-10,24873,1208659,10388,560583,12127,641737,2358,6339,9767,423058,15091,455413,16107,878471,California
San Diego,2021-03-11,27888,1236547,10680,571263,13721,655458,3487,9826,9638,421859,18228,473641,17029,895500,California
San Diego,2021-03-12,26539,1263086,9243,580506,14203,669661,3093,12919,9572,421170,16953,490594,16264,911764,California
San Diego,2021-03-13,25499,1288585,7082,587588,16676,686337,1741,14660,9814,421140,15677,506271,15647,927411,California
San Diego,2021-03-14,13338,1301923,5302,592890,7313,693650,723,15383,4625,420044,8702,514973,7606,935017,California
San Diego,2021-03-15,21306,1323229,9833,602723,10690,704340,783,16166,8681,419943,12598,527571,12497,947514,California
San Diego,2021-03-16,29134,1352363,15301,618024,13420,717760,413,16579,15323,424851,13785,541356,18693,966207,California
San Diego,2021-03-17,26103,1378466,11983,630007,13403,731163,717,17296,16701,434915,9385,550741,19449,985656,California
San Diego,2021-03-18,30835,1409301,17316,647323,12597,743760,922,18218,16748,440021,14052,564793,19158,1004814,California
San Diego,2021-03-19,29812,1439113,14131,661454,14631,758391,1050,19268,19161,450775,10629,575422,21383,1026197,California
San Diego,2021-03-20,27380,1466493,8295,669749,17312,775703,1773,21041,21176,468595,6189,581611,24009,1050206,California
San Diego,2021-03-21,16104,1482597,11732,681481,3678,779381,694,21735,7539,469594,8550,590161,9549,1059755,California
San Diego,2021-03-22,22151,1504748,12857,694338,9010,788391,284,22019,14108,478702,8031,598192,17139,1076894,California
San Diego,2021-03-23,25359,1530107,13235,707573,11838,800229,286,22305,16811,489282,8540,606732,19120,1096014,California
San Diego,2021-03-24,28937,1559044,19357,726930,9194,809423,386,22691,16749,496258,12174,618906,19150,1115164,California
San Diego,2021-03-25,29815,1588859,17931,744861,11204,820627,680,23371,17684,504613,12108,631014,20463,1135627,California
San Diego,2021-03-26,31442,1620301,17629,762490,13300,833927,513,23884,17172,510852,14241,645255,20480,1156107,California
San Diego,2021-03-27,24990,1645291,10869,773359,13742,847669,379,24263,15408,519318,9561,654816,18027,1174134,California
San Diego,2021-03-28,14928,1660219,9248,782607,5628,853297,52,24315,9155,524403,5767,660583,10852,1184986,California
San Diego,2021-03-29,26203,1686422,12650,795257,12923,866220,630,24945,16150,533570,10042,670625,19209,1204195,California
San Diego,2021-03-30,32574,1718996,17595,812852,14254,880474,725,25670,21649,546858,10908,681533,24196,1228391,California
San Diego,2021-03-31,29790,1748786,18476,831328,10610,891084,704,26374,20266,559431,9506,691039,22079,1250470,California
San Diego,2021-04-01,33704,1782490,19735,851063,12489,903573,1480,27854,22881,574298,10800,701839,25667,1276137,California
San Diego,2021-04-02,35148,1817638,20382,871445,11988,915561,2778,30632,23746,590870,11381,713220,27953,1304090,California
San Diego,2021-04-03,30383,1848021,14242,885687,11534,927095,4607,35239,19383,605070,10987,724207,25187,1329277,California
San Diego,2021-04-04,8690,1856711,5011,890698,2763,929858,916,36155,4634,606738,4050,728257,5718,1334995,California
San Diego,2021-04-05,29346,1886057,15196,905894,11445,941303,2705,38860,19078,620740,10250,738507,24252,1359247,California
San Diego,2021-04-06,38170,1924227,20080,925974,12215,953518,5875,44735,21985,634537,16165,754672,29962,1389209,California
San Diego,2021-04-07,35660,1959887,21731,947705,9401,962919,4528,49263,20077,644792,15552,770224,25807,1415016,California
San Diego,2021-04-08,34755,1994642,21137,968842,9518,972437,4100,53363,20995,658706,13739,783963,27653,1442669,California
San Diego,2021-04-09,37784,2032426,22535,991377,10081,982518,5168,58531,20400,670206,17350,801313,28850,1471519,California
San Diego,2021-04-10,28784,2061210,11593,1002970,13208,995726,3983,62514,14836,678099,13937,815250,21830,1493349,California
San Diego,2021-04-11,15947,2077157,9857,1012827,3815,999541,2275,64789,7051,681535,8893,824143,12329,1505678,California
San Diego,2021-04-12,30329,2107486,12660,1025487,13396,1012937,4273,69062,16859,692877,13451,837594,24793,1530471,California
San Diego,2021-04-13,36534,2144020,17479,1042966,19020,1031957,35,69097,24267,707764,12243,849837,27130,1557601,California
San Diego,2021-04-14,32496,2176516,18676,1061642,13807,1045764,13,69110,17476,714582,15003,864840,21821,1579422,California
San Diego,2021-04-15,39024,2215540,20227,1081869,18787,1064551,10,69120,23622,725719,15372,880212,26509,1605931,California
San Diego,2021-04-16,33300,2248840,18305,1100174,14992,1079543,3,69123,19250,733355,13988,894200,21624,1627555,California
San Diego,2021-04-17,27655,2276495,13419,1113593,14236,1093779,0,69123,12171,733207,15388,909588,15240,1642795,California
San Diego,2021-04-18,14527,2291022,9031,1122624,5492,1099271,4,69127,6706,735081,7807,917395,9681,1652476,California
San Diego,2021-04-19,26308,2317330,13424,1136048,12882,1112153,2,69129,12292,735103,13991,931386,14013,1666489,California
San Diego,2021-04-20,39355,2356685,18258,1154306,21094,1133247,3,69132,20044,738825,19279,950665,23001,1689490,California
San Diego,2021-04-21,36083,2392768,21881,1176187,14201,1147448,1,69133,17318,740724,18719,969384,20618,1710108,California
San Diego,2021-04-22,44685,2437453,23186,1199373,21495,1168943,4,69137,22353,743830,22289,991673,25395,1735503,California
San Diego,2021-04-23,42349,2479802,26339,1225712,16006,1184949,4,69141,15813,736329,26495,1018168,18994,1754497,California
San Diego,2021-04-24,34729,2514531,18826,1244538,15888,1200837,15,69156,15460,735758,19223,1037391,18652,1773149,California
San Diego,2021-04-25,12469,2527000,7599,1252137,4869,1205706,1,69157,5764,736224,6694,1044085,7160,1780309,California
San Diego,2021-04-26,33175,2560175,16660,1268797,16379,1222085,136,69293,11578,730767,21572,1065657,16115,1796424,California
San Diego,2021-04-27,44428,2604603,24482,1293279,19405,1241490,541,69834,19528,729058,24847,1090504,23138,1819562,California
San Diego,2021-04-28,38049,2642652,22672,1315951,14716,1256206,661,70495,17172,728306,20828,1111332,20076,1839638,California
San Diego,2021-04-29,37953,2680605,24278,1340229,13030,1269236,645,71140,15354,723459,22557,1133889,17710,1857348,California
San Diego,2021-04-30,37934,2718539,23070,1363299,13793,1283029,1071,72211,14849,718185,23044,1156933,17770,1875118,California
San Diego,2021-05-01,23959,2742498,10552,1373851,12779,1295808,628,72839,9334,715692,14614,1171547,12121,1887239,California
San Diego,2021-05-02,10450,2752948,7356,1381207,2519,1298327,575,73414,3160,712465,7285,1178832,4058,1891297,California
San Diego,2021-05-03,25004,2777952,12335,1393542,11531,1309858,1138,74552,9140,707711,15843,1194675,11089,1902386,California
San Diego,2021-05-04,31756,2809708,17689,1411231,12809,1322667,1258,75810,11396,701131,20333,1215008,13753,1916139,California
San Diego,2021-05-05,27693,2837401,17131,1428362,9308,1331975,1254,77064,10451,696644,17213,1232221,12726,1928865,California
San Diego,2021-05-06,28252,2865653,18833,1447195,8524,1340499,895,77959,10605,692967,17616,1249837,13939,1942804,California
San Diego,2021-05-07,29444,2895097,19326,1466521,9107,1349606,1011,78970,10885,687546,18523,1268360,13102,1955906,California
San Diego,2021-05-08,22922,2918019,11025,1477546,11175,1360781,722,79692,7147,681102,15747,1284107,9303,1965209,California
San Diego,2021-05-09,7650,2925669,5590,1483136,1654,1362435,406,80098,2524,679334,5120,1289227,3352,1968561,California
San Diego,2021-05-10,21578,2947247,8573,1491709,12201,1374636,804,80902,5782,671424,15769,1304996,7859,1976420,California
San Diego,2021-05-11,28610,2975857,12157,1503866,15653,1390289,800,81702,10006,665375,18574,1323570,12525,1988945,California
San Diego,2021-05-12,22841,2998698,12543,1516409,9445,1399734,853,82555,8176,660909,14629,1338199,10163,1999108,California
San Diego,2021-05-13,31237,3029935,18966,1535375,11637,1411371,634,83189,12892,658745,18291,1356490,16127,2015235,California
San Diego,2021-05-14,30656,3060591,19691,1555066,10131,1421502,834,84023,13878,658806,16735,1373225,16796,2032031,California
San Diego,2021-05-15,26020,3086611,16381,1571447,8829,1430331,810,84833,10728,656073,15242,1388467,12509,2044540,California
San Diego,2021-05-16,13610,3100221,10170,1581617,2880,1433211,560,85393,6678,656787,6920,1395387,7634,2052174,California
San Diego,2021-05-17,21181,3121402,12860,1594477,7588,1440799,733,86126,8741,654729,12402,1407789,10344,2062518,California
San Diego,2021-05-18,33935,3155337,19241,1613718,13840,1454639,854,86980,13132,649382,20774,1428563,15427,2077945,California
San Diego,2021-05-19,28052,3183389,17662,1631380,9619,1464258,771,87751,11793,646845,16226,1444789,13689,2091634,California
San Diego,2021-05-20,34535,3217924,19097,1650477,14627,1478885,811,88562,11551,637794,22950,1467739,13899,2105533,California
San Diego,2021-05-21,26757,3244681,17019,1667496,8761,1487646,977,89539,10735,634754,15988,1483727,12948,2118481,California
San Diego,2021-05-22,21318,3265999,12279,1679775,7808,1495454,1231,90770,8867,633561,12427,1496154,11234,2129715,California
San Diego,2021-05-23,7240,3273239,5191,1684966,1745,1497199,304,91074,3433,633898,3783,1499937,4120,2133835,California
San Diego,2021-05-24,17625,3290864,9036,1694002,6685,1503884,1904,92978,6304,631650,11302,1511239,9054,2142889,California
San Diego,2021-05-25,24131,3314995,12995,1706997,9273,1513157,1863,94841,8352,627284,15749,1526988,11383,2154272,California
San Diego,2021-05-26,18911,3333906,10501,1717498,6409,1519566,2001,96842,6491,624246,12391,1539379,9353,2163625,California
San Diego,2021-05-27,20440,3354346,11852,1729350,6204,1525770,2384,99226,6863,621037,13556,1552935,10347,2173972,California
San Diego,2021-05-28,21045,3375391,13075,1742425,7264,1533034,706,99932,8254,618360,12773,1565708,10096,2184068,California
San Diego,2021-05-29,11847,3387238,7500,1749925,3863,1536897,484,100416,5053,617636,6780,1572488,6056,2190124,California
San Diego,2021-05-30,4579,3391817,3145,1753070,1059,1537956,375,100791,1952,617566,2621,1575109,2551,2192675,California
San Diego,2021-05-31,2528,3394345,1715,1754785,647,1538603,166,100957,824,616983,1698,1576807,1115,2193790,California
San Diego,2021-06-01,21045,3415390,11228,1766013,8198,1546801,1619,102576,5671,609855,15347,1592154,8219,2202009,California
San Diego,2021-06-02,16879,3432269,8729,1774742,6080,1552881,2070,104646,5368,606566,11481,1603635,8192,2210201,California
San Diego,2021-06-03,19016,3451285,11908,1786650,5313,1558194,1795,106441,5079,600563,13916,1617551,7913,2218114,California
San Diego,2021-06-04,19614,3470899,13740,1800390,5264,1563458,610,107051,5629,594733,13953,1631504,8123,2226237,California
San Diego,2021-06-05,15652,3486551,11942,1812332,2939,1566397,771,107822,4399,589649,11237,1642741,6153,2232390,California
San Diego,2021-06-06,5524,3492075,4481,1816813,735,1567132,308,108130,1534,588333,3979,1646720,2663,2235053,California
San Diego,2021-06-07,12635,3504710,7957,1824770,3336,1570468,1342,109472,3448,584713,9169,1655889,5549,2240602,California
San Diego,2021-06-08,20272,3524982,14358,1839128,4039,1574507,1875,111347,4887,577162,15374,1671263,7823,2248425,California
San Diego,2021-06-09,16830,3541812,11202,1850330,3678,1578185,1950,113297,4240,571736,12573,1683836,7147,2255572,California
San Diego,2021-06-10,17661,3559473,11750,1862080,3838,1582023,2073,115370,4236,565738,13401,1697237,7403,2262975,California
San Diego,2021-06-11,15672,3575145,9994,1872074,4329,1586352,1349,116719,4233,560845,11412,1708649,6519,2269494,California
San Diego,2021-06-12,10873,3586018,8346,1880420,2109,1588461,418,117137,3082,557226,7774,1716423,4155,2273649,California
San Diego,2021-06-13,4097,3590115,3079,1883499,816,1589277,202,117339,974,555686,3117,1719540,1577,2275226,California
San Diego,2021-06-14,12478,3602593,7490,1890989,2804,1592081,2184,119523,3480,553033,8983,1728523,6330,2281556,California
San Diego,2021-06-15,17692,3620285,10136,1901125,4130,1596211,3426,122949,4587,548885,13095,1741618,8947,2290503,California
San Diego,2021-06-16,13748,3634033,8739,1909864,2703,1598914,2306,125255,4323,546900,9412,1751030,7427,2297930,California
San Diego,2021-06-17,14687,3648720,8420,1918284,3426,1602340,2841,128096,4114,543965,10560,1761590,7625,2305555,California
San Diego,2021-06-18,14029,3662749,8668,1926952,3538,1605878,1823,129919,4328,541236,9691,1771281,6962,2312517,California
San Diego,2021-06-19,7485,3670234,5533,1932485,1495,1607373,457,130376,2690,540167,4776,1776057,3707,2316224,California
San Diego,2021-06-20,3045,3673279,2218,1934703,633,1608006,194,130570,1112,539770,1928,1777985,1531,2317755,California
San Diego,2021-06-21,9019,3682298,5090,1939793,2384,1610390,1545,132115,3813,540482,5197,1783182,5909,2323664,California
San Diego,2021-06-22,11131,3693429,7475,1947268,2531,1612921,1125,133240,4339,539866,6784,1789966,6168,2329832,California
San Diego,2021-06-23,10651,3704080,6919,1954187,2274,1615195,1458,134698,4297,539930,6346,1796312,6410,2336242,California
San Diego,2021-06-24,9901,3713981,6425,1960612,2693,1617888,783,135481,3939,539321,5954,1802266,5345,2341587,California
San Diego,2021-06-25,10446,3724427,7274,1967886,2573,1620461,599,136080,4005,538131,6431,1808697,5241,2346828,California
San Diego,2021-06-26,6597,3731024,5184,1973070,1109,1621570,304,136384,2587,537619,3997,1812694,3485,2350313,California
San Diego,2021-06-27,2945,3733969,2255,1975325,483,1622053,207,136591,1283,537695,1659,1814353,1735,2352048,California
San Diego,2021-06-28,7101,3741070,5234,1980559,1357,1623410,510,137101,3282,538175,3813,1818166,4293,2356341,California
San Diego,2021-06-29,8649,3749719,6026,1986585,1951,1625361,672,137773,3556,537928,5080,1823246,4833,2361174,California
San Diego,2021-06-30,8089,3757808,5959,1992544,1607,1626968,523,138296,3457,537887,4618,1827864,4577,2365751,California
San Diego,2021-07-01,7193,3765001,4969,1997513,1823,1628791,401,138697,3078,537823,4104,1831968,4040,2369791,California
San Diego,2021-07-02,7463,3772464,5148,2002661,1899,1630690,416,139113,3138,537628,4307,1836275,4112,2373903,California
San Diego,2021-07-03,4086,3776550,3077,2005738,839,1631529,170,139283,1826,537706,2254,1838529,2332,2376235,California
San Diego,2021-07-04,412,3776962,275,2006013,55,1631584,82,139365,150,537732,262,1838791,288,2376523,California
San Diego,2021-07-05,3913,3780875,2810,2008823,815,1632399,288,139653,1802,538017,2106,1840897,2391,2378914,California
San Diego,2021-07-06,8319,3789194,6167,2014990,1755,1634154,397,140050,3053,536857,5259,1846156,4099,2383013,California
San Diego,2021-07-07,7520,3796714,5560,2020550,1457,1635611,503,140553,3025,536533,4484,1850640,4160,2387173,California
San Diego,2021-07-08,6839,3803553,4866,2025416,1494,1637105,479,141032,2771,536264,4048,1854688,3779,2390952,California
San Diego,2021-07-09,7394,3810947,4995,2030411,1873,1638978,526,141558,2994,535968,4380,1859068,4084,2395036,California
San Diego,2021-07-10,4695,3815642,3554,2033965,847,1639825,294,141852,2002,535958,2687,1861755,2677,2397713,California
San Diego,2021-07-11,2133,3817775,1579,2035544,378,1640203,176,142028,948,536046,1182,1862937,1270,2398983,California
San Diego,2021-07-12,6471,3824246,4673,2040217,1355,1641558,443,142471,2568,535673,3890,1866827,3517,2402500,California
San Diego,2021-07-13,7252,3831498,5370,2045587,1517,1643075,365,142836,3068,535432,4170,1870997,3929,2406429,California
San Diego,2021-07-14,6860,3838358,5096,2050683,1374,1644449,390,143226,2883,535252,3962,1874959,3782,2410211,California
San Diego,2021-07-15,6742,3845100,5068,2055751,1352,1645801,322,143548,2925,535197,3797,1878756,3742,2413953,California
San Diego,2021-07-16,7267,3852367,5111,2060862,1788,1647589,368,143916,3268,535340,3992,1882748,4135,2418088,California
San Diego,2021-07-17,4464,3856831,3310,2064172,936,1648525,218,144134,2044,535485,2413,1885161,2558,2420646,California
San Diego,2021-07-18,2415,3859246,1774,2065946,474,1648999,167,144301,1101,535591,1310,1886471,1416,2422062,California
San Diego,2021-07-19,6143,3865389,4501,2070447,1297,1650296,345,144646,2861,536009,3274,1889745,3692,2425754,California
San Diego,2021-07-20,7498,3872887,5433,2075880,1644,1651940,421,145067,3579,536612,3906,1893651,4509,2430263,California
San Diego,2021-07-21,6973,3879860,5113,2080993,1471,1653411,389,145456,3223,536955,3739,1897390,4082,2434345,California
San Diego,2021-07-22,6759,3886619,4894,2085887,1528,1654939,337,145793,3473,537918,3273,1900663,4236,2438581,California
San Diego,2021-07-23,7661,3894280,5578,2091465,1748,1656687,335,146128,4058,539187,3593,1904256,4862,2443443,California
San Diego,2021-07-24,4771,3899051,3469,2094934,1115,1657802,187,146315,2710,540266,2054,1906310,3133,2446576,California
San Diego,2021-07-25,2446,3901497,1766,2096700,510,1658312,170,146485,1681,541480,764,1907074,1978,2448554,California
San Diego,2021-07-26,6330,3907827,4455,2101155,1468,1659780,407,146892,3778,543469,2544,1909618,4533,2453087,California
San Diego,2021-07-27,7556,3915383,5476,2106631,1691,1661471,389,147281,4237,545151,3309,1912927,4991,2458078,California
San Diego,2021-07-28,7544,3922927,5592,2112223,1532,1663003,420,147701,4381,547202,3154,1916081,5205,2463283,California
San Diego,2021-07-29,6966,3929893,5149,2117372,1470,1664473,347,148048,4076,549136,2879,1918960,4813,2468096,California
San Diego,2021-07-30,7834,3937727,5487,2122859,1977,1666450,370,148418,4677,551517,3146,1922106,5527,2473623,California
San Diego,2021-07-31,2172,3939899,1686,2124545,264,1666714,222,148640,1290,552343,880,1922986,1706,2475329,California
San Francisco,2020-12-15,9,9,9,9,0,0,0,0,9,9,0,0,9,9,California
San Francisco,2020-12-16,230,239,230,239,0,0,0,0,230,239,0,0,230,239,California
San Francisco,2020-12-17,417,656,417,656,0,0,0,0,417,656,0,0,417,656,California
San Francisco,2020-12-18,910,1566,909,1565,1,1,0,0,910,1566,0,0,910,1566,California
San Francisco,2020-12-19,611,2177,611,2176,0,1,0,0,611,2177,0,0,611,2177,California
San Francisco,2020-12-20,481,2658,481,2657,0,1,0,0,481,2658,0,0,481,2658,California
San Francisco,2020-12-21,1164,3822,1164,3821,0,1,0,0,1164,3822,0,0,1164,3822,California
San Francisco,2020-12-22,1404,5226,1368,5189,36,37,0,0,1404,5226,0,0,1404,5226,California
San Francisco,2020-12-23,1364,6590,1059,6248,305,342,0,0,1364,6590,0,0,1364,6590,California
San Francisco,2020-12-24,847,7437,500,6748,347,689,0,0,847,7437,0,0,847,7437,California
San Francisco,2020-12-25,36,7473,29,6777,7,696,0,0,36,7473,0,0,36,7473,California
San Francisco,2020-12-26,248,7721,150,6927,98,794,0,0,248,7721,0,0,248,7721,California
San Francisco,2020-12-27,272,7993,57,6984,215,1009,0,0,272,7993,0,0,272,7993,California
San Francisco,2020-12-28,1288,9281,696,7680,592,1601,0,0,1288,9281,0,0,1288,9281,California
San Francisco,2020-12-29,1263,10544,629,8309,634,2235,0,0,1263,10544,0,0,1263,10544,California
San Francisco,2020-12-30,1487,12031,777,9086,710,2945,0,0,1487,12031,0,0,1487,12031,California
San Francisco,2020-12-31,988,13019,417,9503,571,3516,0,0,988,13019,0,0,988,13019,California
San Francisco,2021-01-01,112,13131,82,9585,30,3546,0,0,112,13131,0,0,112,13131,California
San Francisco,2021-01-02,346,13477,309,9894,37,3583,0,0,346,13477,0,0,346,13477,California
San Francisco,2021-01-03,297,13774,105,9999,192,3775,0,0,296,13772,1,1,296,13773,California
San Francisco,2021-01-04,1852,15626,1361,11360,491,4266,0,0,1849,15618,3,4,1849,15622,California
San Francisco,2021-01-05,2238,17864,1425,12785,813,5079,0,0,2200,17782,38,42,2202,17824,California
San Francisco,2021-01-06,1885,19749,1171,13956,714,5793,0,0,1610,19120,273,315,1611,19435,California
San Francisco,2021-01-07,2087,21836,1216,15172,871,6664,0,0,1610,20257,473,788,1610,21045,California
San Francisco,2021-01-08,2345,24181,1647,16819,698,7362,0,0,1480,20878,860,1648,1481,22526,California
San Francisco,2021-01-09,1409,25590,910,17729,499,7861,0,0,891,21253,518,2166,893,23419,California
San Francisco,2021-01-10,923,26513,539,18268,384,8245,0,0,468,21267,454,2620,468,23887,California
San Francisco,2021-01-11,2511,29024,1863,20131,648,8893,0,0,1413,21582,1099,3719,1414,25301,California
San Francisco,2021-01-12,3122,32146,2087,22218,1035,9928,0,0,1904,22270,1218,4937,1906,27207,California
San Francisco,2021-01-13,2862,35008,1625,23843,1237,11165,0,0,2016,23440,846,5783,2016,29223,California
San Francisco,2021-01-14,2475,37483,1113,24956,1362,12527,0,0,1910,24785,565,6348,1910,31133,California
San Francisco,2021-01-15,2759,40242,1151,26107,1608,14135,0,0,2371,26772,386,6734,2373,33506,California
San Francisco,2021-01-16,2242,42484,930,27037,1312,15447,0,0,2077,28686,165,6899,2079,35585,California
San Francisco,2021-01-17,1945,44429,530,27567,1415,16862,0,0,1725,30192,219,7118,1725,37310,California
San Francisco,2021-01-18,1400,45829,611,28178,789,17651,0,0,1128,31050,271,7389,1129,38439,California
San Francisco,2021-01-19,2601,48430,1484,29662,1117,18768,0,0,1844,32137,757,8146,1844,40283,California
San Francisco,2021-01-20,2856,51286,1199,30861,1657,20425,0,0,2085,33454,769,8915,2086,42369,California
San Francisco,2021-01-21,3454,54740,1035,31896,2419,22844,0,0,2577,35155,876,9791,2577,44946,California
San Francisco,2021-01-22,3268,58008,680,32576,2588,25432,0,0,2817,37522,450,10241,2817,47763,California
San Francisco,2021-01-23,3135,61143,616,33192,2519,27951,0,0,2756,39901,378,10619,2757,50520,California
San Francisco,2021-01-24,2443,63586,362,33554,2081,30032,0,0,2207,41876,232,10851,2207,52727,California
San Francisco,2021-01-25,4668,68254,1845,35399,2823,32855,0,0,3068,43348,1597,12448,3069,55796,California
San Francisco,2021-01-26,4778,73032,2195,37594,2583,35438,0,0,3118,44811,1657,14105,3120,58916,California
San Francisco,2021-01-27,4390,77422,1985,39579,2405,37843,0,0,3083,46589,1305,15410,3083,61999,California
San Francisco,2021-01-28,3813,81235,1577,41156,2236,40079,0,0,2632,48048,1174,16584,2633,64632,California
San Francisco,2021-01-29,4871,86106,1768,42924,3103,43182,0,0,3527,50267,1308,17892,3527,68159,California
San Francisco,2021-01-30,3825,89931,1844,44768,1981,45163,0,0,3355,53157,469,18361,3359,71518,California
San Francisco,2021-01-31,2376,92307,828,45596,1548,46711,0,0,2225,55232,151,18512,2226,73744,California
San Francisco,2021-02-01,4012,96319,1716,47312,2296,49007,0,0,2934,57090,1077,19589,2935,76679,California
San Francisco,2021-02-02,4572,100891,1822,49134,2750,51757,0,0,2960,58443,1607,21196,2960,79639,California
San Francisco,2021-02-03,5133,106024,2404,51538,2729,54486,0,0,3797,60907,1334,22530,3798,83437,California
San Francisco,2021-02-04,5076,111100,2428,53966,2648,57134,0,0,3890,63614,1183,23713,3890,87327,California
San Francisco,2021-02-05,6050,117150,3257,57223,2793,59927,0,0,4676,66919,1372,25085,4677,92004,California
San Francisco,2021-02-06,5474,122624,3648,60871,1826,61753,0,0,4599,70678,843,25928,4602,96606,California
San Francisco,2021-02-07,4391,127015,3233,64104,1158,62911,0,0,3808,73912,579,26507,3813,100419,California
San Francisco,2021-02-08,6833,133848,4714,68818,2119,65030,0,0,5591,78280,1225,27732,5593,106012,California
San Francisco,2021-02-09,6020,139868,4046,72864,1974,67004,0,0,4432,81127,1587,29319,4434,110446,California
San Francisco,2021-02-10,7045,146913,4289,77153,2756,69760,0,0,5154,84405,1881,31200,5159,115605,California
San Francisco,2021-02-11,6873,153786,4092,81245,2781,72541,0,0,4984,87511,1883,33083,4989,120594,California
San Francisco,2021-02-12,5415,159201,2743,83988,2672,75213,0,0,3525,89149,1888,34971,3526,124120,California
San Francisco,2021-02-13,4470,163671,2627,86615,1843,77056,0,0,3101,90885,1369,36340,3105,127225,California
San Francisco,2021-02-14,3490,167161,2297,88912,1193,78249,0,0,2345,92089,1143,37483,2347,129572,California
San Francisco,2021-02-15,2818,169979,1522,90434,1296,79545,0,0,1688,92650,1127,38610,1688,131260,California
San Francisco,2021-02-16,5225,175204,2861,93295,2364,81909,0,0,3057,93553,2161,40771,3064,134324,California
San Francisco,2021-02-17,5434,180638,2667,95962,2767,84676,0,0,2996,94126,2426,43197,2999,137323,California
San Francisco,2021-02-18,5488,186126,2679,98641,2809,87485,0,0,2840,94329,2643,45840,2846,140169,California
San Francisco,2021-02-19,5756,191882,2706,101347,3050,90535,0,0,2980,94545,2765,48605,2981,143150,California
San Francisco,2021-02-20,4677,196559,2267,103614,2410,92945,0,0,1742,93362,2926,51531,1743,144893,California
San Francisco,2021-02-21,3018,199577,1584,105198,1434,94379,0,0,1326,93008,1681,53212,1327,146220,California
San Francisco,2021-02-22,5545,205122,3433,108631,2112,96491,0,0,2759,92995,2775,55987,2762,148982,California
San Francisco,2021-02-23,5981,211103,3384,112015,2597,99088,0,0,3034,93089,2940,58927,3034,152016,California
San Francisco,2021-02-24,9657,220760,5481,117496,4176,103264,0,0,5142,93737,4496,63423,5144,157160,California
San Francisco,2021-02-25,10666,231426,7448,124944,3218,106482,0,0,6818,96714,3843,67266,6820,163980,California
San Francisco,2021-02-26,13087,244513,8495,133439,4592,111074,0,0,7676,98996,5395,72661,7677,171657,California
San Francisco,2021-02-27,9969,254482,6404,139843,3563,114637,2,2,4943,98940,5002,77663,4946,176603,California
San Francisco,2021-02-28,8403,262885,6005,145848,2398,117035,0,2,4106,98758,4289,81952,4107,180710,California
San Francisco,2021-03-01,12019,274904,8090,153938,3924,120959,5,7,5831,98438,6158,88110,5838,186548,California
San Francisco,2021-03-02,10428,285332,7007,160945,3421,124380,0,7,5890,99804,4525,92635,5891,192439,California
San Francisco,2021-03-03,11896,297228,6926,167871,4969,129349,1,8,6459,100851,5416,98051,6463,198902,California
San Francisco,2021-03-04,9114,306342,5702,173573,3412,132761,0,8,5097,101952,3998,102049,5099,204001,California
San Francisco,2021-03-05,9528,315870,5803,179376,3721,136482,4,12,5916,104280,3593,105642,5921,209922,California
San Francisco,2021-03-06,7464,323334,4805,184181,2446,138928,213,225,4627,106267,2844,108486,4831,214753,California
San Francisco,2021-03-07,5608,328942,4283,188464,1168,140096,157,382,3165,107135,2450,110936,3318,218071,California
San Francisco,2021-03-08,7864,336806,5587,194051,2071,142167,206,588,6154,111753,1737,112673,6355,224426,California
San Francisco,2021-03-09,8587,345393,5636,199687,2521,144688,430,1018,6154,115895,2433,115106,6575,231001,California
San Francisco,2021-03-10,11637,357030,6786,206473,4267,148955,584,1602,7130,119111,4483,119589,7699,238700,California
San Francisco,2021-03-11,10294,367324,6427,212900,2820,151775,1047,2649,6691,123237,3579,123168,7705,246405,California
San Francisco,2021-03-12,10971,378295,6391,219291,3216,154991,1364,4013,6111,125853,4835,128003,7451,253856,California
San Francisco,2021-03-13,6799,385094,3960,223251,1754,156745,1085,5098,4222,128588,2565,130568,5300,259156,California
San Francisco,2021-03-14,7607,392701,4942,228193,2408,159153,257,5355,3968,129189,3617,134185,4218,263374,California
San Francisco,2021-03-15,12207,404908,9332,237525,1928,161081,947,6302,8401,134730,3787,137972,9328,272702,California
San Francisco,2021-03-16,12328,417236,8377,245902,3470,164551,481,6783,8745,140399,3557,141529,9226,281928,California
San Francisco,2021-03-17,13739,430975,8515,254417,4580,169131,644,7427,9720,146768,3984,145513,10353,292281,California
San Francisco,2021-03-18,10374,441349,7097,261514,2642,171773,635,8062,5790,148622,4556,150069,6410,298691,California
San Francisco,2021-03-19,12713,454062,9319,270833,2920,174693,474,8536,6492,149383,6192,156261,6953,305644,California
San Francisco,2021-03-20,9078,463140,6689,277522,1916,176609,473,9009,5184,151178,3860,160121,5655,311299,California
San Francisco,2021-03-21,6738,469878,6175,283697,426,177035,137,9146,3682,151955,3035,163156,3812,315111,California
San Francisco,2021-03-22,10070,479948,7026,290723,2195,179230,849,9995,5105,152948,4942,168098,5935,321046,California
San Francisco,2021-03-23,11504,491452,7668,298391,3184,182414,652,10647,6306,154731,5166,173264,6949,327995,California
San Francisco,2021-03-24,12551,504003,9601,307992,2408,184822,542,11189,6101,154956,6404,179668,6629,334624,California
San Francisco,2021-03-25,12142,516145,8857,316849,2715,187537,570,11759,5755,154966,6307,185975,6317,340941,California
San Francisco,2021-03-26,12177,528322,8431,325280,3513,191050,233,11992,5770,154596,6368,192343,5998,346939,California
San Francisco,2021-03-27,8997,537319,5974,331254,2670,193720,353,12345,3774,153532,5187,197530,4123,351062,California
San Francisco,2021-03-28,6725,544044,5359,336613,1324,195044,42,12387,2914,152700,3785,201315,2953,354015,California
San Francisco,2021-03-29,11771,555815,8080,344693,3499,198543,192,12579,4745,150646,6988,208303,4934,358949,California
San Francisco,2021-03-30,11803,567618,7383,352076,4128,202671,292,12871,5496,150153,6277,214580,5784,364733,California
San Francisco,2021-03-31,12424,580042,8267,360343,3858,206529,299,13170,4888,147834,7499,222079,5180,369913,California
San Francisco,2021-04-01,14114,594156,7474,367817,4922,211451,1718,14888,6055,147526,8016,230095,7708,377621,California
San Francisco,2021-04-02,15001,609157,6618,374435,6484,217935,1899,16787,6991,148380,7983,238078,8837,386458,California
San Francisco,2021-04-03,10667,619824,4957,379392,3873,221808,1837,18624,4828,149188,5816,243894,6624,393082,California
San Francisco,2021-04-04,9088,628912,4828,384220,2597,224405,1663,20287,3619,148981,5450,249344,5243,398325,California
San Francisco,2021-04-05,16218,645130,9902,394122,4421,228826,1895,22182,6262,147175,9922,259266,8116,406441,California
San Francisco,2021-04-06,16238,661368,9579,403701,4578,233404,2081,24263,6250,145504,9955,269221,8284,414725,California
San Francisco,2021-04-07,16996,678364,10116,413817,4627,238031,2253,26516,6987,144720,9982,279203,9198,423923,California
San Francisco,2021-04-08,14329,692693,6811,420628,3058,241089,4460,30976,4706,144215,9579,288782,9074,432997,California
San Francisco,2021-04-09,15979,708672,7720,428348,4870,245959,3389,34365,6657,144929,9282,298064,9996,442993,California
San Francisco,2021-04-10,13426,722098,5732,434080,5912,251871,1782,36147,7133,147548,6261,304325,8880,451873,California
San Francisco,2021-04-11,10101,732199,7558,441638,1354,253225,1189,37336,5216,149064,4868,309193,6384,458257,California
San Francisco,2021-04-12,10723,742922,6960,448598,2603,255828,1160,38496,4922,149361,5773,314966,6070,464327,California
San Francisco,2021-04-13,10928,753850,7407,456005,3507,259335,14,38510,5478,149440,5418,320384,5497,469824,California
San Francisco,2021-04-14,13444,767294,8090,464095,5353,264688,1,38511,6331,148705,7070,327454,6335,476159,California
San Francisco,2021-04-15,13927,781221,9614,473709,4312,269000,1,38512,8031,150884,5859,333313,8038,484197,California
San Francisco,2021-04-16,13158,794379,8826,482535,4288,273288,44,38556,7634,153077,5491,338804,7684,491881,California
San Francisco,2021-04-17,10277,804656,7398,489933,2878,276166,1,38557,7209,157242,3049,341853,7214,499095,California
San Francisco,2021-04-18,6968,811624,5388,495321,1578,277744,2,38559,4316,158930,2632,344485,4320,503415,California
San Francisco,2021-04-19,11148,822772,8326,503647,2816,280560,6,38565,7069,161960,4055,348540,7085,510500,California
San Francisco,2021-04-20,13145,835917,7888,511535,5255,285815,2,38567,8892,166636,4219,352759,8895,519395,California
San Francisco,2021-04-21,12081,847998,8855,520390,3221,289036,5,38572,7280,169156,4771,357530,7291,526686,California
San Francisco,2021-04-22,11243,859241,8373,528763,2869,291905,1,38573,6434,170827,4771,362301,6442,533128,California
San Francisco,2021-04-23,11060,870301,6481,535244,4579,296484,0,38573,6545,172904,4477,366778,6554,539682,California
San Francisco,2021-04-24,8104,878405,5552,540796,2552,299036,0,38573,4771,174374,3310,370088,4780,544462,California
San Francisco,2021-04-25,5115,883520,4394,545190,715,299751,6,38579,2981,175248,2118,372206,2992,547454,California
San Francisco,2021-04-26,8638,892158,6150,551340,2475,302226,13,38592,4299,175272,4304,376510,4328,551782,California
San Francisco,2021-04-27,9074,901232,6163,557503,2740,304966,171,38763,4518,175447,4523,381033,4698,556480,California
San Francisco,2021-04-28,10045,911277,7029,564532,2823,307789,193,38956,5255,176146,4755,385788,5454,561934,California
San Francisco,2021-04-29,9940,921217,5915,570447,3826,311615,199,39155,4884,176220,5024,390812,5098,567032,California
San Francisco,2021-04-30,11487,932704,5681,576128,5600,317215,206,39361,4272,173539,7165,397977,4484,571516,California
San Francisco,2021-05-01,7071,939775,3624,579752,3329,320544,118,39479,1731,170089,5301,403278,1851,573367,California
San Francisco,2021-05-02,5393,945168,3123,582875,2171,322715,99,39578,1000,166812,4381,407659,1104,574471,California
San Francisco,2021-05-03,9914,955082,6784,589659,2964,325679,166,39744,2489,162082,7394,415053,2664,577135,California
San Francisco,2021-05-04,9960,965042,6514,596173,3194,328873,252,39996,2418,157255,7503,422556,2676,579811,California
San Francisco,2021-05-05,9367,974409,6636,602809,2417,331290,314,40310,2313,152881,7006,429562,2632,582443,California
San Francisco,2021-05-06,11136,985545,8921,611730,1738,333028,477,40787,1935,146136,9160,438722,2415,584858,California
San Francisco,2021-05-07,10399,995944,6732,618462,3395,336423,272,41059,1704,139449,8663,447385,1976,586834,California
San Francisco,2021-05-08,9028,1004972,4134,622596,4765,341188,129,41188,1116,132817,7879,455264,1247,588081,California
San Francisco,2021-05-09,6759,1011731,5862,628458,813,342001,84,41272,1086,128332,5649,460913,1164,589245,California
San Francisco,2021-05-10,7482,1019213,5392,633850,1832,343833,258,41530,1017,123177,6429,467342,1274,590519,California
San Francisco,2021-05-11,8314,1027527,6145,639995,1946,345779,223,41753,1494,118115,6778,474120,1716,592235,California
San Francisco,2021-05-12,8474,1036001,6220,646215,1796,347575,458,42211,1504,113139,6934,481054,1958,594193,California
San Francisco,2021-05-13,11476,1047477,8432,654647,2818,350393,226,42437,4180,110293,7260,488314,4414,598607,California
San Francisco,2021-05-14,9656,1057133,6859,661506,2622,353015,175,42612,2994,106850,6621,494935,3178,601785,California
San Francisco,2021-05-15,8182,1065315,6484,667990,1642,354657,56,42668,3218,105189,4946,499881,3285,605070,California
San Francisco,2021-05-16,5315,1070630,4472,672462,783,355440,60,42728,2020,103998,3272,503153,2081,607151,California
San Francisco,2021-05-17,7444,1078074,5539,678001,1740,357180,165,42893,2381,101506,5042,508195,2550,609701,California
San Francisco,2021-05-18,8792,1086866,5043,683044,3574,360754,175,43068,1831,96600,6913,515108,2007,611708,California
San Francisco,2021-05-19,7527,1094393,5561,688605,1730,362484,236,43304,2149,93633,5351,520459,2384,614092,California
San Francisco,2021-05-20,6251,1100644,4197,692802,1801,364285,253,43557,1522,90711,4692,525151,1770,615862,California
San Francisco,2021-05-21,7236,1107880,4097,696899,2954,367239,185,43742,1581,86865,5607,530758,1761,617623,California
San Francisco,2021-05-22,4859,1112739,3660,700559,1108,368347,91,43833,2200,86517,2638,533396,2290,619913,California
San Francisco,2021-05-23,1958,1114697,1499,702058,384,368731,75,43908,853,86351,1094,534490,928,620841,California
San Francisco,2021-05-24,4247,1118944,3010,705068,1075,369806,162,44070,1222,84741,2997,537487,1387,622228,California
San Francisco,2021-05-25,3718,1122662,2417,707485,1077,370883,224,44294,1032,83328,2662,540149,1249,623477,California
San Francisco,2021-05-26,3992,1126654,2571,710056,1275,372158,146,44440,1059,81625,2909,543058,1206,624683,California
San Francisco,2021-05-27,3746,1130400,2162,712218,1407,373565,177,44617,1172,80413,2561,545619,1349,626032,California
San Francisco,2021-05-28,3795,1134195,2161,714379,1472,375037,162,44779,1313,79438,2449,548068,1474,627506,California
San Francisco,2021-05-29,2045,1136240,1473,715852,469,375506,103,44882,792,79096,1231,549299,889,628395,California
San Francisco,2021-05-30,986,1137226,701,716553,248,375754,37,44919,396,78948,581,549880,433,628828,California
San Francisco,2021-05-31,263,1137489,213,716766,43,375797,7,44926,89,78874,170,550050,96,628924,California
San Francisco,2021-06-01,3598,1141087,2173,718939,1236,377033,189,45115,1066,77613,2514,552564,1253,630177,California
San Francisco,2021-06-02,2475,1143562,1788,720727,564,377597,123,45238,812,76896,1647,554211,930,631107,California
San Francisco,2021-06-03,3980,1147542,2727,723454,1049,378646,204,45442,918,74973,3041,557252,1118,632225,California
San Francisco,2021-06-04,5740,1153282,4861,728315,744,379390,135,45577,1240,71879,4466,561718,1372,633597,California
San Francisco,2021-06-05,3756,1157038,3174,731489,434,379824,148,45725,875,70030,2868,564586,1019,634616,California
San Francisco,2021-06-06,2342,1159380,2191,733680,113,379937,38,45763,391,68514,1945,566531,429,635045,California
San Francisco,2021-06-07,3664,1163044,3031,736711,494,380431,139,45902,874,66755,2769,569300,1010,636055,California
San Francisco,2021-06-08,2839,1165883,2231,738942,440,380871,168,46070,798,65693,2022,571322,960,637015,California
San Francisco,2021-06-09,2325,1168208,1861,740803,325,381196,139,46209,655,64829,1656,572978,792,637807,California
San Francisco,2021-06-10,2517,1170725,1922,742725,401,381597,194,46403,744,64008,1760,574738,939,638746,California
San Francisco,2021-06-11,3166,1173891,2499,745224,502,382099,165,46568,927,62883,2214,576952,1089,639835,California
San Francisco,2021-06-12,3035,1176926,2634,747858,273,382372,128,46696,712,61410,2310,579262,837,640672,California
San Francisco,2021-06-13,928,1177854,805,748663,76,382448,47,46743,222,60979,699,579961,268,640940,California
San Francisco,2021-06-14,2515,1180369,2033,750696,331,382779,151,46894,830,60286,1671,581632,978,641918,California
San Francisco,2021-06-15,1928,1182297,1486,752182,307,383086,135,47029,681,59867,1235,582867,816,642734,California
San Francisco,2021-06-16,1885,1184182,1426,753608,262,383348,197,47226,643,59475,1225,584092,833,643567,California
San Francisco,2021-06-17,2002,1186184,1540,755148,260,383608,202,47428,639,58962,1349,585441,836,644403,California
San Francisco,2021-06-18,2356,1188540,1740,756888,441,384049,175,47603,750,58292,1590,587031,920,645323,California
San Francisco,2021-06-19,1423,1189963,1185,758073,126,384175,112,47715,435,57860,975,588006,543,645866,California
San Francisco,2021-06-20,627,1190590,537,758610,56,384231,34,47749,255,57784,365,588371,289,646155,California
San Francisco,2021-06-21,1164,1191754,864,759474,188,384419,112,47861,598,57939,554,588925,709,646864,California
San Francisco,2021-06-22,1590,1193344,1248,760722,230,384649,112,47973,550,57571,1024,589949,656,647520,California
San Francisco,2021-06-23,1494,1194838,1175,761897,178,384827,141,48114,591,57405,891,590840,725,648245,California
San Francisco,2021-06-24,1542,1196380,1130,763027,244,385071,168,48282,511,57067,1012,591852,674,648919,California
San Francisco,2021-06-25,1838,1198218,1485,764512,251,385322,102,48384,664,56681,1151,593003,765,649684,California
San Francisco,2021-06-26,1403,1199621,1252,765764,66,385388,85,48469,494,56360,898,593901,577,650261,California
San Francisco,2021-06-27,560,1200181,497,766261,35,385423,28,48497,229,56291,325,594226,256,650517,California
San Francisco,2021-06-28,1492,1201673,1282,767543,115,385538,95,48592,532,55969,948,595174,626,651143,California
San Francisco,2021-06-29,1389,1203062,1068,768611,219,385757,102,48694,499,55687,877,596051,595,651738,California
San Francisco,2021-06-30,1291,1204353,1058,769669,164,385921,69,48763,498,55465,787,596838,565,652303,California
San Francisco,2021-07-01,1200,1205553,945,770614,176,386097,79,48842,485,55325,702,597540,562,652865,California
San Francisco,2021-07-02,1530,1207083,1222,771836,236,386333,72,48914,603,55081,917,598457,673,653538,California
San Francisco,2021-07-03,895,1207978,752,772588,71,386404,72,48986,335,54930,555,599012,404,653942,California
San Francisco,2021-07-04,13,1207991,11,772599,1,386405,1,48987,5,54928,8,599020,6,653948,California
San Francisco,2021-07-05,959,1208950,841,773440,73,386478,45,49032,388,54799,561,599581,432,654380,California
San Francisco,2021-07-06,1682,1210632,1395,774835,196,386674,91,49123,547,54318,1115,600696,634,655014,California
San Francisco,2021-07-07,1120,1211752,887,775722,137,386811,96,49219,394,54090,713,601409,485,655499,California
San Francisco,2021-07-08,1134,1212886,880,776602,145,386956,109,49328,410,53894,712,602121,516,656015,California
San Francisco,2021-07-09,1299,1214185,1011,777613,196,387152,92,49420,496,53700,780,602901,586,656601,California
San Francisco,2021-07-10,647,1214832,559,778172,47,387199,41,49461,279,53658,356,603257,314,656915,California
San Francisco,2021-07-11,494,1215326,418,778590,54,387253,22,49483,187,53567,299,603556,208,657123,California
San Francisco,2021-07-12,1290,1216616,1038,779628,167,387420,85,49568,496,53370,777,604333,580,657703,California
San Francisco,2021-07-13,971,1217587,761,780389,134,387554,76,49644,402,53288,556,604889,474,658177,California
San Francisco,2021-07-14,1052,1218639,815,781204,155,387709,82,49726,425,53174,617,605506,503,658680,California
San Francisco,2021-07-15,975,1219614,778,781982,151,387860,46,49772,455,53166,506,606012,498,659178,California
San Francisco,2021-07-16,1184,1220798,946,782928,194,388054,44,49816,545,53130,624,606636,588,659766,California
San Francisco,2021-07-17,806,1221604,733,783661,45,388099,28,49844,347,53059,444,607080,373,660139,California
San Francisco,2021-07-18,409,1222013,347,784008,48,388147,14,49858,192,53054,211,607291,206,660345,California
San Francisco,2021-07-19,1197,1223210,995,785003,136,388283,66,49924,562,53060,618,607909,624,660969,California
San Francisco,2021-07-20,927,1224137,752,785755,102,388385,73,49997,458,53138,451,608360,529,661498,California
San Francisco,2021-07-21,1123,1225260,930,786685,139,388524,54,50051,552,53188,553,608913,603,662101,California
San Francisco,2021-07-22,1042,1226302,840,787525,147,388671,55,50106,497,53211,528,609441,551,662652,California
San Francisco,2021-07-23,1186,1227488,953,788478,170,388841,63,50169,554,53219,608,610049,616,663268,California
San Francisco,2021-07-24,794,1228282,675,789153,78,388919,41,50210,334,53154,438,610487,373,663641,California
San Francisco,2021-07-25,358,1228640,310,789463,42,388961,6,50216,224,53260,123,610610,229,663870,California
San Francisco,2021-07-26,1195,1229835,932,790395,180,389141,83,50299,655,53481,515,611125,736,664606,California
San Francisco,2021-07-27,1117,1230952,907,791302,144,389285,66,50365,580,53606,519,611644,644,665250,California
San Francisco,2021-07-28,1123,1232075,884,792186,164,389449,75,50440,595,53774,496,612140,664,665914,California
San Francisco,2021-07-29,1037,1233112,808,792994,163,389612,66,50506,570,53964,443,612583,633,666547,California
San Francisco,2021-07-30,1174,1234286,936,793930,175,389787,63,50569,590,54080,537,613120,653,667200,California
San Francisco,2021-07-31,462,1234748,382,794312,48,389835,32,50601,255,54170,192,613312,282,667482,California
San Joaquin,2020-12-15,16,16,16,16,0,0,0,0,16,16,0,0,16,16,California
San Joaquin,2020-12-16,467,483,467,483,0,0,0,0,467,483,0,0,467,483,California
San Joaquin,2020-12-17,374,857,374,857,0,0,0,0,374,857,0,0,374,857,California
San Joaquin,2020-12-18,625,1482,617,1474,8,8,0,0,625,1482,0,0,625,1482,California
San Joaquin,2020-12-19,222,1704,218,1692,4,12,0,0,222,1704,0,0,222,1704,California
San Joaquin,2020-12-20,125,1829,123,1815,2,14,0,0,125,1829,0,0,125,1829,California
San Joaquin,2020-12-21,551,2380,547,2362,4,18,0,0,551,2380,0,0,551,2380,California
San Joaquin,2020-12-22,1006,3386,882,3244,124,142,0,0,1005,3385,0,0,1005,3385,California
San Joaquin,2020-12-23,1003,4389,943,4187,60,202,0,0,1001,4386,2,2,1003,4388,California
San Joaquin,2020-12-24,228,4617,198,4385,30,232,0,0,227,4613,1,3,228,4616,California
San Joaquin,2020-12-25,19,4636,19,4404,0,232,0,0,19,4632,0,3,19,4635,California
San Joaquin,2020-12-26,105,4741,33,4437,72,304,0,0,105,4737,0,3,105,4740,California
San Joaquin,2020-12-27,50,4791,36,4473,14,318,0,0,50,4787,0,3,50,4790,California
San Joaquin,2020-12-28,637,5428,430,4903,207,525,0,0,637,5424,0,3,637,5427,California
San Joaquin,2020-12-29,806,6234,674,5577,132,657,0,0,805,6228,1,4,805,6232,California
San Joaquin,2020-12-30,1025,7259,729,6306,296,953,0,0,1023,7251,2,6,1025,7257,California
San Joaquin,2020-12-31,470,7729,207,6513,263,1216,0,0,469,7719,2,8,470,7727,California
San Joaquin,2021-01-01,26,7755,15,6528,11,1227,0,0,26,7745,0,8,26,7753,California
San Joaquin,2021-01-02,273,8028,248,6776,25,1252,0,0,273,8018,0,8,273,8026,California
San Joaquin,2021-01-03,37,8065,20,6796,17,1269,0,0,36,8053,1,9,36,8062,California
San Joaquin,2021-01-04,504,8569,356,7152,148,1417,0,0,502,8554,1,10,502,8564,California
San Joaquin,2021-01-05,1086,9655,719,7871,367,1784,0,0,835,9178,249,259,873,9437,California
San Joaquin,2021-01-06,1319,10974,789,8660,530,2314,0,0,950,9770,362,621,954,10391,California
San Joaquin,2021-01-07,1167,12141,759,9419,408,2722,0,0,805,10219,356,977,805,11196,California
San Joaquin,2021-01-08,1377,13518,971,10390,406,3128,0,0,790,10433,583,1560,797,11993,California
San Joaquin,2021-01-09,388,13906,305,10695,83,3211,0,0,252,10551,136,1696,254,12247,California
San Joaquin,2021-01-10,232,14138,122,10817,110,3321,0,0,174,10668,57,1753,174,12421,California
San Joaquin,2021-01-11,1605,15743,1374,12191,231,3552,0,0,918,10971,684,2437,987,13408,California
San Joaquin,2021-01-12,1703,17446,1187,13378,516,4068,0,0,851,11050,844,3281,923,14331,California
San Joaquin,2021-01-13,1624,19070,921,14299,703,4771,0,0,1025,11489,592,3873,1031,15362,California
San Joaquin,2021-01-14,1955,21025,996,15295,959,5730,0,0,1588,12758,341,4214,1610,16972,California
San Joaquin,2021-01-15,1672,22697,564,15859,1108,6838,0,0,1412,13952,243,4457,1437,18409,California
San Joaquin,2021-01-16,1145,23842,184,16043,961,7799,0,0,1111,15030,33,4490,1111,19520,California
San Joaquin,2021-01-17,1642,25484,143,16186,1499,9298,0,0,1592,16575,50,4540,1595,21115,California
San Joaquin,2021-01-18,753,26237,245,16431,508,9806,0,0,630,17086,119,4659,630,21745,California
San Joaquin,2021-01-19,2005,28242,907,17338,1098,10904,0,0,1311,17720,687,5346,1321,23066,California
San Joaquin,2021-01-20,2237,30479,1299,18637,938,11842,0,0,1574,18648,654,6000,1582,24648,California
San Joaquin,2021-01-21,2128,32607,908,19545,1220,13062,0,0,1721,19979,399,6399,1730,26378,California
San Joaquin,2021-01-22,2113,34720,922,20467,1191,14253,0,0,1950,21774,157,6556,1952,28330,California
San Joaquin,2021-01-23,909,35629,395,20862,514,14767,0,0,617,22104,289,6845,619,28949,California
San Joaquin,2021-01-24,372,36001,139,21001,233,15000,0,0,349,22433,20,6865,349,29298,California
San Joaquin,2021-01-25,2128,38129,1175,22176,953,15953,0,0,1529,23373,594,7459,1534,30832,California
San Joaquin,2021-01-26,2362,40491,1119,23295,1243,17196,0,0,1715,24467,633,8092,1727,32559,California
San Joaquin,2021-01-27,1841,42332,778,24073,1063,18259,0,0,1323,25284,512,8604,1329,33888,California
San Joaquin,2021-01-28,2261,44593,804,24877,1457,19716,0,0,1551,26142,703,9307,1561,35449,California
San Joaquin,2021-01-29,2339,46932,1071,25948,1268,20984,0,0,1942,27706,388,9695,1952,37401,California
San Joaquin,2021-01-30,2191,49123,359,26307,1832,22816,0,0,2005,29528,185,9880,2007,39408,California
San Joaquin,2021-01-31,1557,50680,173,26480,1384,24200,0,0,1484,30944,70,9950,1486,40894,California
San Joaquin,2021-02-01,2565,53245,1319,27799,1246,25446,0,0,1755,31893,808,10758,1757,42651,California
San Joaquin,2021-02-02,2691,55936,1190,28989,1501,26947,0,0,2039,33348,588,11346,2043,44694,California
San Joaquin,2021-02-03,3164,59100,1244,30233,1920,28867,0,0,2259,34720,897,12243,2269,46963,California
San Joaquin,2021-02-04,3593,62693,1794,32027,1799,30666,0,0,2674,36488,914,13157,2682,49645,California
San Joaquin,2021-02-05,3258,65951,1766,33793,1492,32158,0,0,2377,38026,853,14010,2391,52036,California
San Joaquin,2021-02-06,1020,66971,659,34452,361,32519,0,0,866,38742,151,14161,867,52903,California
San Joaquin,2021-02-07,629,67600,495,34947,134,32653,0,0,420,38960,203,14364,421,53324,California
San Joaquin,2021-02-08,1930,69530,1050,35997,880,33533,0,0,1552,40174,346,14710,1560,54884,California
San Joaquin,2021-02-09,2300,71830,1159,37156,1141,34674,0,0,1670,41299,549,15259,1674,56558,California
San Joaquin,2021-02-10,2794,74624,1270,38426,1524,36198,0,0,1461,41469,1293,16552,1463,58021,California
San Joaquin,2021-02-11,3071,77695,1478,39904,1593,37791,0,0,1738,41944,1270,17822,1745,59766,California
San Joaquin,2021-02-12,3013,80708,1151,41055,1862,39653,0,0,1660,42296,1312,19134,1664,61430,California
San Joaquin,2021-02-13,2152,82860,414,41469,1738,41391,0,0,869,41906,1265,20399,875,62305,California
San Joaquin,2021-02-14,1932,84792,266,41735,1666,43057,0,0,706,41421,1192,21591,707,63012,California
San Joaquin,2021-02-15,2084,86876,830,42565,1254,44311,0,0,1245,41874,796,22387,1249,64261,California
San Joaquin,2021-02-16,3371,90247,1410,43975,1961,46272,0,0,1864,42264,1485,23872,1875,66136,California
San Joaquin,2021-02-17,3604,93851,1313,45288,2291,48563,0,0,1983,42676,1575,25447,1987,68123,California
San Joaquin,2021-02-18,3580,97431,1422,46710,2158,50721,0,0,1989,43143,1528,26975,1995,70118,California
San Joaquin,2021-02-19,4416,101847,2453,49163,1963,52684,0,0,2437,43679,1902,28877,2438,72556,California
San Joaquin,2021-02-20,1626,103473,702,49865,924,53608,0,0,1091,44240,530,29407,1091,73647,California
San Joaquin,2021-02-21,721,104194,531,50396,190,53798,0,0,435,44396,281,29688,437,74084,California
San Joaquin,2021-02-22,3827,108021,2614,53010,1213,55011,0,0,2629,45879,1149,30837,2632,76716,California
San Joaquin,2021-02-23,4661,112682,2698,55708,1963,56974,0,0,2764,46833,1817,32654,2771,79487,California
San Joaquin,2021-02-24,5998,118680,3506,59214,2492,59466,0,0,4220,49331,1726,34380,4224,83711,California
San Joaquin,2021-02-25,6829,125509,4079,63293,2750,62216,0,0,4221,51042,2523,36903,4234,87945,California
San Joaquin,2021-02-26,5776,131285,2973,66266,2803,65019,0,0,3848,53025,1871,38774,3854,91799,California
San Joaquin,2021-02-27,5654,136939,1755,68021,3898,68917,1,1,2688,52827,2897,41671,2699,94498,California
San Joaquin,2021-02-28,3171,140110,1156,69177,2015,70932,0,1,2084,53865,1050,42721,2088,96586,California
San Joaquin,2021-03-01,4591,144701,1883,71060,2705,73637,3,4,2474,54295,2057,44778,2487,99073,California
San Joaquin,2021-03-02,4480,149181,1742,72802,2738,76375,0,4,2804,55513,1638,46416,2856,101929,California
San Joaquin,2021-03-03,6092,155273,3523,76325,2567,78942,2,6,4382,58229,1667,48083,4383,106312,California
San Joaquin,2021-03-04,5940,161213,2324,78649,3613,82555,3,9,3885,60095,2024,50107,3890,110202,California
San Joaquin,2021-03-05,4839,166052,1948,80597,2886,85441,5,14,3317,61957,1465,51572,3327,113529,California
San Joaquin,2021-03-06,3375,169427,2216,82813,1028,86469,131,145,2761,64249,603,52175,2895,116424,California
San Joaquin,2021-03-07,1322,170749,578,83391,642,87111,102,247,969,64969,335,52510,1055,117479,California
San Joaquin,2021-03-08,3331,174080,1291,84682,1903,89014,137,384,2167,66138,1135,53645,2304,119783,California
San Joaquin,2021-03-09,4372,178452,1891,86573,2349,91363,132,516,2764,67490,1551,55196,2903,122686,California
San Joaquin,2021-03-10,5033,183485,2551,89124,2340,93703,142,658,3519,69664,1487,56683,3661,126347,California
San Joaquin,2021-03-11,5357,188842,2497,91621,2256,95959,604,1262,3021,70978,2312,58995,3626,129973,California
San Joaquin,2021-03-12,6724,195566,3266,94887,3118,99077,340,1602,4227,73093,2456,61451,4571,134544,California
San Joaquin,2021-03-13,3264,198830,1528,96415,1610,100687,126,1728,2324,74627,926,62377,2460,137004,California
San Joaquin,2021-03-14,2193,201023,684,97099,1205,101892,304,2032,1033,74816,1152,63529,1341,138345,California
San Joaquin,2021-03-15,6213,207236,3548,100647,2256,104148,409,2441,3195,75472,2965,66494,3621,141966,California
San Joaquin,2021-03-16,7085,214321,3972,104619,2853,107001,260,2701,4123,76943,2920,69414,4391,146357,California
San Joaquin,2021-03-17,8090,222411,4775,109394,3245,110246,70,2771,4420,77843,3595,73009,4495,150852,California
San Joaquin,2021-03-18,7852,230263,4579,113973,2763,113009,510,3281,3856,78288,3926,76935,4371,155223,California
San Joaquin,2021-03-19,8160,238423,4721,118694,2892,115901,547,3828,4889,80548,3235,80170,5495,160718,California
San Joaquin,2021-03-20,3745,242168,2164,120858,1338,117239,243,4071,1836,80755,1886,82056,2093,162811,California
San Joaquin,2021-03-21,2158,244326,1530,122388,421,117660,207,4278,1161,81219,974,83030,1438,164249,California
San Joaquin,2021-03-22,4224,248550,2110,124498,1698,119358,416,4694,2489,82430,1699,84729,2910,167159,California
San Joaquin,2021-03-23,5561,254111,2715,127213,2678,122036,168,4862,3823,84730,1698,86427,3998,171157,California
San Joaquin,2021-03-24,7071,261182,4323,131536,2655,124691,93,4955,3102,84032,3900,90327,3202,174359,California
San Joaquin,2021-03-25,5830,267012,3407,134943,2375,127066,48,5003,3443,85188,2338,92665,3494,177853,California
San Joaquin,2021-03-26,6545,273557,2632,137575,3758,130824,155,5158,3355,85611,3109,95774,3532,181385,California
San Joaquin,2021-03-27,4734,278291,2662,140237,1997,132821,75,5233,1814,84624,2887,98661,1900,183285,California
San Joaquin,2021-03-28,2778,281069,1842,142079,911,133732,25,5258,1264,84538,1490,100151,1404,184689,California
San Joaquin,2021-03-29,4215,285284,2216,144295,1974,135706,25,5283,2117,84631,2067,102218,2160,186849,California
San Joaquin,2021-03-30,6484,291768,3226,147521,3165,138871,93,5376,3547,85403,2886,105104,3658,190507,California
San Joaquin,2021-03-31,6906,298674,4220,151741,2624,141495,62,5438,3508,85644,3353,108457,3594,194101,California
San Joaquin,2021-04-01,6729,305403,3049,154790,3587,145082,93,5531,2979,85077,3701,112158,3134,197235,California
San Joaquin,2021-04-02,6602,312005,2920,157710,3181,148263,501,6032,2608,84277,3941,116099,3141,200376,California
San Joaquin,2021-04-03,4253,316258,2424,160134,1505,149768,324,6356,2034,84451,2198,118297,2372,202748,California
San Joaquin,2021-04-04,2318,318576,1380,161514,729,150497,209,6565,1546,85470,758,119055,1777,204525,California
San Joaquin,2021-04-05,5036,323612,2891,164405,1899,152396,246,6811,2732,86194,2261,121316,2985,207510,California
San Joaquin,2021-04-06,7409,331021,4607,169012,2521,154917,281,7092,3473,86099,3862,125178,3767,211277,California
San Joaquin,2021-04-07,8551,339572,4616,173628,2344,157261,1591,8683,3594,86377,4916,130094,5194,216471,California
San Joaquin,2021-04-08,9023,348595,4794,178422,2057,159318,2172,10855,3406,86381,5573,135667,5577,222048,California
San Joaquin,2021-04-09,9208,357803,4432,182854,3199,162517,1577,12432,3374,85549,5795,141462,4963,227011,California
San Joaquin,2021-04-10,5283,363086,1675,184529,1690,164207,1918,14350,1793,85787,3470,144932,3708,230719,California
San Joaquin,2021-04-11,4335,367421,1797,186326,1372,165579,1166,15516,1995,86616,2326,147258,3155,233874,California
San Joaquin,2021-04-12,6253,373674,2532,188858,2166,167745,1555,17071,2461,86878,3756,151014,4018,237892,California
San Joaquin,2021-04-13,7757,381431,4436,193294,3312,171057,9,17080,4706,88589,3012,154026,4723,242615,California
San Joaquin,2021-04-14,7801,389232,3958,197252,3840,174897,3,17083,4674,90180,3097,157123,4688,247303,California
San Joaquin,2021-04-15,8086,397318,4805,202057,3280,178177,1,17084,4449,91055,3584,160707,4459,251762,California
San Joaquin,2021-04-16,7958,405276,4318,206375,3637,181814,3,17087,4768,92688,3151,163858,4784,256546,California
San Joaquin,2021-04-17,5246,410522,2854,209229,2390,184204,2,17089,3711,94901,1517,165375,3730,260276,California
San Joaquin,2021-04-18,2626,413148,1515,210744,1111,185315,0,17089,1397,95095,1209,166584,1403,261679,California
San Joaquin,2021-04-19,5357,418505,2851,213595,2505,187820,1,17090,2782,95353,2538,169122,2796,264475,California
San Joaquin,2021-04-20,6535,425040,3505,217100,3029,190849,1,17091,3062,94991,3436,172558,3074,267549,California
San Joaquin,2021-04-21,6109,431149,3484,220584,2624,193473,1,17092,3117,95190,2927,175485,3126,270675,California
San Joaquin,2021-04-22,5607,436756,3338,223922,2267,195740,2,17094,3159,95961,2407,177892,3178,273853,California
San Joaquin,2021-04-23,6255,443011,3050,226972,3204,198944,1,17095,3901,97547,2323,180215,3909,277762,California
San Joaquin,2021-04-24,5320,448331,3659,230631,1659,200603,2,17097,3447,99167,1841,182056,3461,281223,California
San Joaquin,2021-04-25,3090,451421,2603,233234,487,201090,0,17097,2050,100214,1009,183065,2056,283279,California
San Joaquin,2021-04-26,4275,455696,2759,235993,1512,202602,4,17101,2192,100353,2063,185128,2202,285481,California
San Joaquin,2021-04-27,4877,460573,2804,238797,2011,204613,62,17163,2053,99684,2793,187921,2124,287605,California
San Joaquin,2021-04-28,5912,466485,3538,242335,2292,206905,82,17245,2875,99657,2994,190915,2967,290572,California
San Joaquin,2021-04-29,5215,471700,3063,245398,2095,209000,57,17302,2635,99812,2548,193463,2703,293275,California
San Joaquin,2021-04-30,5291,476991,2617,248015,2607,211607,67,17369,2693,100014,2568,196031,2770,296045,California
San Joaquin,2021-05-01,3399,480390,1943,249958,1399,213006,57,17426,2163,101023,1224,197255,2233,298278,California
San Joaquin,2021-05-02,2330,482720,1624,251582,649,213655,57,17483,1177,101110,1148,198403,1235,299513,California
San Joaquin,2021-05-03,3472,486192,2338,253920,1055,214710,79,17562,1432,100609,2020,200423,1519,301032,California
San Joaquin,2021-05-04,5142,491334,3453,257373,1529,216239,160,17722,1880,99428,3233,203656,2052,303084,California
San Joaquin,2021-05-05,5415,496749,3744,261117,1507,217746,164,17886,2402,99026,2976,206632,2574,305658,California
San Joaquin,2021-05-06,4950,501699,3340,264457,1479,219225,131,18017,2134,98506,2797,209429,2277,307935,California
San Joaquin,2021-05-07,5391,507090,3170,267627,2067,221292,154,18171,2048,97410,3312,212741,2216,310151,California
San Joaquin,2021-05-08,3436,510526,2259,269886,1074,222366,103,18274,1294,96695,2122,214863,1407,311558,California
San Joaquin,2021-05-09,1533,512059,878,270764,585,222951,70,18344,575,96392,954,215817,651,312209,California
San Joaquin,2021-05-10,2983,515042,1588,272352,1269,224220,126,18470,954,95470,2007,217824,1085,313294,California
San Joaquin,2021-05-11,4302,519344,2250,274602,1931,226151,121,18591,1301,93941,2982,220806,1453,314747,California
San Joaquin,2021-05-12,4558,523902,2182,276784,2248,228399,128,18719,1399,92345,3135,223941,1539,316286,California
San Joaquin,2021-05-13,4928,528830,2903,279687,1937,230336,88,18807,1883,91304,3026,226967,1985,318271,California
San Joaquin,2021-05-14,5954,534784,3585,283272,2261,232597,108,18915,2446,90387,3475,230442,2558,320829,California
San Joaquin,2021-05-15,5286,540070,3151,286423,2054,234651,81,18996,1658,88535,3594,234036,1742,322571,California
San Joaquin,2021-05-16,3631,543701,2854,289277,728,235379,49,19045,1473,87924,2141,236177,1530,324101,California
San Joaquin,2021-05-17,4194,547895,2511,291788,1585,236964,98,19143,1793,87445,2380,238557,1901,326002,California
San Joaquin,2021-05-18,4036,551931,2332,294120,1589,238553,115,19258,1872,87293,2142,240699,1990,327992,California
San Joaquin,2021-05-19,4836,556767,2819,296939,1882,240435,135,19393,2035,86705,2768,243467,2180,330172,California
San Joaquin,2021-05-20,4034,560801,2417,299356,1510,241945,107,19500,1741,86290,2266,245733,1851,332023,California
San Joaquin,2021-05-21,5139,565940,3028,302384,1986,243931,125,19625,2316,85950,2789,248522,2449,334472,California
San Joaquin,2021-05-22,4101,570041,2577,304961,1428,245359,96,19721,1835,85643,2250,250772,1943,336415,California
San Joaquin,2021-05-23,2555,572596,2095,307056,415,245774,45,19766,1472,86095,1069,251841,1521,337936,California
San Joaquin,2021-05-24,3121,575717,1830,308886,1197,246971,94,19860,1450,85990,1654,253495,1549,339485,California
San Joaquin,2021-05-25,3160,578877,1959,310845,1053,248024,148,20008,1455,85914,1678,255173,1602,341087,California
San Joaquin,2021-05-26,3940,582817,2431,313276,1435,249459,74,20082,1602,85274,2320,257493,1680,342767,California
San Joaquin,2021-05-27,3163,585980,1722,314998,1355,250814,86,20168,1279,84774,1867,259360,1367,344134,California
San Joaquin,2021-05-28,3169,589149,1701,316699,1377,252191,91,20259,1471,84675,1670,261030,1571,345705,California
San Joaquin,2021-05-29,2163,591312,1199,317898,929,253120,35,20294,922,84402,1235,262265,962,346667,California
San Joaquin,2021-05-30,979,592291,523,318421,430,253550,26,20320,399,84257,574,262839,429,347096,California
San Joaquin,2021-05-31,625,592916,264,318685,354,253904,7,20327,239,84122,381,263220,246,347342,California
San Joaquin,2021-06-01,2496,595412,1503,320188,892,254796,101,20428,1182,84107,1304,264524,1289,348631,California
San Joaquin,2021-06-02,2751,598163,1621,321809,1076,255872,54,20482,1139,83707,1596,266120,1196,349827,California
San Joaquin,2021-06-03,2869,601032,1777,323586,1035,256907,57,20539,1061,83040,1789,267909,1122,350949,California
San Joaquin,2021-06-04,3173,604205,1948,325534,1120,258027,105,20644,1062,82128,2081,269990,1169,352118,California
San Joaquin,2021-06-05,2526,606731,1923,327457,537,258564,66,20710,1149,82062,1285,271275,1219,353337,California
San Joaquin,2021-06-06,1106,607837,889,328346,179,258743,38,20748,428,81870,659,271934,467,353804,California
San Joaquin,2021-06-07,2853,610690,2106,330452,705,259448,42,20790,984,81044,1861,273795,1035,354839,California
San Joaquin,2021-06-08,2795,613485,2116,332568,634,260082,45,20835,882,80078,1896,275691,930,355769,California
San Joaquin,2021-06-09,2895,616380,2023,334591,828,260910,44,20879,998,79241,1880,277571,1043,356812,California
San Joaquin,2021-06-10,2695,619075,1952,336543,673,261583,70,20949,1012,78647,1676,279247,1082,357894,California
San Joaquin,2021-06-11,2994,622069,2074,338617,802,262385,118,21067,985,77751,2000,281247,1104,358998,California
San Joaquin,2021-06-12,1868,623937,1407,340024,431,262816,30,21097,627,77197,1232,282479,678,359676,California
San Joaquin,2021-06-13,1080,625017,829,340853,203,263019,48,21145,500,77172,575,283054,550,360226,California
San Joaquin,2021-06-14,2239,627256,1496,342349,668,263687,75,21220,937,76897,1287,284341,1012,361238,California
San Joaquin,2021-06-15,2273,629529,1511,343860,685,264372,77,21297,880,76481,1376,285717,960,362198,California
San Joaquin,2021-06-16,2806,632335,2034,345894,691,265063,81,21378,914,75598,1877,287594,994,363192,California
San Joaquin,2021-06-17,2633,634968,1872,347766,698,265761,63,21441,899,74838,1722,289316,962,364154,California
San Joaquin,2021-06-18,2891,637859,1936,349702,880,266641,75,21516,1193,74441,1667,290983,1270,365424,California
San Joaquin,2021-06-19,1403,639262,872,350574,271,266912,260,21776,505,74317,889,291872,765,366189,California
San Joaquin,2021-06-20,667,639929,528,351102,112,267024,27,21803,298,74278,363,292235,324,366513,California
San Joaquin,2021-06-21,1632,641561,965,352067,559,267583,108,21911,827,74415,798,293033,935,367448,California
San Joaquin,2021-06-22,1915,643476,1260,353327,583,268166,72,21983,823,74232,1078,294111,895,368343,California
San Joaquin,2021-06-23,1987,645463,1311,354638,600,268766,76,22059,784,73909,1185,295296,862,369205,California
San Joaquin,2021-06-24,1988,647451,1356,355994,537,269303,95,22154,878,73833,1048,296344,972,370177,California
San Joaquin,2021-06-25,1734,649185,1111,357105,545,269848,78,22232,770,73727,955,297299,849,371026,California
San Joaquin,2021-06-26,1079,650264,809,357914,220,270068,50,22282,520,73747,552,297851,572,371598,California
San Joaquin,2021-06-27,577,650841,437,358351,99,270167,41,22323,267,73750,304,298155,307,371905,California
San Joaquin,2021-06-28,1454,652295,1026,359377,361,270528,67,22390,666,73726,756,298911,732,372637,California
San Joaquin,2021-06-29,1468,653763,933,360310,460,270988,75,22465,658,73653,801,299712,728,373365,California
San Joaquin,2021-06-30,1517,655280,1028,361338,411,271399,78,22543,646,73513,863,300575,723,374088,California
San Joaquin,2021-07-01,1593,656873,1098,362436,399,271798,96,22639,695,73417,886,301461,790,374878,California
San Joaquin,2021-07-02,1555,658428,1076,363512,426,272224,53,22692,718,73358,831,302292,772,375650,California
San Joaquin,2021-07-03,706,659134,513,364025,166,272390,27,22719,390,73461,314,302606,417,376067,California
San Joaquin,2021-07-04,136,659270,89,364114,34,272424,13,22732,59,73457,77,302683,73,376140,California
San Joaquin,2021-07-05,810,660080,572,364686,194,272618,44,22776,397,73489,409,303092,441,376581,California
San Joaquin,2021-07-06,1344,661424,883,365569,405,273023,56,22832,575,73370,753,303845,634,377215,California
San Joaquin,2021-07-07,1336,662760,983,366552,287,273310,66,22898,623,73355,707,304552,692,377907,California
San Joaquin,2021-07-08,1364,664124,969,367521,339,273649,56,22954,641,73334,718,305270,697,378604,California
San Joaquin,2021-07-09,1538,665662,1128,368649,349,273998,61,23015,698,73258,837,306107,761,379365,California
San Joaquin,2021-07-10,904,666566,726,369375,142,274140,36,23051,388,73177,511,306618,430,379795,California
San Joaquin,2021-07-11,552,667118,428,369803,102,274242,22,23073,291,73233,258,306876,314,380109,California
San Joaquin,2021-07-12,1311,668429,868,370671,400,274642,43,23116,605,73204,682,307558,653,380762,California
San Joaquin,2021-07-13,1118,669547,727,371398,348,274990,43,23159,596,73330,515,308073,641,381403,California
San Joaquin,2021-07-14,1119,670666,841,372239,236,275226,42,23201,563,73392,548,308621,610,382013,California
San Joaquin,2021-07-15,1311,671977,964,373203,314,275540,33,23234,648,73422,655,309276,685,382698,California
San Joaquin,2021-07-16,1443,673420,1028,374231,362,275902,53,23287,740,73521,697,309973,796,383494,California
San Joaquin,2021-07-17,792,674212,610,374841,167,276069,15,23302,428,73607,359,310332,445,383939,California
San Joaquin,2021-07-18,501,674713,393,375234,84,276153,24,23326,262,73659,234,310566,286,384225,California
San Joaquin,2021-07-19,1260,675973,892,376126,332,276485,36,23362,661,73761,597,311163,699,384924,California
San Joaquin,2021-07-20,1229,677202,832,376958,359,276844,38,23400,661,73897,565,311728,701,385625,California
San Joaquin,2021-07-21,1340,678542,999,377957,312,277156,29,23429,750,74095,581,312309,779,386404,California
San Joaquin,2021-07-22,1518,680060,1115,379072,361,277517,42,23471,892,74409,623,312932,937,387341,California
San Joaquin,2021-07-23,1508,681568,1083,380155,392,277909,33,23504,881,74707,623,313555,921,388262,California
San Joaquin,2021-07-24,821,682389,623,380778,186,278095,12,23516,475,74853,343,313898,489,388751,California
San Joaquin,2021-07-25,497,682886,392,381170,83,278178,22,23538,361,75105,132,314030,384,389135,California
San Joaquin,2021-07-26,1291,684177,880,382050,366,278544,45,23583,773,75414,510,314540,819,389954,California
San Joaquin,2021-07-27,1740,685917,1250,383300,421,278965,69,23652,1166,76086,566,315106,1238,391192,California
San Joaquin,2021-07-28,1478,687395,1157,384457,287,279252,34,23686,946,76543,528,315634,985,392177,California
San Joaquin,2021-07-29,1629,689024,1213,385670,380,279632,36,23722,1059,77074,566,316200,1097,393274,California
San Joaquin,2021-07-30,1249,690273,877,386547,340,279972,32,23754,764,77411,482,316682,819,394093,California
San Joaquin,2021-07-31,344,690617,202,386749,138,280110,4,23758,216,77512,127,316809,228,394321,California
San Luis Obispo,2020-12-15,1,1,1,1,0,0,0,0,1,1,0,0,1,1,California
San Luis Obispo,2020-12-16,4,5,4,5,0,0,0,0,4,5,0,0,4,5,California
San Luis Obispo,2020-12-17,200,205,200,205,0,0,0,0,200,205,0,0,200,205,California
San Luis Obispo,2020-12-18,223,428,223,428,0,0,0,0,223,428,0,0,223,428,California
San Luis Obispo,2020-12-19,165,593,165,593,0,0,0,0,165,593,0,0,165,593,California
San Luis Obispo,2020-12-20,216,809,216,809,0,0,0,0,216,809,0,0,216,809,California
San Luis Obispo,2020-12-21,551,1360,550,1359,1,1,0,0,551,1360,0,0,551,1360,California
San Luis Obispo,2020-12-22,310,1670,306,1665,4,5,0,0,309,1668,1,1,309,1669,California
San Luis Obispo,2020-12-23,682,2352,368,2033,314,319,0,0,682,2350,0,1,682,2351,California
San Luis Obispo,2020-12-24,194,2546,19,2052,175,494,0,0,194,2544,0,1,194,2545,California
San Luis Obispo,2020-12-25,2,2548,1,2053,1,495,0,0,2,2546,0,1,2,2547,California
San Luis Obispo,2020-12-26,92,2640,13,2066,79,574,0,0,92,2638,0,1,92,2639,California
San Luis Obispo,2020-12-27,76,2716,0,2066,76,650,0,0,76,2714,0,1,76,2715,California
San Luis Obispo,2020-12-28,882,3598,433,2499,449,1099,0,0,882,3596,0,1,882,3597,California
San Luis Obispo,2020-12-29,903,4501,502,3001,401,1500,0,0,903,4499,0,1,903,4500,California
San Luis Obispo,2020-12-30,1171,5672,679,3680,492,1992,0,0,1171,5670,0,1,1171,5671,California
San Luis Obispo,2020-12-31,109,5781,4,3684,105,2097,0,0,109,5779,0,1,109,5780,California
San Luis Obispo,2021-01-01,26,5807,14,3698,12,2109,0,0,26,5805,0,1,26,5806,California
San Luis Obispo,2021-01-02,34,5841,8,3706,26,2135,0,0,34,5839,0,1,34,5840,California
San Luis Obispo,2021-01-03,17,5858,6,3712,11,2146,0,0,17,5856,0,1,17,5857,California
San Luis Obispo,2021-01-04,681,6539,525,4237,156,2302,0,0,681,6537,0,1,681,6538,California
San Luis Obispo,2021-01-05,983,7522,757,4994,226,2528,0,0,980,7514,3,4,980,7518,California
San Luis Obispo,2021-01-06,725,8247,478,5472,247,2775,0,0,714,8218,10,14,714,8232,California
San Luis Obispo,2021-01-07,1122,9369,944,6416,178,2953,0,0,679,8454,443,457,679,8911,California
San Luis Obispo,2021-01-08,889,10258,807,7223,82,3035,0,0,518,8602,370,827,518,9429,California
San Luis Obispo,2021-01-09,206,10464,196,7419,10,3045,0,0,28,8452,178,1005,28,9457,California
San Luis Obispo,2021-01-10,12,10476,8,7427,4,3049,0,0,8,8456,4,1009,8,9465,California
San Luis Obispo,2021-01-11,563,11039,512,7939,51,3100,0,0,299,8492,263,1272,299,9764,California
San Luis Obispo,2021-01-12,615,11654,386,8325,229,3329,0,0,321,8533,293,1565,334,10098,California
San Luis Obispo,2021-01-13,892,12546,263,8588,629,3958,0,0,653,8948,238,1803,653,10751,California
San Luis Obispo,2021-01-14,725,13271,237,8825,488,4446,0,0,605,9440,113,1916,605,11356,California
San Luis Obispo,2021-01-15,732,14003,290,9115,442,4888,0,0,555,9821,174,2090,555,11911,California
San Luis Obispo,2021-01-16,108,14111,87,9202,21,4909,0,0,96,9905,12,2102,96,12007,California
San Luis Obispo,2021-01-17,63,14174,56,9258,7,4916,0,0,63,9968,0,2102,63,12070,California
San Luis Obispo,2021-01-18,1382,15556,395,9653,987,5903,0,0,1115,10816,267,2369,1115,13185,California
San Luis Obispo,2021-01-19,1581,17137,417,10070,1164,7067,0,0,1169,11574,412,2781,1170,14355,California
San Luis Obispo,2021-01-20,1897,19034,601,10671,1296,8363,0,0,1305,12290,590,3371,1306,15661,California
San Luis Obispo,2021-01-21,1580,20614,472,11143,1108,9471,0,0,1208,13131,368,3739,1209,16870,California
San Luis Obispo,2021-01-22,1523,22137,511,11654,1012,10483,0,0,1206,14023,314,4053,1206,18076,California
San Luis Obispo,2021-01-23,312,22449,292,11946,20,10503,0,0,296,14303,16,4069,296,18372,California
San Luis Obispo,2021-01-24,444,22893,238,12184,206,10709,0,0,438,14734,7,4076,438,18810,California
San Luis Obispo,2021-01-25,2078,24971,606,12790,1472,12181,0,0,1246,15148,832,4908,1246,20056,California
San Luis Obispo,2021-01-26,2015,26986,712,13502,1303,13484,0,0,1143,15419,872,5780,1143,21199,California
San Luis Obispo,2021-01-27,1616,28602,292,13794,1324,14808,0,0,1157,16117,459,6239,1157,22356,California
San Luis Obispo,2021-01-28,1504,30106,346,14140,1158,15966,0,0,1240,17094,263,6502,1240,23596,California
San Luis Obispo,2021-01-29,1760,31866,695,14835,1065,17031,0,0,1464,18262,296,6798,1464,25060,California
San Luis Obispo,2021-01-30,40,31906,18,14853,22,17053,0,0,29,18281,10,6808,29,25089,California
San Luis Obispo,2021-01-31,236,32142,20,14873,216,17269,0,0,234,18513,2,6810,234,25323,California
San Luis Obispo,2021-02-01,1713,33855,745,15618,968,18237,0,0,1404,19608,309,7119,1404,26727,California
San Luis Obispo,2021-02-02,1911,35766,686,16304,1225,19462,0,0,1529,20756,382,7501,1530,28257,California
San Luis Obispo,2021-02-03,1718,37484,730,17034,988,20450,0,0,1295,21628,423,7924,1295,29552,California
San Luis Obispo,2021-02-04,1669,39153,805,17839,864,21314,0,0,1098,22155,571,8495,1098,30650,California
San Luis Obispo,2021-02-05,1617,40770,719,18558,898,22212,0,0,1069,22676,548,9043,1069,31719,California
San Luis Obispo,2021-02-06,179,40949,105,18663,74,22286,0,0,98,22694,80,9123,98,31817,California
San Luis Obispo,2021-02-07,123,41072,78,18741,45,22331,0,0,71,22714,52,9175,72,31889,California
San Luis Obispo,2021-02-08,866,41938,474,19215,392,22723,0,0,500,22849,365,9540,500,32389,California
San Luis Obispo,2021-02-09,1132,43070,448,19663,684,23407,0,0,547,22825,571,10111,547,32936,California
San Luis Obispo,2021-02-10,1449,44519,495,20158,954,24361,0,0,530,22441,914,11025,530,33466,California
San Luis Obispo,2021-02-11,1342,45861,851,21009,491,24852,0,0,663,22427,677,11702,663,34129,California
San Luis Obispo,2021-02-12,795,46656,369,21378,426,25278,0,0,419,22470,376,12078,419,34548,California
San Luis Obispo,2021-02-13,399,47055,134,21512,265,25543,0,0,287,22646,111,12189,287,34835,California
San Luis Obispo,2021-02-14,323,47378,46,21558,277,25820,0,0,282,22888,41,12230,283,35118,California
San Luis Obispo,2021-02-15,734,48112,141,21699,593,26413,0,0,478,23112,254,12484,478,35596,California
San Luis Obispo,2021-02-16,3001,51113,1203,22902,1798,28211,0,0,1368,22848,1632,14116,1368,36964,California
San Luis Obispo,2021-02-17,2810,53923,1269,24171,1541,29752,0,0,1026,22098,1776,15892,1026,37990,California
San Luis Obispo,2021-02-18,2846,56769,1474,25645,1372,31124,0,0,1133,21528,1704,17596,1134,39124,California
San Luis Obispo,2021-02-19,1472,58241,1351,26996,121,31245,0,0,1139,22336,331,17927,1139,40263,California
San Luis Obispo,2021-02-20,263,58504,88,27084,175,31420,0,0,223,22519,40,17967,223,40486,California
San Luis Obispo,2021-02-21,58,58562,54,27138,4,31424,0,0,30,22521,28,17995,30,40516,California
San Luis Obispo,2021-02-22,2446,61008,1892,29030,554,31978,0,0,1479,23037,964,18959,1480,41996,California
San Luis Obispo,2021-02-23,1879,62887,1761,30791,118,32096,0,0,1368,23897,509,19468,1369,43365,California
San Luis Obispo,2021-02-24,2688,65575,1328,32119,1360,33456,0,0,841,22896,1842,21310,841,44206,California
San Luis Obispo,2021-02-25,2169,67744,1268,33387,901,34357,0,0,1226,23188,935,22245,1227,45433,California
San Luis Obispo,2021-02-26,2702,70446,1179,34566,1523,35880,0,0,1354,23206,1336,23581,1354,46787,California
San Luis Obispo,2021-02-27,611,71057,376,34942,235,36115,0,0,555,23706,55,23636,555,47342,California
San Luis Obispo,2021-02-28,602,71659,70,35012,532,36647,0,0,173,23452,427,24063,173,47515,California
San Luis Obispo,2021-03-01,3039,74698,1899,36911,1138,37785,2,2,2091,24598,948,25011,2094,49609,California
San Luis Obispo,2021-03-02,3102,77800,1940,38851,1162,38947,0,2,1930,25362,1167,26178,1931,51540,California
San Luis Obispo,2021-03-03,2382,80182,358,39209,2024,40971,0,2,862,24713,1512,27690,863,52403,California
San Luis Obispo,2021-03-04,2249,82431,1182,40391,1067,42038,0,2,1212,24896,1032,28722,1215,53618,California
San Luis Obispo,2021-03-05,2323,84754,1031,41422,1221,43259,71,73,1312,25284,995,29717,1383,55001,California
San Luis Obispo,2021-03-06,846,85600,314,41736,426,43685,106,179,622,25781,224,29941,721,55722,California
San Luis Obispo,2021-03-07,234,85834,33,41769,96,43781,105,284,88,25824,145,30086,188,55910,California
San Luis Obispo,2021-03-08,2770,88604,763,42532,1688,45469,319,603,1561,26497,1204,31290,1877,57787,California
San Luis Obispo,2021-03-09,2991,91595,995,43527,1747,47216,249,852,1540,26838,1447,32737,1788,59575,California
San Luis Obispo,2021-03-10,3221,94816,1241,44768,1695,48911,285,1137,1830,27565,1386,34123,2113,61688,California
San Luis Obispo,2021-03-11,3388,98204,1337,46105,1729,50640,322,1459,1825,28163,1549,35672,2147,63835,California
San Luis Obispo,2021-03-12,3239,101443,1262,47367,1640,52280,337,1796,1622,28512,1610,37282,1959,65794,California
San Luis Obispo,2021-03-13,915,102358,264,47631,542,52822,109,1905,542,28788,372,37654,648,66442,California
San Luis Obispo,2021-03-14,516,102874,57,47688,348,53170,111,2016,136,28657,378,38032,247,66689,California
San Luis Obispo,2021-03-15,3081,105955,1110,48798,1873,55043,98,2114,1530,28742,1547,39579,1632,68321,California
San Luis Obispo,2021-03-16,2867,108822,1516,50314,1240,56283,111,2225,1442,28875,1418,40997,1551,69872,California
San Luis Obispo,2021-03-17,3479,112301,1457,51771,1758,58041,264,2489,2014,29702,1450,42447,2277,72149,California
San Luis Obispo,2021-03-18,2891,115192,1473,53244,1204,59245,214,2703,1372,29774,1511,43958,1583,73732,California
San Luis Obispo,2021-03-19,2624,117816,1583,54827,717,59962,324,3027,960,29405,1655,45613,1286,75018,California
San Luis Obispo,2021-03-20,849,118665,507,55334,305,60267,37,3064,381,29356,467,46080,418,75436,California
San Luis Obispo,2021-03-21,193,118858,47,55381,142,60409,4,3068,161,29489,31,46111,164,75600,California
San Luis Obispo,2021-03-22,2800,121658,1189,56570,1563,61972,48,3116,1941,30624,854,46965,1989,77589,California
San Luis Obispo,2021-03-23,3392,125050,2256,58826,1106,63078,30,3146,2237,31742,1149,48114,2267,79856,California
San Luis Obispo,2021-03-24,3621,128671,2220,61046,1315,64393,86,3232,2686,33585,928,49042,2771,82627,California
San Luis Obispo,2021-03-25,3750,132421,2359,63405,1379,65772,12,3244,2678,35209,1065,50107,2689,85316,California
San Luis Obispo,2021-03-26,3385,135806,1839,65244,1059,66831,487,3731,1879,36075,1499,51606,2365,87681,California
San Luis Obispo,2021-03-27,1009,136815,508,65752,410,67241,91,3822,446,36052,560,52166,537,88218,California
San Luis Obispo,2021-03-28,630,137445,160,65912,414,67655,56,3878,416,36314,212,52378,474,88692,California
San Luis Obispo,2021-03-29,2657,140102,1334,67246,1190,68845,133,4011,1683,37173,958,53336,1817,90509,California
San Luis Obispo,2021-03-30,3569,143671,1964,69210,1466,70311,139,4150,2356,38462,1205,54541,2494,93003,California
San Luis Obispo,2021-03-31,3917,147588,2497,71707,1273,71584,147,4297,2505,39712,1399,55940,2649,95652,California
San Luis Obispo,2021-04-01,3959,151547,2513,74220,1329,72913,117,4414,2742,41374,1195,57135,2857,98509,California
San Luis Obispo,2021-04-02,1754,153301,684,74904,751,73664,319,4733,946,41831,805,57940,1262,99771,California
San Luis Obispo,2021-04-03,1118,154419,557,75461,434,74098,127,4860,494,41834,617,58557,620,100391,California
San Luis Obispo,2021-04-04,384,154803,133,75594,211,74309,40,4900,237,41964,147,58704,277,100668,California
San Luis Obispo,2021-04-05,3674,158477,1954,77548,1602,75911,118,5018,2048,42507,1622,60326,2165,102833,California
San Luis Obispo,2021-04-06,4195,162672,2223,79771,1647,77558,325,5343,1988,42620,2198,62524,2311,105144,California
San Luis Obispo,2021-04-07,4333,167005,2366,82137,1600,79158,367,5710,2485,43638,1831,64355,2849,107993,California
San Luis Obispo,2021-04-08,4026,171031,2207,84344,1405,80563,414,6124,2143,44322,1873,66228,2557,110550,California
San Luis Obispo,2021-04-09,3723,174754,1766,86110,1182,81745,775,6899,1494,44369,2216,68444,2263,112813,California
San Luis Obispo,2021-04-10,1700,176454,570,86680,459,82204,671,7570,496,44330,1201,69645,1162,113975,California
San Luis Obispo,2021-04-11,321,176775,66,86746,188,82392,67,7637,130,44337,189,69834,196,114171,California
San Luis Obispo,2021-04-12,3493,180268,1747,88493,1583,83975,163,7800,1400,43811,2088,71922,1562,115733,California
San Luis Obispo,2021-04-13,3782,184050,2182,90675,1599,85574,1,7801,1994,44024,1783,73705,1996,117729,California
San Luis Obispo,2021-04-14,3600,187650,2061,92736,1534,87108,5,7806,1742,43933,1837,75542,1746,119475,California
San Luis Obispo,2021-04-15,3834,191484,2492,95228,1341,88449,1,7807,2021,44166,1791,77333,2024,121499,California
San Luis Obispo,2021-04-16,3703,195187,2253,97481,1446,89895,4,7811,1758,43993,1933,79266,1760,123259,California
San Luis Obispo,2021-04-17,1104,196291,437,97918,665,90560,2,7813,713,44318,390,79656,715,123974,California
San Luis Obispo,2021-04-18,328,196619,104,98022,223,90783,1,7814,114,44222,210,79866,114,124088,California
San Luis Obispo,2021-04-19,3252,199871,1368,99390,1846,92629,38,7852,1091,43198,2154,82020,1130,125218,California
San Luis Obispo,2021-04-20,3674,203545,2042,101432,1632,94261,0,7852,1304,42146,2356,84376,1304,126522,California
San Luis Obispo,2021-04-21,4069,207614,1868,103300,2199,96460,2,7854,1625,41353,2423,86799,1630,128152,California
San Luis Obispo,2021-04-22,4669,212283,2100,105400,2569,99029,0,7854,1406,39522,3239,90038,1408,129560,California
San Luis Obispo,2021-04-23,1455,213738,844,106244,607,99636,4,7858,730,39536,721,90759,735,130295,California
San Luis Obispo,2021-04-24,1097,214835,443,106687,630,100266,24,7882,515,39487,588,91347,539,130834,California
San Luis Obispo,2021-04-25,524,215359,167,106854,357,100623,0,7882,116,39200,403,91750,116,130950,California
San Luis Obispo,2021-04-26,1089,216448,398,107252,673,101296,18,7900,397,38934,680,92430,414,131364,California
San Luis Obispo,2021-04-27,3947,220395,2007,109259,1860,103156,80,7980,1516,38108,2421,94851,1595,132959,California
San Luis Obispo,2021-04-28,3853,224248,2132,111391,1650,104806,71,8051,1326,36993,2512,97363,1397,134356,California
San Luis Obispo,2021-04-29,3779,228027,2143,113534,1567,106373,69,8120,1240,35783,2520,99883,1310,135666,California
San Luis Obispo,2021-04-30,3043,231070,1709,115243,1260,107633,74,8194,916,34673,2100,101983,990,136656,California
San Luis Obispo,2021-05-01,494,231564,167,115410,283,107916,44,8238,107,34441,381,102364,149,136805,California
San Luis Obispo,2021-05-02,176,231740,56,115466,100,108016,20,8258,45,34375,131,102495,65,136870,California
San Luis Obispo,2021-05-03,914,232654,299,115765,505,108521,110,8368,227,34025,684,103179,334,137204,California
San Luis Obispo,2021-05-04,3048,235702,1973,117738,1003,109524,72,8440,895,32844,2145,105324,964,138168,California
San Luis Obispo,2021-05-05,2901,238603,1906,119644,922,110446,73,8513,672,31380,2209,107533,745,138913,California
San Luis Obispo,2021-05-06,2882,241485,1950,121594,869,111315,63,8576,710,30001,2151,109684,772,139685,California
San Luis Obispo,2021-05-07,2406,243891,1797,123391,533,111848,76,8652,592,28876,1794,111478,669,140354,California
San Luis Obispo,2021-05-08,611,244502,346,123737,237,112085,28,8680,203,28719,388,111866,231,140585,California
San Luis Obispo,2021-05-09,163,244665,39,123776,104,112189,20,8700,43,28663,119,111985,63,140648,California
San Luis Obispo,2021-05-10,747,245412,165,123941,528,112717,54,8754,157,28289,583,112568,209,140857,California
San Luis Obispo,2021-05-11,1218,246630,596,124537,547,113264,75,8829,383,27919,828,113396,458,141315,California
San Luis Obispo,2021-05-12,2536,249166,1631,126168,820,114084,85,8914,690,26865,1828,115224,774,142089,California
San Luis Obispo,2021-05-13,1187,250353,716,126884,408,114492,63,8977,490,26726,691,115915,552,142641,California
San Luis Obispo,2021-05-14,2284,252637,1654,128538,577,115069,53,9030,934,26382,1330,117245,986,143627,California
San Luis Obispo,2021-05-15,999,253636,457,128995,507,115576,35,9065,465,26352,531,117776,501,144128,California
San Luis Obispo,2021-05-16,307,253943,163,129158,138,115714,6,9071,173,26398,133,117909,179,144307,California
San Luis Obispo,2021-05-17,1710,255653,987,130145,661,116375,62,9133,671,26104,1028,118937,734,145041,California
San Luis Obispo,2021-05-18,1917,257570,1168,131313,718,117093,31,9164,724,25673,1187,120124,756,145797,California
San Luis Obispo,2021-05-19,1471,259041,628,131941,779,117872,64,9228,400,25072,1063,121187,462,146259,California
San Luis Obispo,2021-05-20,1151,260192,501,132442,614,118486,36,9264,336,24640,804,121991,372,146631,California
San Luis Obispo,2021-05-21,1110,261302,573,133015,492,118978,45,9309,508,24602,591,122582,553,147184,California
San Luis Obispo,2021-05-22,700,262002,328,133343,343,119321,29,9338,344,24627,348,122930,373,147557,California
San Luis Obispo,2021-05-23,149,262151,69,133412,74,119395,6,9344,52,24589,96,123026,58,147615,California
San Luis Obispo,2021-05-24,570,262721,264,133676,266,119661,40,9384,203,24469,363,123389,243,147858,California
San Luis Obispo,2021-05-25,882,263603,430,134106,424,120085,28,9412,345,24312,529,123918,372,148230,California
San Luis Obispo,2021-05-26,2146,265749,994,135100,1096,121181,56,9468,657,23542,1482,125400,712,148942,California
San Luis Obispo,2021-05-27,1893,267642,676,135776,1184,122365,33,9501,492,22674,1393,126793,525,149467,California
San Luis Obispo,2021-05-28,930,268572,475,136251,428,122793,27,9528,488,22749,440,127233,515,149982,California
San Luis Obispo,2021-05-29,382,268954,153,136404,216,123009,13,9541,207,22796,174,127407,221,150203,California
San Luis Obispo,2021-05-30,90,269044,36,136440,46,123055,8,9549,36,22787,52,127459,43,150246,California
San Luis Obispo,2021-05-31,42,269086,6,136446,23,123078,13,9562,16,22791,24,127483,28,150274,California
San Luis Obispo,2021-06-01,764,269850,326,136772,405,123483,33,9595,272,22609,487,127970,305,150579,California
San Luis Obispo,2021-06-02,643,270493,290,137062,310,123793,43,9638,181,22376,456,128426,223,150802,California
San Luis Obispo,2021-06-03,912,271405,451,137513,428,124221,33,9671,247,21993,663,129089,280,151082,California
San Luis Obispo,2021-06-04,2490,273895,1525,139038,923,125144,42,9713,707,20969,1771,130860,747,151829,California
San Luis Obispo,2021-06-05,671,274566,291,139329,358,125502,22,9735,327,20975,343,131203,349,152178,California
San Luis Obispo,2021-06-06,191,274757,136,139465,46,125548,9,9744,50,20893,141,131344,59,152237,California
San Luis Obispo,2021-06-07,550,275307,358,139823,148,125696,44,9788,154,20698,393,131737,198,152435,California
San Luis Obispo,2021-06-08,810,276117,527,140350,243,125939,40,9828,245,20422,561,132298,285,152720,California
San Luis Obispo,2021-06-09,642,276759,358,140708,253,126192,31,9859,190,20195,448,132746,221,152941,California
San Luis Obispo,2021-06-10,758,277517,363,141071,356,126548,39,9898,222,19922,534,133280,261,153202,California
San Luis Obispo,2021-06-11,944,278461,540,141611,366,126914,38,9936,337,19696,602,133882,376,153578,California
San Luis Obispo,2021-06-12,395,278856,269,141880,122,127036,4,9940,166,19638,228,134110,170,153748,California
San Luis Obispo,2021-06-13,162,279018,93,141973,66,127102,3,9943,44,19568,117,134227,47,153795,California
San Luis Obispo,2021-06-14,459,279477,298,142271,126,127228,35,9978,127,19400,328,134555,160,153955,California
San Luis Obispo,2021-06-15,641,280118,398,142669,205,127433,38,10016,234,19269,402,134957,271,154226,California
San Luis Obispo,2021-06-16,623,280741,364,143033,224,127657,35,10051,179,19045,437,135394,213,154439,California
San Luis Obispo,2021-06-17,600,281341,342,143375,233,127890,25,10076,197,18865,402,135796,222,154661,California
San Luis Obispo,2021-06-18,795,282136,509,143884,237,128127,49,10125,279,18682,512,136308,329,154990,California
San Luis Obispo,2021-06-19,271,282407,152,144036,104,128231,15,10140,103,18635,165,136473,118,155108,California
San Luis Obispo,2021-06-20,112,282519,73,144109,31,128262,8,10148,45,18622,66,136539,53,155161,California
San Luis Obispo,2021-06-21,353,282872,224,144333,102,128364,27,10175,154,18607,196,136735,181,155342,California
San Luis Obispo,2021-06-22,623,283495,361,144694,227,128591,35,10210,273,18567,348,137083,308,155650,California
San Luis Obispo,2021-06-23,507,284002,280,144974,207,128798,20,10230,244,18568,263,137346,264,155914,California
San Luis Obispo,2021-06-24,476,284478,267,145241,182,128980,27,10257,211,18545,261,137607,238,156152,California
San Luis Obispo,2021-06-25,533,285011,210,145451,297,129277,26,10283,210,18462,317,137924,234,156386,California
San Luis Obispo,2021-06-26,277,285288,148,145599,111,129388,18,10301,122,18447,155,138079,140,156526,California
San Luis Obispo,2021-06-27,147,285435,97,145696,46,129434,4,10305,77,18459,69,138148,81,156607,California
San Luis Obispo,2021-06-28,343,285778,246,145942,81,129515,16,10321,130,18395,209,138357,145,156752,California
San Luis Obispo,2021-06-29,483,286261,313,146255,150,129665,20,10341,200,18337,277,138634,219,156971,California
San Luis Obispo,2021-06-30,454,286715,254,146509,163,129828,37,10378,163,18247,289,138923,199,157170,California
San Luis Obispo,2021-07-01,470,287185,310,146819,142,129970,18,10396,206,18210,261,139184,224,157394,California
San Luis Obispo,2021-07-02,434,287619,206,147025,204,130174,24,10420,173,18150,257,139441,197,157591,California
San Luis Obispo,2021-07-03,426,288045,179,147204,239,130413,8,10428,122,17979,302,139743,131,157722,California
San Luis Obispo,2021-07-04,28,288073,16,147220,11,130424,1,10429,11,17974,17,139760,12,157734,California
San Luis Obispo,2021-07-05,170,288243,94,147314,65,130489,11,10440,82,17981,84,139844,91,157825,California
San Luis Obispo,2021-07-06,476,288719,299,147613,144,130633,33,10473,194,17929,279,140123,227,158052,California
San Luis Obispo,2021-07-07,401,289120,219,147832,131,130764,51,10524,161,17901,237,140360,209,158261,California
San Luis Obispo,2021-07-08,397,289517,238,148070,147,130911,12,10536,182,17882,213,140573,194,158455,California
San Luis Obispo,2021-07-09,439,289956,209,148279,204,131115,26,10562,168,17809,267,140840,194,158649,California
San Luis Obispo,2021-07-10,200,290156,130,148409,64,131179,6,10568,86,17788,113,140953,92,158741,California
San Luis Obispo,2021-07-11,74,290230,45,148454,22,131201,7,10575,36,17795,36,140989,43,158784,California
San Luis Obispo,2021-07-12,272,290502,215,148669,50,131251,7,10582,116,17764,154,141143,123,158907,California
San Luis Obispo,2021-07-13,396,290898,269,148938,119,131370,8,10590,154,17690,236,141379,162,159069,California
San Luis Obispo,2021-07-14,438,291336,273,149211,120,131490,45,10635,189,17676,248,141627,234,159303,California
San Luis Obispo,2021-07-15,347,291683,199,149410,143,131633,5,10640,159,17655,185,141812,164,159467,California
San Luis Obispo,2021-07-16,394,292077,186,149596,185,131818,23,10663,211,17714,175,141987,234,159701,California
San Luis Obispo,2021-07-17,175,292252,92,149688,78,131896,5,10668,85,17716,88,142075,90,159791,California
San Luis Obispo,2021-07-18,123,292375,83,149771,30,131926,10,10678,59,17722,63,142138,69,159860,California
San Luis Obispo,2021-07-19,374,292749,252,150023,96,132022,26,10704,181,17736,190,142328,204,160064,California
San Luis Obispo,2021-07-20,518,293267,304,150327,194,132216,20,10724,265,17773,248,142576,285,160349,California
San Luis Obispo,2021-07-21,381,293648,202,150529,146,132362,33,10757,208,17845,169,142745,241,160590,California
San Luis Obispo,2021-07-22,356,294004,161,150690,176,132538,19,10776,177,17862,179,142924,196,160786,California
San Luis Obispo,2021-07-23,465,294469,278,150968,171,132709,16,10792,255,17927,206,143130,271,161057,California
San Luis Obispo,2021-07-24,321,294790,217,151185,90,132799,14,10806,172,17968,145,143275,186,161243,California
San Luis Obispo,2021-07-25,101,294891,54,151239,45,132844,2,10808,56,17982,44,143319,58,161301,California
San Luis Obispo,2021-07-26,363,295254,216,151455,123,132967,24,10832,219,18087,138,143457,243,161544,California
San Luis Obispo,2021-07-27,380,295634,204,151659,146,133113,30,10862,183,18106,194,143651,213,161757,California
San Luis Obispo,2021-07-28,502,296136,326,151985,140,133253,36,10898,274,18192,224,143875,310,162067,California
San Luis Obispo,2021-07-29,386,296522,186,152171,156,133409,44,10942,208,18272,171,144046,251,162318,California
San Luis Obispo,2021-07-30,490,297012,252,152423,211,133620,27,10969,279,18373,205,144251,306,162624,California
San Luis Obispo,2021-07-31,136,297148,90,152513,42,133662,4,10973,72,18385,64,144315,76,162700,California
San Mateo,2020-12-15,26,26,26,26,0,0,0,0,26,26,0,0,26,26,California
San Mateo,2020-12-16,117,143,117,143,0,0,0,0,117,143,0,0,117,143,California
San Mateo,2020-12-17,173,316,173,316,0,0,0,0,173,316,0,0,173,316,California
San Mateo,2020-12-18,769,1085,767,1083,2,2,0,0,769,1085,0,0,769,1085,California
San Mateo,2020-12-19,506,1591,506,1589,0,2,0,0,506,1591,0,0,506,1591,California
San Mateo,2020-12-20,507,2098,506,2095,1,3,0,0,507,2098,0,0,507,2098,California
San Mateo,2020-12-21,1131,3229,1130,3225,1,4,0,0,1131,3229,0,0,1131,3229,California
San Mateo,2020-12-22,1507,4736,1499,4724,8,12,0,0,1506,4734,1,1,1506,4735,California
San Mateo,2020-12-23,1539,6275,1355,6079,184,196,0,0,1539,6273,0,1,1539,6274,California
San Mateo,2020-12-24,867,7142,612,6691,255,451,0,0,867,7140,0,1,867,7141,California
San Mateo,2020-12-25,113,7255,109,6800,4,455,0,0,113,7253,0,1,113,7254,California
San Mateo,2020-12-26,557,7812,417,7217,140,595,0,0,557,7810,0,1,557,7811,California
San Mateo,2020-12-27,298,8110,166,7383,132,727,0,0,298,8108,0,1,298,8109,California
San Mateo,2020-12-28,1060,9170,718,8101,342,1069,0,0,1060,9168,0,1,1060,9169,California
San Mateo,2020-12-29,1138,10308,719,8820,419,1488,0,0,1138,10306,0,1,1138,10307,California
San Mateo,2020-12-30,1273,11581,767,9587,506,1994,0,0,1273,11579,0,1,1273,11580,California
San Mateo,2020-12-31,708,12289,227,9814,481,2475,0,0,707,12285,1,2,707,12287,California
San Mateo,2021-01-01,113,12402,77,9891,36,2511,0,0,113,12398,0,2,113,12400,California
San Mateo,2021-01-02,392,12794,267,10158,125,2636,0,0,392,12790,0,2,392,12792,California
San Mateo,2021-01-03,280,13074,204,10362,76,2712,0,0,277,13064,3,5,277,13069,California
San Mateo,2021-01-04,1053,14127,680,11042,373,3085,0,0,1053,14117,0,5,1053,14122,California
San Mateo,2021-01-05,1206,15333,712,11754,494,3579,0,0,1172,15256,34,39,1173,15295,California
San Mateo,2021-01-06,1471,16804,967,12721,504,4083,0,0,1278,16345,190,229,1279,16574,California
San Mateo,2021-01-07,1448,18252,807,13528,641,4724,0,0,1146,17196,295,524,1146,17720,California
San Mateo,2021-01-08,1867,20119,1213,14741,654,5378,0,0,1156,17645,707,1231,1156,18876,California
San Mateo,2021-01-09,1168,21287,771,15512,397,5775,0,0,715,17907,453,1684,715,19591,California
San Mateo,2021-01-10,702,21989,575,16087,127,5902,0,0,263,17731,439,2123,263,19854,California
San Mateo,2021-01-11,2619,24608,1507,17594,1112,7014,0,0,1545,18205,1074,3197,1548,21402,California
San Mateo,2021-01-12,3437,28045,1923,19517,1514,8528,0,0,2227,19231,1205,4402,2231,23633,California
San Mateo,2021-01-13,3407,31452,1662,21179,1745,10273,0,0,2370,20566,1037,5439,2372,26005,California
San Mateo,2021-01-14,3813,35265,1627,22806,2186,12459,0,0,3108,22976,703,6142,3113,29118,California
San Mateo,2021-01-15,4335,39600,1726,24532,2609,15068,0,0,3799,26247,530,6672,3801,32919,California
San Mateo,2021-01-16,3102,42702,774,25306,2328,17396,0,0,2772,28691,329,7001,2773,35692,California
San Mateo,2021-01-17,1319,44021,312,25618,1007,18403,0,0,1106,29585,212,7213,1106,36798,California
San Mateo,2021-01-18,1368,45389,542,26160,826,19229,0,0,987,30194,378,7591,987,37785,California
San Mateo,2021-01-19,2795,48184,1792,27952,1003,20232,0,0,1987,31377,804,8395,1987,39772,California
San Mateo,2021-01-20,2982,51166,1733,29685,1249,21481,0,0,2135,32669,844,9239,2136,41908,California
San Mateo,2021-01-21,2916,54082,1356,31041,1560,23041,0,0,2316,34391,597,9836,2319,44227,California
San Mateo,2021-01-22,2830,56912,1159,32200,1671,24712,0,0,2532,36629,295,10131,2533,46760,California
San Mateo,2021-01-23,2871,59783,1672,33872,1199,25911,0,0,2513,38784,358,10489,2513,49273,California
San Mateo,2021-01-24,1503,61286,370,34242,1133,27044,0,0,1199,39681,303,10792,1200,50473,California
San Mateo,2021-01-25,4396,65682,3133,37375,1263,28307,0,0,3498,42289,894,11686,3502,53975,California
San Mateo,2021-01-26,4330,70012,3005,40380,1325,29632,0,0,3394,44751,933,12619,3395,57370,California
San Mateo,2021-01-27,2810,72822,1471,41851,1339,30971,0,0,1787,45520,1019,13638,1788,59158,California
San Mateo,2021-01-28,2815,75637,1368,43219,1447,32418,0,0,1960,46641,839,14477,1960,61118,California
San Mateo,2021-01-29,3001,78638,1365,44584,1636,34054,0,0,2145,47936,853,15330,2148,63266,California
San Mateo,2021-01-30,3503,82141,1489,46073,2014,36068,0,0,3044,50523,458,15788,3045,66311,California
San Mateo,2021-01-31,1681,83822,898,46971,783,36851,0,0,1516,51877,162,15950,1516,67827,California
San Mateo,2021-02-01,2927,86749,1349,48320,1578,38429,0,0,2201,53358,721,16671,2202,70029,California
San Mateo,2021-02-02,3205,89954,1736,50056,1469,39898,0,0,2170,54497,1031,17702,2170,72199,California
San Mateo,2021-02-03,5007,94961,2051,52107,2956,42854,0,0,3860,57214,1144,18846,3861,76060,California
San Mateo,2021-02-04,6203,101164,2501,54608,3702,46556,0,0,4915,60851,1282,20128,4919,80979,California
San Mateo,2021-02-05,6814,107978,2549,57157,4265,50821,0,0,4969,63994,1826,21954,4969,85948,California
San Mateo,2021-02-06,3281,111259,1919,59076,1362,52183,0,0,2615,65950,661,22615,2617,88565,California
San Mateo,2021-02-07,1885,113144,1342,60418,543,52726,0,0,1694,67455,189,22804,1694,90259,California
San Mateo,2021-02-08,5292,118436,2267,62685,3025,55751,0,0,3112,68451,2116,24920,3112,93371,California
San Mateo,2021-02-09,6132,124568,3167,65852,2965,58716,0,0,3277,68882,2846,27766,3277,96648,California
San Mateo,2021-02-10,6581,131149,3309,69161,3272,61988,0,0,3296,68912,3266,31032,3296,99944,California
San Mateo,2021-02-11,7096,138245,3610,72771,3486,65474,0,0,3785,69395,3304,34336,3787,103731,California
San Mateo,2021-02-12,6684,144929,3012,75783,3672,69146,0,0,4726,72173,1950,36286,4728,108459,California
San Mateo,2021-02-13,6233,151162,4134,79917,2099,71245,0,0,2651,71249,3575,39861,2651,111110,California
San Mateo,2021-02-14,4749,155911,3129,83046,1620,72865,0,0,1986,70481,2755,42616,1987,113097,California
San Mateo,2021-02-15,3155,159066,1451,84497,1704,74569,0,0,1770,70875,1377,43993,1771,114868,California
San Mateo,2021-02-16,7186,166252,1889,86386,5297,79866,0,0,5304,74302,1879,45872,5306,120174,California
San Mateo,2021-02-17,7116,173368,1954,88340,5162,85028,0,0,5054,77303,2054,47926,5055,125229,California
San Mateo,2021-02-18,6795,180163,4708,93048,2087,87115,0,0,4516,79550,2273,50199,4520,129749,California
San Mateo,2021-02-19,7862,188025,5860,98908,2002,89117,0,0,5818,83334,2035,52234,5819,135568,California
San Mateo,2021-02-20,3848,191873,2468,101376,1380,90497,0,0,2371,84238,1468,53702,2372,137940,California
San Mateo,2021-02-21,2675,194548,1820,103196,855,91352,0,0,1586,84743,1082,54784,1587,139527,California
San Mateo,2021-02-22,4619,199167,3360,106556,1259,92611,0,0,2901,85934,1711,56495,2902,142429,California
San Mateo,2021-02-23,4480,203647,3224,109780,1256,93867,0,0,2593,86653,1874,58369,2593,145022,California
San Mateo,2021-02-24,7596,211243,3409,113189,4187,98054,0,0,5023,89115,2562,60931,5024,150046,California
San Mateo,2021-02-25,9668,220911,4285,117474,5383,103437,0,0,6329,92126,3319,64250,6330,156376,California
San Mateo,2021-02-26,10303,231214,3971,121445,6332,109769,0,0,7105,96057,3176,67426,7107,163483,California
San Mateo,2021-02-27,7217,238431,3719,125164,3498,113267,0,0,3879,96617,3326,70752,3886,167369,California
San Mateo,2021-02-28,4591,243022,2829,127993,1762,115029,0,0,2753,97545,1826,72578,2754,170123,California
San Mateo,2021-03-01,6220,249242,3920,131913,2296,117325,4,4,3056,97461,3146,75724,3062,173185,California
San Mateo,2021-03-02,6344,255586,4511,136424,1832,119157,1,5,3649,98428,2685,78409,3652,176837,California
San Mateo,2021-03-03,8726,264312,4058,140482,4666,123823,2,7,3709,97140,5000,83409,3712,180549,California
San Mateo,2021-03-04,8767,273079,4092,144574,4671,128494,4,11,3896,96197,4845,88254,3902,184451,California
San Mateo,2021-03-05,9475,282554,6363,150937,3108,131602,4,15,6640,100033,2811,91065,6647,191098,California
San Mateo,2021-03-06,8019,290573,5579,156516,2260,133862,180,195,5868,103943,2136,93201,6046,197144,California
San Mateo,2021-03-07,3692,294265,2447,158963,1094,134956,151,346,2128,104664,1560,94761,2281,199425,California
San Mateo,2021-03-08,4563,298828,2558,161521,1767,136723,238,584,3305,106951,1251,96012,3538,202963,California
San Mateo,2021-03-09,5475,304303,2864,164385,2315,139038,296,880,3827,109434,1634,97646,4117,207080,California
San Mateo,2021-03-10,7270,311573,2912,167297,4058,143096,300,1180,4840,112151,2415,100061,5132,212212,California
San Mateo,2021-03-11,9147,320720,5736,173033,3014,146110,397,1577,3639,110705,5474,105535,4028,216240,California
San Mateo,2021-03-12,10617,331337,6696,179729,3533,149643,388,1965,3577,107644,7017,112552,3956,220196,California
San Mateo,2021-03-13,8286,339623,3518,183247,3127,152770,1641,3606,4037,109064,4232,116784,5652,225848,California
San Mateo,2021-03-14,4999,344622,3382,186629,1512,154282,105,3711,2654,109482,2337,119121,2755,228603,California
San Mateo,2021-03-15,7187,351809,4639,191268,2367,156649,181,3892,3724,109934,3452,122573,3904,232507,California
San Mateo,2021-03-16,11992,363801,4397,195665,7471,164120,124,4016,4787,107666,7182,129755,4914,237421,California
San Mateo,2021-03-17,10949,374750,4456,200121,6345,170465,148,4164,4889,106675,6027,135782,5036,242457,California
San Mateo,2021-03-18,7389,382139,4167,204288,3030,173495,192,4356,4360,108205,3018,138800,4548,247005,California
San Mateo,2021-03-19,7529,389668,4875,209163,1981,175476,673,5029,3587,108536,3927,142727,4258,251263,California
San Mateo,2021-03-20,8541,398209,6593,215756,1609,177085,339,5368,5416,111181,3109,145836,5754,257017,California
San Mateo,2021-03-21,4258,402467,3248,219004,783,177868,227,5595,2257,111674,1987,147823,2480,259497,California
San Mateo,2021-03-22,5332,407799,3651,222655,1264,179132,417,6012,2784,112343,2530,150353,3199,262696,California
San Mateo,2021-03-23,9956,417755,4567,227222,5195,184327,194,6206,4402,111419,5520,155873,4596,267292,California
San Mateo,2021-03-24,9597,427352,5509,232731,3943,188270,145,6351,4047,110136,5472,161345,4189,271481,California
San Mateo,2021-03-25,10272,437624,5004,237735,4956,193226,312,6663,4387,109062,5775,167120,4701,276182,California
San Mateo,2021-03-26,11382,449006,7823,245558,3389,196615,170,6833,4228,106355,7105,174225,4398,280580,California
San Mateo,2021-03-27,10689,459695,8199,253757,2381,198996,109,6942,4744,105278,5923,180148,4846,285426,California
San Mateo,2021-03-28,4278,463973,2780,256537,1387,200383,111,7053,1964,105052,2301,182449,2075,287501,California
San Mateo,2021-03-29,6096,470069,3777,260314,2065,202448,254,7307,2691,104612,3382,185831,2942,290443,California
San Mateo,2021-03-30,7227,477296,4092,264406,2982,205430,153,7460,3870,105293,3341,189172,4022,294465,California
San Mateo,2021-03-31,7360,484656,4621,269027,2592,208022,147,7607,3844,105790,3496,192668,3993,298458,California
San Mateo,2021-04-01,10695,495351,5269,274296,4213,212235,1213,8820,5763,107856,4873,197541,6939,305397,California
San Mateo,2021-04-02,10988,506339,5223,279519,4095,216330,1670,10490,5750,110031,5215,202756,7390,312787,California
San Mateo,2021-04-03,10071,516410,5762,285281,2463,218793,1846,12336,5106,111999,4954,207710,6922,319709,California
San Mateo,2021-04-04,5444,521854,2623,287904,1567,220360,1254,13590,1706,111218,3722,211432,2941,322650,California
San Mateo,2021-04-05,9012,530866,4780,292684,2496,222856,1736,15326,3873,111677,5119,216551,5578,328228,California
San Mateo,2021-04-06,13358,544224,8258,300942,3238,226094,1862,17188,7568,115317,5770,222321,9410,337638,California
San Mateo,2021-04-07,11448,555672,5294,306236,4460,230554,1694,18882,4846,115250,6582,228903,6515,344153,California
San Mateo,2021-04-08,10257,565929,5070,311306,2567,233121,2620,21502,4554,116712,5681,234584,7143,351296,California
San Mateo,2021-04-09,11422,577351,5563,316869,3369,236490,2490,23992,5136,118031,6279,240863,7598,358894,California
San Mateo,2021-04-10,11413,588764,5774,322643,4177,240667,1462,25454,4709,117507,6668,247531,6144,365038,California
San Mateo,2021-04-11,6693,595457,3299,325942,884,241551,2510,27964,2326,117963,4360,251891,4816,369854,California
San Mateo,2021-04-12,7394,602851,4502,330444,1909,243460,983,28947,3557,118679,3813,255704,4529,374383,California
San Mateo,2021-04-13,8317,611168,5171,335615,3135,246595,11,28958,4415,119220,3887,259591,4428,378811,California
San Mateo,2021-04-14,8468,619636,5510,341125,2957,249552,1,28959,4351,119482,4098,263689,4360,383171,California
San Mateo,2021-04-15,11346,630982,7528,348653,3816,253368,2,28961,7405,122983,3908,267597,7409,390580,California
San Mateo,2021-04-16,10100,641082,6949,355602,3133,256501,18,28979,6355,125645,3717,271314,6379,396959,California
San Mateo,2021-04-17,9985,651067,6647,362249,3336,259837,2,28981,6198,128081,3774,275088,6210,403169,California
San Mateo,2021-04-18,5752,656819,2877,365126,2875,262712,0,28981,3862,130074,1875,276963,3868,407037,California
San Mateo,2021-04-19,8493,665312,5525,370651,2968,265680,0,28981,5510,132632,2965,279928,5523,412560,California
San Mateo,2021-04-20,10828,676140,6199,376850,4628,270308,1,28982,6914,135669,3889,283817,6926,419486,California
San Mateo,2021-04-21,9959,686099,6928,383778,3029,273337,2,28984,6169,138081,3764,287581,6176,425662,California
San Mateo,2021-04-22,10311,696410,6980,390758,3329,276666,2,28986,5740,139299,4531,292112,5749,431411,California
San Mateo,2021-04-23,10055,706465,6747,397505,3308,279974,0,28986,5660,140613,4364,296476,5678,437089,California
San Mateo,2021-04-24,11487,717952,8192,405697,3294,283268,1,28987,5910,140988,5546,302022,5921,443010,California
San Mateo,2021-04-25,5606,723558,3890,409587,1714,284982,2,28989,4007,143426,1582,303604,4020,447030,California
San Mateo,2021-04-26,6967,730525,5047,414634,1911,286893,9,28998,4034,144565,2917,306521,4056,451086,California
San Mateo,2021-04-27,11643,742168,8212,422846,3275,290168,156,29154,4767,142661,6838,313359,4934,456020,California
San Mateo,2021-04-28,8268,750436,4814,427660,3248,293416,206,29360,4425,143477,3822,317181,4638,460658,California
San Mateo,2021-04-29,8518,758954,4081,431741,4261,297677,176,29536,3863,142910,4622,321803,4055,464713,California
San Mateo,2021-04-30,8493,767447,5389,437130,2942,300619,162,29698,3647,141924,4815,326618,3829,468542,California
San Mateo,2021-05-01,6268,773715,4199,441329,1951,302570,118,29816,2739,141289,3507,330125,2872,471414,California
San Mateo,2021-05-02,3218,776933,1756,443085,1389,303959,73,29889,1167,140495,2040,332165,1246,472660,California
San Mateo,2021-05-03,6187,783120,4617,447702,1422,305381,148,30037,1870,138212,4302,336467,2019,474679,California
San Mateo,2021-05-04,7766,790886,5372,453074,2218,307599,176,30213,2572,135799,5179,341646,2766,477445,California
San Mateo,2021-05-05,7299,798185,4874,457948,2263,309862,162,30375,2468,133628,4800,346446,2629,480074,California
San Mateo,2021-05-06,9088,807273,7148,465096,1759,311621,181,30556,1801,128350,7264,353710,1986,482060,California
San Mateo,2021-05-07,8466,815739,6092,471188,2088,313709,286,30842,1871,123958,6565,360275,2173,484233,California
San Mateo,2021-05-08,7051,822790,4380,475568,2430,316139,241,31083,1946,121061,5088,365363,2191,486424,California
San Mateo,2021-05-09,3170,825960,2468,478036,629,316768,73,31156,945,119866,2214,367577,1019,487443,California
San Mateo,2021-05-10,4907,830867,3542,481578,1192,317960,173,31329,747,116648,4147,371724,929,488372,California
San Mateo,2021-05-11,7390,838257,5609,487187,1654,319614,127,31456,1753,112917,5614,377338,1883,490255,California
San Mateo,2021-05-12,7171,845428,5184,492371,1772,321386,215,31671,1443,108863,5713,383051,1659,491914,California
San Mateo,2021-05-13,9816,855244,7365,499736,2355,323741,96,31767,3442,106074,6340,389391,3551,495465,California
San Mateo,2021-05-14,8597,863841,6373,506109,2107,325848,117,31884,2594,102813,5980,395371,2719,498184,California
San Mateo,2021-05-15,10731,874572,8414,514523,2216,328064,101,31985,4760,101742,5952,401323,4881,503065,California
San Mateo,2021-05-16,7343,881915,5245,519768,2027,330091,71,32056,2292,99076,5030,406353,2364,505429,California
San Mateo,2021-05-17,7250,889165,5150,524918,1990,332081,110,32166,2142,96247,5088,411441,2259,507688,California
San Mateo,2021-05-18,8563,897728,5930,530848,2536,334617,97,32263,3074,94063,5362,416803,3178,510866,California
San Mateo,2021-05-19,7970,905698,5938,536786,1909,336526,123,32386,3584,93443,4331,421134,3711,514577,California
San Mateo,2021-05-20,5825,911523,3636,540422,2054,338580,135,32521,2202,92188,3596,424730,2341,516918,California
San Mateo,2021-05-21,7042,918565,4791,545213,2106,340686,145,32666,1869,89052,5151,429881,2015,518933,California
San Mateo,2021-05-22,6437,925002,4379,549592,1990,342676,68,32734,2665,88037,3750,433631,2735,521668,California
San Mateo,2021-05-23,3165,928167,1800,551392,1275,343951,90,32824,1204,87384,1947,435578,1294,522962,California
San Mateo,2021-05-24,3709,931876,2452,553844,1108,345059,149,32973,1246,86343,2436,438014,1395,524357,California
San Mateo,2021-05-25,4788,936664,3013,556857,1598,346657,177,33150,1568,84893,3198,441212,1748,526105,California
San Mateo,2021-05-26,5737,942401,3094,559951,2523,349180,120,33270,1783,82866,3930,445142,1903,528008,California
San Mateo,2021-05-27,3791,946192,2198,562149,1491,350671,102,33372,1194,81590,2568,447710,1292,529300,California
San Mateo,2021-05-28,3503,949695,2198,564347,1219,351890,86,33458,1309,80835,2149,449859,1394,530694,California
San Mateo,2021-05-29,3262,952957,2307,566654,902,352792,53,33511,1245,80145,1986,451845,1296,531990,California
San Mateo,2021-05-30,1661,954618,1121,567775,479,353271,61,33572,651,79858,999,452844,712,532702,California
San Mateo,2021-05-31,438,955056,276,568051,154,353425,8,33580,159,79749,276,453120,167,532869,California
San Mateo,2021-06-01,3340,958396,1980,570031,1263,354688,97,33677,955,78429,2370,455490,1050,533919,California
San Mateo,2021-06-02,2777,961173,1842,571873,855,355543,80,33757,1061,77869,1699,457189,1139,535058,California
San Mateo,2021-06-03,3841,965014,3017,574890,710,356253,114,33871,833,75821,2992,460181,944,536002,California
San Mateo,2021-06-04,4129,969143,3178,578068,856,357109,95,33966,1110,74017,2998,463179,1194,537196,California
San Mateo,2021-06-05,5199,974342,4544,582612,556,357665,99,34065,959,70868,4207,467386,1058,538254,California
San Mateo,2021-06-06,2541,976883,2091,584703,388,358053,62,34127,477,69362,2041,469427,535,538789,California
San Mateo,2021-06-07,3117,980000,2614,587317,421,358474,82,34209,692,67717,2416,471843,771,539560,California
San Mateo,2021-06-08,4101,984101,3463,590780,532,359006,106,34315,968,65694,3098,474941,1075,540635,California
San Mateo,2021-06-09,4156,988257,3579,594359,508,359514,69,34384,622,62862,3522,478463,690,541325,California
San Mateo,2021-06-10,2997,991254,2431,596790,450,359964,116,34500,740,61477,2241,480704,856,542181,California
San Mateo,2021-06-11,2883,994137,2312,599102,458,360422,113,34613,926,60571,1945,482649,1039,543220,California
San Mateo,2021-06-12,3173,997310,2827,601929,265,360687,81,34694,771,59037,2386,485035,852,544072,California
San Mateo,2021-06-13,1459,998769,1100,603029,296,360983,63,34757,351,58361,1090,486125,414,544486,California
San Mateo,2021-06-14,2454,1001223,2120,605149,250,361233,84,34841,704,57432,1717,487842,788,545274,California
San Mateo,2021-06-15,2249,1003472,1786,606935,344,361577,119,34960,668,56657,1563,489405,788,546062,California
San Mateo,2021-06-16,2450,1005922,2030,608965,262,361839,158,35118,668,55742,1737,491142,822,546884,California
San Mateo,2021-06-17,1971,1007893,1634,610599,250,362089,87,35205,697,55305,1222,492364,785,547669,California
San Mateo,2021-06-18,2120,1010013,1774,612373,267,362356,79,35284,609,54498,1492,493856,685,548354,California
San Mateo,2021-06-19,1798,1011811,1578,613951,163,362519,57,35341,598,54022,1129,494985,653,549007,California
San Mateo,2021-06-20,771,1012582,701,614652,59,362578,11,35352,288,53871,450,495435,299,549306,California
San Mateo,2021-06-21,1252,1013834,936,615588,239,362817,77,35429,582,53868,664,496099,661,549967,California
San Mateo,2021-06-22,1587,1015421,1287,616875,208,363025,92,35521,591,53570,980,497079,682,550649,California
San Mateo,2021-06-23,1851,1017272,1571,618446,178,363203,102,35623,623,53099,1196,498275,725,551374,California
San Mateo,2021-06-24,1477,1018749,1096,619542,279,363482,102,35725,535,52812,921,499196,634,552008,California
San Mateo,2021-06-25,1791,1020540,1488,621030,225,363707,78,35803,664,52442,1112,500308,742,552750,California
San Mateo,2021-06-26,1254,1021794,1056,622086,140,363847,58,35861,495,52253,741,501049,552,553302,California
San Mateo,2021-06-27,656,1022450,533,622619,77,363924,46,35907,289,52222,366,501415,335,553637,California
San Mateo,2021-06-28,1245,1023695,1064,623683,106,364030,75,35982,487,52039,744,502159,561,554198,California
San Mateo,2021-06-29,1438,1025133,1157,624840,197,364227,84,36066,489,51668,940,503099,569,554767,California
San Mateo,2021-06-30,1278,1026411,1048,625888,130,364357,100,36166,571,51643,695,503794,670,555437,California
San Mateo,2021-07-01,1238,1027649,1050,626938,126,364483,62,36228,502,51494,713,504507,564,556001,California
San Mateo,2021-07-02,1470,1029119,1222,628160,173,364656,75,36303,558,51226,901,505408,633,556634,California
San Mateo,2021-07-03,1065,1030184,908,629068,115,364771,42,36345,419,51052,633,506041,459,557093,California
San Mateo,2021-07-04,49,1030233,43,629111,0,364771,6,36351,23,51056,25,506066,29,557122,California
San Mateo,2021-07-05,820,1031053,688,629799,105,364876,27,36378,355,50977,458,506524,379,557501,California
San Mateo,2021-07-06,1340,1032393,1109,630908,145,365021,86,36464,541,50813,788,507312,624,558125,California
San Mateo,2021-07-07,1132,1033525,922,631830,132,365153,78,36542,407,50586,712,508024,485,558610,California
San Mateo,2021-07-08,1166,1034691,947,632777,155,365308,64,36606,377,50247,781,508805,442,559052,California
San Mateo,2021-07-09,1172,1035863,923,633700,169,365477,80,36686,537,50238,623,509428,614,559666,California
San Mateo,2021-07-10,822,1036685,668,634368,107,365584,47,36733,318,50107,495,509923,364,560030,California
San Mateo,2021-07-11,483,1037168,388,634756,62,365646,33,36766,210,50087,262,510185,242,560272,California
San Mateo,2021-07-12,1079,1038247,935,635691,106,365752,38,36804,403,49856,672,510857,441,560713,California
San Mateo,2021-07-13,1041,1039288,834,636525,149,365901,58,36862,432,49748,598,511455,490,561203,California
San Mateo,2021-07-14,1097,1040385,928,637453,115,366016,54,36916,453,49621,635,512090,508,561711,California
San Mateo,2021-07-15,1033,1041418,816,638269,151,366167,66,36982,427,49514,598,512688,491,562202,California
San Mateo,2021-07-16,1092,1042510,881,639150,156,366323,55,37037,468,49420,616,513304,522,562724,California
San Mateo,2021-07-17,892,1043402,769,639919,87,366410,36,37073,413,49399,470,513774,449,563173,California
San Mateo,2021-07-18,527,1043929,439,640358,69,366479,19,37092,250,49406,262,514036,269,563442,California
San Mateo,2021-07-19,1097,1045026,912,641270,129,366608,56,37148,513,49402,573,514609,569,564011,California
San Mateo,2021-07-20,1045,1046071,821,642091,160,366768,64,37212,476,49396,545,515154,539,564550,California
San Mateo,2021-07-21,1139,1047210,916,643007,154,366922,69,37281,577,49493,549,515703,646,565196,California
San Mateo,2021-07-22,1144,1048354,892,643899,180,367102,72,37353,524,49482,606,516309,595,565791,California
San Mateo,2021-07-23,1048,1049402,841,644740,160,367262,47,37400,535,49564,500,516809,582,566373,California
San Mateo,2021-07-24,950,1050352,791,645531,117,367379,42,37442,438,49553,490,517299,479,566852,California
San Mateo,2021-07-25,404,1050756,314,645845,58,367437,32,37474,272,49728,129,517428,304,567156,California
San Mateo,2021-07-26,956,1051712,739,646584,156,367593,61,37535,559,49964,383,517811,619,567775,California
San Mateo,2021-07-27,1168,1052880,972,647556,134,367727,62,37597,595,50061,558,518369,655,568430,California
San Mateo,2021-07-28,994,1053874,779,648335,131,367858,84,37681,521,50203,462,518831,604,569034,California
San Mateo,2021-07-29,1002,1054876,837,649172,126,367984,39,37720,547,50345,444,519275,586,569620,California
San Mateo,2021-07-30,1090,1055966,896,650068,158,368142,36,37756,562,50439,503,519778,597,570217,California
San Mateo,2021-07-31,576,1056542,445,650513,93,368235,38,37794,331,50569,239,520017,369,570586,California
Santa Barbara,2020-12-15,2,2,2,2,0,0,0,0,2,2,0,0,2,2,California
Santa Barbara,2020-12-16,2,4,2,4,0,0,0,0,2,4,0,0,2,4,California
Santa Barbara,2020-12-17,162,166,162,166,0,0,0,0,162,166,0,0,162,166,California
Santa Barbara,2020-12-18,391,557,390,556,1,1,0,0,391,557,0,0,391,557,California
Santa Barbara,2020-12-19,328,885,328,884,0,1,0,0,328,885,0,0,328,885,California
Santa Barbara,2020-12-20,234,1119,234,1118,0,1,0,0,234,1119,0,0,234,1119,California
Santa Barbara,2020-12-21,659,1778,657,1775,2,3,0,0,659,1778,0,0,659,1778,California
Santa Barbara,2020-12-22,250,2028,248,2023,2,5,0,0,250,2028,0,0,250,2028,California
Santa Barbara,2020-12-23,326,2354,207,2230,119,124,0,0,326,2354,0,0,326,2354,California
Santa Barbara,2020-12-24,89,2443,41,2271,48,172,0,0,89,2443,0,0,89,2443,California
Santa Barbara,2020-12-26,325,2768,67,2338,258,430,0,0,325,2768,0,0,325,2768,California
Santa Barbara,2020-12-27,62,2830,1,2339,61,491,0,0,62,2830,0,0,62,2830,California
Santa Barbara,2020-12-28,360,3190,226,2565,134,625,0,0,360,3190,0,0,360,3190,California
Santa Barbara,2020-12-29,562,3752,361,2926,201,826,0,0,562,3752,0,0,562,3752,California
Santa Barbara,2020-12-30,582,4334,397,3323,185,1011,0,0,582,4334,0,0,582,4334,California
Santa Barbara,2020-12-31,241,4575,114,3437,127,1138,0,0,241,4575,0,0,241,4575,California
Santa Barbara,2021-01-01,121,4696,115,3552,6,1144,0,0,121,4696,0,0,121,4696,California
Santa Barbara,2021-01-02,601,5297,235,3787,366,1510,0,0,601,5297,0,0,601,5297,California
Santa Barbara,2021-01-03,23,5320,15,3802,8,1518,0,0,23,5320,0,0,23,5320,California
Santa Barbara,2021-01-04,303,5623,241,4043,62,1580,0,0,302,5622,0,0,302,5622,California
Santa Barbara,2021-01-05,757,6380,383,4426,374,1954,0,0,727,6319,30,30,727,6349,California
Santa Barbara,2021-01-06,661,7041,278,4704,383,2337,0,0,555,6769,105,135,555,6904,California
Santa Barbara,2021-01-07,1034,8075,712,5416,322,2659,0,0,482,6703,548,683,482,7386,California
Santa Barbara,2021-01-08,1206,9281,851,6267,355,3014,0,0,703,6903,503,1186,703,8089,California
Santa Barbara,2021-01-09,566,9847,297,6564,269,3283,0,0,315,6967,251,1437,315,8404,California
Santa Barbara,2021-01-10,64,9911,51,6615,13,3296,0,0,45,6993,19,1456,45,8449,California
Santa Barbara,2021-01-11,853,10764,684,7299,169,3465,0,0,620,7381,232,1688,620,9069,California
Santa Barbara,2021-01-12,1442,12206,648,7947,794,4259,0,0,1279,8497,163,1851,1279,10348,California
Santa Barbara,2021-01-13,1223,13429,272,8219,951,5210,0,0,1096,9466,127,1978,1096,11444,California
Santa Barbara,2021-01-14,1262,14691,141,8360,1121,6331,0,0,1206,10618,55,2033,1207,12651,California
Santa Barbara,2021-01-15,1812,16503,426,8786,1386,7717,0,0,1729,12266,81,2114,1729,14380,California
Santa Barbara,2021-01-16,1278,17781,202,8988,1076,8793,0,0,1238,13465,39,2153,1238,15618,California
Santa Barbara,2021-01-17,127,17908,24,9012,103,8896,0,0,124,13586,3,2156,124,15742,California
Santa Barbara,2021-01-18,1150,19058,421,9433,729,9625,0,0,964,14364,186,2342,964,16706,California
Santa Barbara,2021-01-19,1662,20720,572,10005,1090,10715,0,0,1379,15463,280,2622,1379,18085,California
Santa Barbara,2021-01-20,2238,22958,661,10666,1577,12292,0,0,1811,16849,426,3048,1812,19897,California
Santa Barbara,2021-01-21,3206,26164,1922,12588,1284,13576,0,0,3041,19728,164,3212,3043,22940,California
Santa Barbara,2021-01-22,2955,29119,1798,14386,1157,14733,0,0,2781,22339,171,3383,2782,25722,California
Santa Barbara,2021-01-23,1741,30860,1107,15493,634,15367,0,0,1220,23039,520,3903,1220,26942,California
Santa Barbara,2021-01-24,845,31705,746,16239,99,15466,0,0,834,23863,10,3913,834,27776,California
Santa Barbara,2021-01-25,1243,32948,494,16733,749,16215,0,0,1009,24638,234,4147,1009,28785,California
Santa Barbara,2021-01-26,2095,35043,510,17243,1585,17800,0,0,1713,25971,380,4527,1713,30498,California
Santa Barbara,2021-01-27,1167,36210,398,17641,769,18569,0,0,902,26611,264,4791,904,31402,California
Santa Barbara,2021-01-28,905,37115,299,17940,606,19175,0,0,688,27087,212,5003,688,32090,California
Santa Barbara,2021-01-29,1348,38463,527,18467,821,19996,0,0,982,27709,362,5365,984,33074,California
Santa Barbara,2021-01-30,1903,40366,1412,19879,491,20487,0,0,1484,28777,416,5781,1484,34558,California
Santa Barbara,2021-01-31,1454,41820,1213,21092,241,20728,0,0,1414,30151,40,5821,1414,35972,California
Santa Barbara,2021-02-01,953,42773,522,21614,431,21159,0,0,552,30302,401,6222,552,36524,California
Santa Barbara,2021-02-02,1818,44591,685,22299,1133,22292,0,0,1050,30586,766,6988,1050,37574,California
Santa Barbara,2021-02-03,1972,46563,1085,23384,887,23179,0,0,1516,31657,445,7433,1516,39090,California
Santa Barbara,2021-02-04,2817,49380,1883,25267,934,24113,0,0,2517,33880,294,7727,2517,41607,California
Santa Barbara,2021-02-05,2928,52308,2081,27348,847,24960,0,0,2274,35503,651,8378,2274,43881,California
Santa Barbara,2021-02-06,1206,53514,333,27681,873,25833,0,0,794,35886,412,8790,795,44676,California
Santa Barbara,2021-02-07,309,53823,266,27947,43,25876,0,0,270,36119,37,8827,270,44946,California
Santa Barbara,2021-02-08,951,54774,304,28251,647,26523,0,0,661,36490,290,9117,661,45607,California
Santa Barbara,2021-02-09,2456,57230,322,28573,2134,28657,0,0,1128,36302,1316,10433,1128,46735,California
Santa Barbara,2021-02-10,2779,60009,1502,30075,1277,29934,0,0,744,35027,2020,12453,745,47480,California
Santa Barbara,2021-02-11,4225,64234,2825,32900,1400,31334,0,0,643,32102,3568,16021,643,48123,California
Santa Barbara,2021-02-12,3321,67555,943,33843,2378,33712,0,0,777,30341,2538,18559,777,48900,California
Santa Barbara,2021-02-13,1247,68802,345,34188,902,34614,0,0,565,30226,680,19239,565,49465,California
Santa Barbara,2021-02-14,343,69145,44,34232,299,34913,0,0,292,30469,51,19290,294,49759,California
Santa Barbara,2021-02-15,987,70132,352,34584,635,35548,0,0,498,30483,486,19776,500,50259,California
Santa Barbara,2021-02-16,2188,72320,463,35047,1725,37273,0,0,730,29760,1453,21229,730,50989,California
Santa Barbara,2021-02-17,1462,73782,335,35382,1127,38400,0,0,521,29348,936,22165,524,51513,California
Santa Barbara,2021-02-18,3292,77074,2679,38061,613,39013,0,0,1538,29173,1714,23879,1539,53052,California
Santa Barbara,2021-02-19,3622,80696,2662,40723,960,39973,0,0,2340,30235,1279,25158,2341,55393,California
Santa Barbara,2021-02-20,2344,83040,1540,42263,804,40777,0,0,1760,31422,574,25732,1761,57154,California
Santa Barbara,2021-02-21,149,83189,119,42382,30,40807,0,0,64,31403,83,25815,64,57218,California
Santa Barbara,2021-02-22,984,84173,268,42650,716,41523,0,0,284,30989,698,26513,284,57502,California
Santa Barbara,2021-02-23,3374,87547,1120,43770,2254,43777,0,0,441,28501,2930,29443,442,57944,California
Santa Barbara,2021-02-24,3381,90928,1162,44932,2219,45996,0,0,758,26653,2606,32049,758,58702,California
Santa Barbara,2021-02-25,3639,94567,2024,46956,1615,47611,0,0,1040,25109,2588,34637,1044,59746,California
Santa Barbara,2021-02-26,3851,98418,2304,49260,1547,49158,0,0,2078,25428,1760,36397,2079,61825,California
Santa Barbara,2021-02-27,1600,100018,587,49847,1013,50171,0,0,893,25623,702,37099,897,62722,California
Santa Barbara,2021-02-28,1167,101185,232,50079,935,51106,0,0,958,26382,201,37300,960,63682,California
Santa Barbara,2021-03-01,1749,102934,527,50606,1220,52326,2,2,1179,27016,549,37849,1183,64865,California
Santa Barbara,2021-03-02,2768,105702,454,51060,2313,54639,1,3,2242,28747,513,38362,2244,67109,California
Santa Barbara,2021-03-03,4789,110491,2191,53251,2596,57235,2,5,4169,32313,610,38972,4176,71285,California
Santa Barbara,2021-03-04,3567,114058,2390,55641,1177,58412,0,5,2984,34726,573,39545,2986,74271,California
Santa Barbara,2021-03-05,3950,118008,2267,57908,1623,60035,60,65,3203,37249,741,40286,3264,77535,California
Santa Barbara,2021-03-06,2514,120522,760,58668,1533,61568,221,286,1724,38403,785,41071,1939,79474,California
Santa Barbara,2021-03-07,711,121233,126,58794,345,61913,240,526,414,38762,296,41367,655,80129,California
Santa Barbara,2021-03-08,1613,122846,385,59179,869,62782,359,885,808,39128,799,42166,1165,81294,California
Santa Barbara,2021-03-09,2819,125665,355,59534,1686,64468,778,1663,748,38574,2067,44233,1513,82807,California
Santa Barbara,2021-03-10,2785,128450,556,60090,1170,65638,1059,2722,1060,38963,1719,45952,2108,84915,California
Santa Barbara,2021-03-11,5592,134042,3026,63116,1449,67087,1117,3839,2268,39033,3304,49256,3374,88289,California
Santa Barbara,2021-03-12,3729,137771,2120,65236,1173,68260,436,4275,2200,40140,1521,50777,2628,90917,California
Santa Barbara,2021-03-13,3529,141300,1954,67190,1367,69627,208,4483,2709,42244,813,51590,2917,93834,California
Santa Barbara,2021-03-14,835,142135,412,67602,367,69994,56,4539,509,42486,324,51914,566,94400,California
Santa Barbara,2021-03-15,2125,144260,704,68306,1127,71121,294,4833,1271,43203,846,52760,1563,95963,California
Santa Barbara,2021-03-16,3742,148002,1186,69492,2214,73335,342,5175,2742,45293,995,53755,3085,99048,California
Santa Barbara,2021-03-17,3344,151346,988,70480,1951,75286,405,5580,2344,47040,997,54752,2744,101792,California
Santa Barbara,2021-03-18,5296,156642,2809,73289,2283,77569,204,5784,4043,50049,1236,55988,4245,106037,California
Santa Barbara,2021-03-19,4498,161140,2784,76073,1377,78946,337,6121,3040,51972,1452,57440,3375,109412,California
Santa Barbara,2021-03-20,2235,163375,845,76918,1367,80313,23,6144,1368,52502,863,58303,1393,110805,California
Santa Barbara,2021-03-21,1186,164561,387,77305,767,81080,32,6176,851,53054,331,58634,883,111688,California
Santa Barbara,2021-03-22,2792,167353,1930,79235,816,81896,46,6222,2205,54727,578,59212,2251,113939,California
Santa Barbara,2021-03-23,4507,171860,2286,81521,2118,84014,103,6325,3702,57735,795,60007,3803,117742,California
Santa Barbara,2021-03-24,5464,177324,3166,84687,1530,85544,768,7093,2927,58909,2514,62521,3688,121430,California
Santa Barbara,2021-03-25,5607,182931,3286,87973,2121,87665,200,7293,2709,58940,2879,65400,2910,124340,California
Santa Barbara,2021-03-26,5132,188063,3248,91221,1576,89241,308,7601,2117,58369,2995,68395,2424,126764,California
Santa Barbara,2021-03-27,3000,191063,1240,92461,1716,90957,44,7645,1612,58641,1383,69778,1655,128419,California
Santa Barbara,2021-03-28,2814,193877,1674,94135,1112,92069,28,7673,1871,59603,938,70716,1900,130319,California
Santa Barbara,2021-03-29,4066,197943,2092,96227,1901,93970,73,7746,3215,62046,845,71561,3288,133607,California
Santa Barbara,2021-03-30,6835,204778,3531,99758,3153,97123,151,7897,4493,64365,2323,73884,4642,138249,California
Santa Barbara,2021-03-31,8705,213483,5533,105291,3105,100228,67,7964,4982,65713,3700,77584,5048,143297,California
Santa Barbara,2021-04-01,7090,220573,5234,110525,1592,101820,264,8228,4165,67245,2897,80481,4429,147726,California
Santa Barbara,2021-04-02,6673,227246,4575,115100,1501,103321,597,8825,3423,68024,3239,83720,4018,151744,California
Santa Barbara,2021-04-03,3834,231080,2122,117222,1643,104964,69,8894,2515,69294,1312,85032,2582,154326,California
Santa Barbara,2021-04-04,916,231996,449,117671,426,105390,41,8935,499,69419,415,85447,540,154866,California
Santa Barbara,2021-04-05,3511,235507,2311,119982,933,106323,267,9202,2186,70557,1315,86762,2453,157319,California
Santa Barbara,2021-04-06,5529,241036,2851,122833,2119,108442,559,9761,3372,72345,2136,88898,3924,161243,California
Santa Barbara,2021-04-07,6056,247092,3303,126136,2210,110652,543,10304,4107,75053,1939,90837,4647,165890,California
Santa Barbara,2021-04-08,7455,254547,5067,131203,655,111307,1733,12037,3439,76215,4005,94842,5167,171057,California
Santa Barbara,2021-04-09,7356,261903,4880,136083,1107,112414,1369,13406,3299,76830,4046,98888,4661,175718,California
Santa Barbara,2021-04-10,6730,268633,4667,140750,1445,113859,618,14024,4575,79875,2145,101033,5190,180908,California
Santa Barbara,2021-04-11,2692,271325,1971,142721,418,114277,303,14327,1859,81206,825,101858,2156,183064,California
Santa Barbara,2021-04-12,4424,275749,2843,145564,1026,115303,555,14882,1910,81165,2505,104363,2464,185528,California
Santa Barbara,2021-04-13,6391,282140,4190,149754,2195,117498,6,14888,2626,80039,3757,108120,2631,188159,California
Santa Barbara,2021-04-14,6831,288971,4432,154186,2397,119895,2,14890,4244,81710,2577,110697,4248,192407,California
Santa Barbara,2021-04-15,7018,295989,4118,158304,2899,122794,1,14891,3765,82236,3241,113938,3767,196174,California
Santa Barbara,2021-04-16,6447,302436,3786,162090,2651,125445,10,14901,4434,84688,1991,115929,4443,200617,California
Santa Barbara,2021-04-17,5360,307796,3883,165973,1477,126922,0,14901,4092,87528,1252,117181,4092,204709,California
Santa Barbara,2021-04-18,2200,309996,1535,167508,665,127587,0,14901,378,86095,1812,118993,379,205088,California
Santa Barbara,2021-04-19,3289,313285,2269,169777,1014,128601,6,14907,1032,84883,2249,121242,1037,206125,California
Santa Barbara,2021-04-20,5973,319258,3995,173772,1976,130577,2,14909,1658,82246,4295,125537,1658,207783,California
Santa Barbara,2021-04-21,5626,324884,3727,177499,1899,132476,0,14909,1783,80210,3821,129358,1785,209568,California
Santa Barbara,2021-04-22,5226,330110,2618,180117,2607,135083,1,14910,1503,78015,3702,133060,1507,211075,California
Santa Barbara,2021-04-23,5737,335847,3978,184095,1759,136842,0,14910,2016,76327,3704,136764,2016,213091,California
Santa Barbara,2021-04-24,4521,340368,2947,187042,1569,138411,5,14915,1651,75133,2851,139615,1657,214748,California
Santa Barbara,2021-04-25,1874,342242,1208,188250,666,139077,0,14915,500,74269,1364,140979,500,215248,California
Santa Barbara,2021-04-26,3312,345554,2018,190268,1273,140350,21,14936,580,72149,2722,143701,602,215850,California
Santa Barbara,2021-04-27,4059,349613,2237,192505,1719,142069,103,15039,1193,70591,2854,146555,1296,217146,California
Santa Barbara,2021-04-28,4955,354568,2882,195387,1956,144025,117,15156,1414,68605,3521,150076,1535,218681,California
Santa Barbara,2021-04-29,5375,359943,3900,199287,1244,145269,231,15387,1478,66436,3878,153954,1709,220390,California
Santa Barbara,2021-04-30,5053,364996,3782,203069,1105,146374,166,15553,1428,64425,3604,157558,1593,221983,California
Santa Barbara,2021-05-01,5329,370325,4116,207185,1178,147552,35,15588,908,60965,4405,161963,945,222928,California
Santa Barbara,2021-05-02,1146,371471,674,207859,343,147895,129,15717,314,60579,830,162793,444,223372,California
Santa Barbara,2021-05-03,2225,373696,1488,209347,598,148493,139,15856,444,59387,1774,164567,582,223954,California
Santa Barbara,2021-05-04,3367,377063,1714,211061,1579,150072,74,15930,1169,58447,2182,166749,1242,225196,California
Santa Barbara,2021-05-05,5541,382604,3724,214785,1668,151740,149,16079,648,54370,4875,171624,798,225994,California
Santa Barbara,2021-05-06,5145,387749,3981,218766,1058,152798,106,16185,992,51332,4135,175759,1097,227091,California
Santa Barbara,2021-05-07,4722,392471,3701,222467,841,153639,180,16365,1005,48815,3700,179459,1183,228274,California
Santa Barbara,2021-05-08,4356,396827,3226,225693,1029,154668,101,16466,914,46406,3425,182884,1016,229290,California
Santa Barbara,2021-05-09,702,397529,111,225804,551,155219,40,16506,462,46672,237,183121,503,229793,California
Santa Barbara,2021-05-10,1382,398911,675,226479,625,155844,82,16588,386,46147,993,184114,468,230261,California
Santa Barbara,2021-05-11,1946,400857,845,227324,804,156648,297,16885,448,45399,1487,185601,739,231000,California
Santa Barbara,2021-05-12,2099,402956,748,228072,1123,157771,228,17113,523,44589,1561,187162,751,231751,California
Santa Barbara,2021-05-13,3939,406895,2826,230898,914,158685,199,17312,1239,43341,2685,189847,1437,233188,California
Santa Barbara,2021-05-14,4167,411062,2527,233425,1547,160232,93,17405,1619,42523,2531,192378,1713,234901,California
Santa Barbara,2021-05-15,3564,414626,2598,236023,945,161177,21,17426,1856,42705,1696,194074,1878,236779,California
Santa Barbara,2021-05-16,1147,415773,526,236549,506,161683,115,17541,536,42750,606,194680,651,237430,California
Santa Barbara,2021-05-17,1645,417418,934,237483,648,162331,63,17604,861,42895,778,195458,923,238353,California
Santa Barbara,2021-05-18,1869,419287,1171,238654,600,162931,98,17702,979,43100,873,196331,1078,239431,California
Santa Barbara,2021-05-19,1778,421065,977,239631,760,163691,41,17743,811,42994,958,197289,852,240283,California
Santa Barbara,2021-05-20,1753,422818,953,240584,682,164373,118,17861,872,43118,867,198156,991,241274,California
Santa Barbara,2021-05-21,3476,426294,2351,242935,1070,165443,55,17916,1261,42236,2199,200355,1317,242591,California
Santa Barbara,2021-05-22,2476,428770,1712,244647,720,166163,44,17960,1394,42601,1076,201431,1441,244032,California
Santa Barbara,2021-05-23,776,429546,348,244995,397,166560,31,17991,423,42703,352,201783,454,244486,California
Santa Barbara,2021-05-24,1015,430561,592,245587,360,166920,63,18054,482,42722,526,202309,545,245031,California
Santa Barbara,2021-05-25,1413,431974,573,246160,771,167691,69,18123,464,42312,943,203252,533,245564,California
Santa Barbara,2021-05-26,3027,435001,1719,247879,1187,168878,121,18244,837,41095,2173,205425,956,246520,California
Santa Barbara,2021-05-27,1967,436968,1210,249089,614,169492,143,18387,824,40928,1135,206560,968,247488,California
Santa Barbara,2021-05-28,1508,438476,702,249791,653,170145,153,18540,611,40799,893,207453,764,248252,California
Santa Barbara,2021-05-29,910,439386,323,250114,550,170695,37,18577,368,40665,539,207992,405,248657,California
Santa Barbara,2021-05-30,516,439902,181,250295,236,170931,99,18676,185,40621,328,208320,284,248941,California
Santa Barbara,2021-05-31,98,440000,44,250339,44,170975,10,18686,25,40583,72,208392,34,248975,California
Santa Barbara,2021-06-01,1138,441138,592,250931,489,171464,57,18743,443,40395,689,209081,501,249476,California
Santa Barbara,2021-06-02,983,442121,584,251515,316,171780,83,18826,425,40348,554,209635,507,249983,California
Santa Barbara,2021-06-03,2063,444184,1550,253065,457,172237,56,18882,620,39588,1434,211069,674,250657,California
Santa Barbara,2021-06-04,1458,445642,670,253735,648,172885,140,19022,484,39244,964,212033,620,251277,California
Santa Barbara,2021-06-05,2921,448563,2215,255950,654,173539,52,19074,479,37344,2430,214463,530,251807,California
Santa Barbara,2021-06-06,926,449489,487,256437,420,173959,19,19093,232,36904,691,215154,251,252058,California
Santa Barbara,2021-06-07,1170,450659,831,257268,287,174246,52,19145,299,36387,868,216022,351,252409,California
Santa Barbara,2021-06-08,1116,451775,714,257982,370,174616,32,19177,292,35891,819,216841,323,252732,California
Santa Barbara,2021-06-09,1033,452808,703,258685,246,174862,84,19261,322,35590,707,217548,406,253138,California
Santa Barbara,2021-06-10,2393,455201,2074,260759,247,175109,72,19333,521,34315,1868,219416,593,253731,California
Santa Barbara,2021-06-11,1313,456514,610,261369,599,175708,104,19437,392,33895,916,220332,496,254227,California
Santa Barbara,2021-06-12,890,457404,598,261967,269,175977,23,19460,234,33504,647,220979,256,254483,California
Santa Barbara,2021-06-13,493,457897,305,262272,91,176068,97,19557,126,33362,365,221344,223,254706,California
Santa Barbara,2021-06-14,1262,459159,859,263131,326,176394,77,19634,339,32863,914,222258,415,255121,California
Santa Barbara,2021-06-15,1153,460312,760,263891,356,176750,37,19671,403,32559,743,223001,439,255560,California
Santa Barbara,2021-06-16,935,461247,650,264541,238,176988,47,19718,354,32383,575,223576,399,255959,California
Santa Barbara,2021-06-17,1879,463126,1547,266088,243,177231,89,19807,624,31844,1250,224826,711,256670,California
Santa Barbara,2021-06-18,1115,464241,719,266807,297,177528,99,19906,364,31560,747,225573,463,257133,California
Santa Barbara,2021-06-19,541,464782,363,267170,146,177674,32,19938,250,31554,288,225861,282,257415,California
Santa Barbara,2021-06-20,369,465151,211,267381,148,177822,10,19948,153,31501,215,226076,162,257577,California
Santa Barbara,2021-06-21,530,465681,265,267646,212,178034,53,20001,274,31578,250,226326,327,257904,California
Santa Barbara,2021-06-22,772,466453,500,268146,241,178275,31,20032,303,31446,465,226791,333,258237,California
Santa Barbara,2021-06-23,784,467237,567,268713,185,178460,32,20064,336,31370,443,227234,367,258604,California
Santa Barbara,2021-06-24,1365,468602,1148,269861,153,178613,64,20128,578,31229,780,228014,639,259243,California
Santa Barbara,2021-06-25,977,469579,625,270486,290,178903,62,20190,455,31226,518,228532,515,259758,California
Santa Barbara,2021-06-26,508,470087,354,270840,123,179026,31,20221,200,31149,308,228840,231,259989,California
Santa Barbara,2021-06-27,403,470490,265,271105,75,179101,63,20284,195,31203,204,229044,258,260247,California
Santa Barbara,2021-06-28,466,470956,303,271408,129,179230,34,20318,236,31243,230,229274,270,260517,California
Santa Barbara,2021-06-29,566,471522,382,271790,169,179399,15,20333,274,31245,286,229560,288,260805,California
Santa Barbara,2021-06-30,653,472175,463,272253,151,179550,39,20372,314,31268,330,229890,353,261158,California
Santa Barbara,2021-07-01,1065,473240,795,273048,121,179671,149,20521,410,31173,653,230543,558,261716,California
Santa Barbara,2021-07-02,779,474019,520,273568,203,179874,56,20577,382,31216,395,230938,438,262154,California
Santa Barbara,2021-07-03,351,474370,220,273788,119,179993,12,20589,153,31187,194,231132,165,262319,California
Santa Barbara,2021-07-04,25,474395,15,273803,10,180003,0,20589,9,31180,16,231148,9,262328,California
Santa Barbara,2021-07-05,494,474889,320,274123,155,180158,19,20608,224,31154,269,231417,243,262571,California
Santa Barbara,2021-07-06,568,475457,401,274524,127,180285,40,20648,204,31039,359,231776,244,262815,California
Santa Barbara,2021-07-07,591,476048,418,274942,127,180412,46,20694,265,31029,323,232099,313,263128,California
Santa Barbara,2021-07-08,994,477042,850,275792,110,180522,34,20728,431,30934,559,232658,464,263592,California
Santa Barbara,2021-07-09,734,477776,506,276298,167,180689,61,20789,295,30859,430,233088,355,263947,California
Santa Barbara,2021-07-10,424,478200,311,276609,88,180777,25,20814,161,30786,259,233347,186,264133,California
Santa Barbara,2021-07-11,234,478434,176,276785,46,180823,12,20826,94,30753,138,233485,105,264238,California
Santa Barbara,2021-07-12,509,478943,310,277095,174,180997,25,20851,208,30685,301,233786,233,264471,California
Santa Barbara,2021-07-13,423,479366,290,277385,125,181122,8,20859,200,30675,218,234004,208,264679,California
Santa Barbara,2021-07-14,531,479897,356,277741,163,181285,12,20871,218,30596,309,234313,230,264909,California
Santa Barbara,2021-07-15,911,480808,765,278506,133,181418,13,20884,370,30443,536,234849,383,265292,California
Santa Barbara,2021-07-16,769,481577,546,279052,193,181611,30,20914,361,30434,398,235247,389,265681,California
Santa Barbara,2021-07-17,420,481997,298,279350,119,181730,3,20917,226,30474,189,235436,229,265910,California
Santa Barbara,2021-07-18,368,482365,279,279629,60,181790,29,20946,200,30538,165,235601,229,266139,California
Santa Barbara,2021-07-19,683,483048,341,279970,206,181996,136,21082,281,30554,401,236002,417,266556,California
Santa Barbara,2021-07-20,665,483713,439,280409,182,182178,44,21126,348,30633,313,236315,392,266948,California
Santa Barbara,2021-07-21,709,484422,551,280960,144,182322,14,21140,394,30732,308,236623,407,267355,California
Santa Barbara,2021-07-22,966,485388,765,281725,159,182481,42,21182,473,30763,483,237106,514,267869,California
Santa Barbara,2021-07-23,941,486329,569,282294,251,182732,121,21303,474,30899,459,237565,595,268464,California
Santa Barbara,2021-07-24,501,486830,371,282665,111,182843,19,21322,290,31002,205,237770,308,268772,California
Santa Barbara,2021-07-25,284,487114,200,282865,78,182921,6,21328,197,31123,82,237852,203,268975,California
Santa Barbara,2021-07-26,679,487793,441,283306,217,183138,21,21349,417,31301,259,238111,437,269412,California
Santa Barbara,2021-07-27,720,488513,440,283746,213,183351,67,21416,420,31490,297,238408,486,269898,California
Santa Barbara,2021-07-28,799,489312,599,284345,171,183522,29,21445,502,31734,287,238695,531,270429,California
Santa Barbara,2021-07-29,988,490300,807,285152,150,183672,31,21476,557,31900,422,239117,588,271017,California
Santa Barbara,2021-07-30,854,491154,544,285696,264,183936,46,21522,485,32069,360,239477,529,271546,California
Santa Barbara,2021-07-31,258,491412,194,285890,59,183995,5,21527,169,32156,87,239564,174,271720,California
Santa Clara,2020-12-15,67,67,67,67,0,0,0,0,67,67,0,0,67,67,California
Santa Clara,2020-12-16,152,219,152,219,0,0,0,0,152,219,0,0,152,219,California
Santa Clara,2020-12-17,421,640,421,640,0,0,0,0,421,640,0,0,421,640,California
Santa Clara,2020-12-18,1766,2406,1765,2405,1,1,0,0,1766,2406,0,0,1766,2406,California
Santa Clara,2020-12-19,2110,4516,2110,4515,0,1,0,0,2109,4515,0,0,2109,4515,California
Santa Clara,2020-12-20,1914,6430,1913,6428,1,2,0,0,1911,6426,0,0,1911,6426,California
Santa Clara,2020-12-21,2685,9115,2685,9113,0,2,0,0,2682,9107,1,1,2682,9108,California
Santa Clara,2020-12-22,3160,12275,3152,12265,8,10,0,0,3156,12260,3,4,3156,12264,California
Santa Clara,2020-12-23,3306,15581,3109,15374,197,207,0,0,3304,15563,1,5,3304,15568,California
Santa Clara,2020-12-24,1914,17495,1717,17091,197,404,0,0,1908,17469,2,7,1908,17476,California
Santa Clara,2020-12-25,355,17850,354,17445,1,405,0,0,355,17824,0,7,355,17831,California
Santa Clara,2020-12-26,1283,19133,1044,18489,239,644,0,0,1282,19106,0,7,1282,19113,California
Santa Clara,2020-12-27,661,19794,518,19007,143,787,0,0,661,19767,0,7,661,19774,California
Santa Clara,2020-12-28,2380,22174,1752,20759,628,1415,0,0,2380,22147,0,7,2380,22154,California
Santa Clara,2020-12-29,2392,24566,1517,22276,875,2290,0,0,2392,24539,0,7,2392,24546,California
Santa Clara,2020-12-30,3029,27595,1915,24191,1114,3404,0,0,3026,27562,3,10,3026,27572,California
Santa Clara,2020-12-31,1244,28839,396,24587,848,4252,0,0,1243,28804,1,11,1243,28815,California
Santa Clara,2021-01-01,157,28996,19,24606,138,4390,0,0,155,28957,2,13,155,28970,California
Santa Clara,2021-01-02,1108,30104,827,25433,281,4671,0,0,1108,30065,0,13,1108,30078,California
Santa Clara,2021-01-03,594,30698,374,25807,220,4891,0,0,592,30656,1,14,592,30670,California
Santa Clara,2021-01-04,2498,33196,1686,27493,812,5703,0,0,2495,33151,0,14,2495,33165,California
Santa Clara,2021-01-05,3138,36334,2059,29552,1079,6782,0,0,2938,35896,199,213,2944,36109,California
Santa Clara,2021-01-06,3409,39743,2019,31571,1390,8172,0,0,2785,38065,619,832,2788,38897,California
Santa Clara,2021-01-07,4294,44037,2609,34180,1685,9857,0,0,3188,40165,1095,1927,3195,42092,California
Santa Clara,2021-01-08,5926,49963,3874,38054,2052,11909,0,0,3798,41845,2118,4045,3798,45890,California
Santa Clara,2021-01-09,3061,53024,1932,39986,1129,13038,0,0,1727,42243,1332,5377,1730,47620,California
Santa Clara,2021-01-10,1993,55017,1540,41526,453,13491,0,0,761,41774,1230,6607,761,48381,California
Santa Clara,2021-01-11,6110,61127,3882,45408,2228,15719,0,0,3439,42551,2669,9276,3446,51827,California
Santa Clara,2021-01-12,6948,68075,3523,48931,3425,19144,0,0,4599,44811,2341,11617,4601,56428,California
Santa Clara,2021-01-13,7555,75630,3178,52109,4377,23521,0,0,5268,47800,2280,13897,5269,61697,California
Santa Clara,2021-01-14,8404,84034,2912,55021,5492,29013,0,0,6560,52527,1835,15732,6562,68259,California
Santa Clara,2021-01-15,9593,93627,2745,57766,6848,35861,0,0,8223,59403,1352,17084,8228,76487,California
Santa Clara,2021-01-16,4365,97992,1258,59024,3107,38968,0,0,3518,62078,843,17927,3518,80005,California
Santa Clara,2021-01-17,3249,101241,612,59636,2637,41605,0,0,2748,64328,498,18425,2748,82753,California
Santa Clara,2021-01-18,5170,106411,1195,60831,3975,45580,0,0,4597,68353,573,18998,4598,87351,California
Santa Clara,2021-01-19,8602,115013,2725,63556,5877,51457,0,0,6879,73515,1720,20718,6882,94233,California
Santa Clara,2021-01-20,8513,123526,4480,68036,4033,55490,0,0,6925,78857,1583,22301,6925,101158,California
Santa Clara,2021-01-21,8998,132524,3976,72012,5022,60512,0,0,7710,85287,1282,23583,7712,108870,California
Santa Clara,2021-01-22,8811,141335,3322,75334,5489,66001,0,0,8216,92914,592,24175,8219,117089,California
Santa Clara,2021-01-23,3858,145193,1715,77049,2143,68144,0,0,2871,94801,986,25161,2873,119962,California
Santa Clara,2021-01-24,2883,148076,1440,78489,1443,69587,0,0,2381,96684,498,25659,2381,122343,California
Santa Clara,2021-01-25,8488,156564,3832,82321,4656,74243,0,0,6374,100953,2107,27766,6376,128719,California
Santa Clara,2021-01-26,8491,165055,3872,86193,4619,78862,0,0,6312,105101,2167,29933,6315,135034,California
Santa Clara,2021-01-27,8886,173941,3908,90101,4978,83840,0,0,6931,110098,1936,31869,6933,141967,California
Santa Clara,2021-01-28,9767,183708,3904,94005,5863,89703,0,0,7745,115848,2001,33870,7751,149718,California
Santa Clara,2021-01-29,9707,193415,3988,97993,5719,95422,0,0,7486,121125,2210,36080,7487,157205,California
Santa Clara,2021-01-30,4153,197568,2102,100095,2051,97473,0,0,2917,122816,1227,37307,2918,160123,California
Santa Clara,2021-01-31,2214,199782,1313,101408,901,98374,0,0,1607,123823,600,37907,1607,161730,California
Santa Clara,2021-02-01,7958,207740,3541,104949,4417,102791,0,0,6214,128310,1729,39636,6216,167946,California
Santa Clara,2021-02-02,8803,216543,2927,107876,5876,108667,0,0,6742,133005,2050,41686,6745,174691,California
Santa Clara,2021-02-03,9381,225924,3511,111387,5870,114537,0,0,7037,137710,2338,44024,7043,181734,California
Santa Clara,2021-02-04,11201,237125,4218,115605,6983,121520,0,0,8835,144195,2354,46378,8839,190573,California
Santa Clara,2021-02-05,12164,249289,4390,119995,7774,129294,0,0,8647,149346,3498,49876,8649,199222,California
Santa Clara,2021-02-06,5298,254587,2868,122863,2430,131724,0,0,4097,152250,1195,51071,4099,203321,California
Santa Clara,2021-02-07,3527,258114,2361,125224,1166,132890,0,0,3062,154851,462,51533,3063,206384,California
Santa Clara,2021-02-08,10319,268433,3582,128806,6737,139627,0,0,7496,159540,2809,54342,7498,213882,California
Santa Clara,2021-02-09,11369,279802,3873,132679,7496,147123,0,0,7794,163779,3559,57901,7798,221680,California
Santa Clara,2021-02-10,12869,292671,5008,137687,7861,154984,0,0,6684,164301,6165,64066,6687,228367,California
Santa Clara,2021-02-11,13812,306483,4848,142535,8964,163948,0,0,7746,166003,6046,70112,7748,236115,California
Santa Clara,2021-02-12,14843,321326,4561,147096,10282,174230,0,0,7057,165303,7759,77871,7059,243174,California
Santa Clara,2021-02-13,6220,327546,1514,148610,4706,178936,0,0,2262,163617,3950,81821,2264,245438,California
Santa Clara,2021-02-14,4692,332238,1176,149786,3516,182452,0,0,1507,161948,3181,85002,1512,246950,California
Santa Clara,2021-02-15,6413,338651,2847,152633,3566,186018,0,0,2775,161100,3626,88628,2778,249728,California
Santa Clara,2021-02-16,14080,352731,4101,156734,9979,195997,0,0,7034,161112,7024,95652,7036,256764,California
Santa Clara,2021-02-17,14329,367060,5612,162346,8717,204714,0,0,7138,161089,7167,102819,7144,263908,California
Santa Clara,2021-02-18,14548,381608,8569,170915,5979,210693,0,0,7378,161353,7118,109937,7382,271290,California
Santa Clara,2021-02-19,15166,396774,9717,180632,5449,216142,0,0,8821,163863,6318,116255,8828,280118,California
Santa Clara,2021-02-20,7126,403900,5351,185983,1775,217917,0,0,3824,164405,3284,119539,3826,283944,California
Santa Clara,2021-02-21,3490,407390,2573,188556,917,218834,0,0,1305,163547,2165,121704,1307,285251,California
Santa Clara,2021-02-22,10952,418342,6544,195100,4408,223242,0,0,5065,162763,5850,127554,5066,290317,California
Santa Clara,2021-02-23,12726,431068,8216,203316,4510,227752,0,0,7152,164377,5544,133098,7158,297475,California
Santa Clara,2021-02-24,15126,446194,9725,213041,5401,233153,0,0,9249,167784,5843,138941,9250,306725,California
Santa Clara,2021-02-25,15939,462133,10165,223206,5774,238927,0,0,8597,169094,7296,146237,8606,315331,California
Santa Clara,2021-02-26,15767,477900,9066,232272,6701,245628,0,0,8516,170422,7196,153433,8524,323855,California
Santa Clara,2021-02-27,8736,486636,6087,238359,2648,248276,1,1,4848,171427,3851,157284,4856,328711,California
Santa Clara,2021-02-28,5723,492359,3908,242267,1814,250090,1,2,2782,171302,2909,160193,2784,331495,California
Santa Clara,2021-03-01,15470,507829,8804,251071,6658,256748,8,10,9557,174991,5877,166070,9566,341061,California
Santa Clara,2021-03-02,16864,524693,9942,261013,6920,263668,2,12,10722,179607,6108,172178,10724,351785,California
Santa Clara,2021-03-03,19560,544253,9662,270675,9894,273562,4,16,12057,184211,7460,179638,12064,363849,California
Santa Clara,2021-03-04,17160,561413,9314,279989,7843,281405,3,19,9906,186970,7153,186791,9912,373761,California
Santa Clara,2021-03-05,16891,578304,9348,289337,7415,288820,128,147,9347,188944,7508,194299,9482,383243,California
Santa Clara,2021-03-06,9625,587929,6397,295734,2776,291596,452,599,7199,194186,2408,196707,7650,390893,California
Santa Clara,2021-03-07,7146,595075,4521,300255,2243,293839,382,981,5569,198569,1562,198269,5945,396838,California
Santa Clara,2021-03-08,13174,608249,6797,307052,5771,299610,606,1587,8368,202751,4785,203054,8967,405805,California
Santa Clara,2021-03-09,15437,623686,6589,313641,7502,307112,1346,2933,6872,202412,8538,211592,8199,414004,California
Santa Clara,2021-03-10,15446,639132,6766,320407,6528,313640,2152,5085,6351,201820,9051,220643,8459,422463,California
Santa Clara,2021-03-11,17297,656429,7842,328249,7939,321579,1516,6601,6096,198254,11154,231797,7588,430051,California
Santa Clara,2021-03-12,17943,674372,9190,337439,7170,328749,1583,8184,5993,193902,11895,243692,7543,437594,California
Santa Clara,2021-03-13,11016,685388,6338,343777,3079,331828,1599,9783,4840,194142,6145,249837,6385,443979,California
Santa Clara,2021-03-14,6606,691994,3427,347204,1870,333698,1309,11092,3203,195244,3383,253220,4485,448464,California
Santa Clara,2021-03-15,12983,704977,6624,353828,6076,339774,283,11375,5951,194482,6997,260217,6235,454699,California
Santa Clara,2021-03-16,18494,723471,10446,364274,7839,347613,209,11584,8806,193844,9649,269866,9011,463710,California
Santa Clara,2021-03-17,20395,743866,11548,375822,8675,356288,172,11756,10421,194523,9905,279771,10584,474294,California
Santa Clara,2021-03-18,19545,763411,9164,384986,9202,365490,1179,12935,9049,194302,10430,290201,10209,484503,California
Santa Clara,2021-03-19,19825,783236,10200,395186,8607,374097,1018,13953,10026,195626,9706,299907,11030,495533,California
Santa Clara,2021-03-20,11640,794876,6469,401655,4335,378432,836,14789,6669,198209,4915,304822,7498,503031,California
Santa Clara,2021-03-21,8473,803349,3877,405532,3185,381617,1411,16200,5390,201926,3063,307885,6780,509811,California
Santa Clara,2021-03-22,16751,820100,9349,414881,7044,388661,358,16558,9112,203795,7597,315482,9466,519277,California
Santa Clara,2021-03-23,19729,839829,12528,427409,6670,395331,531,17089,11181,207013,8490,323972,11708,530985,California
Santa Clara,2021-03-24,23090,862919,14824,442233,7849,403180,417,17506,14634,213651,8407,332379,15045,546030,California
Santa Clara,2021-03-25,23384,886303,13398,455631,9030,412210,956,18462,14904,221091,8397,340776,15837,561867,California
Santa Clara,2021-03-26,22438,908741,14214,469845,7829,420039,395,18857,13699,226483,8689,349465,14081,575948,California
Santa Clara,2021-03-27,15946,924687,10563,480408,4606,424645,777,19634,8476,228320,7410,356875,9247,585195,California
Santa Clara,2021-03-28,12246,936933,8481,488889,3053,427698,712,20346,6557,229923,5658,362533,7261,592456,California
Santa Clara,2021-03-29,20971,957904,12809,501698,7433,435131,729,21075,11185,232094,9728,372261,11899,604355,California
Santa Clara,2021-03-30,26104,984008,15466,517164,8680,443811,1958,23033,16338,240655,9713,381974,18274,622629,California
Santa Clara,2021-03-31,20860,1004868,12068,529232,7647,451458,1145,24178,12618,246216,8183,390157,13744,636373,California
Santa Clara,2021-04-01,32265,1037133,20009,549241,9116,460574,3140,27318,20220,257552,11951,402108,23287,659660,California
Santa Clara,2021-04-02,25682,1062815,14586,563827,8907,469481,2189,29507,16722,267523,8903,411011,18874,678534,California
Santa Clara,2021-04-03,15497,1078312,9417,573244,3571,473052,2509,32016,8601,271742,6863,417874,11082,689616,California
Santa Clara,2021-04-04,7759,1086071,4103,577347,2474,475526,1182,33198,4007,273168,3738,421612,5164,694780,California
Santa Clara,2021-04-05,22280,1108351,14776,592123,4962,480488,2542,35740,14510,282458,7728,429340,17018,711798,California
Santa Clara,2021-04-06,29910,1138261,16523,608646,7865,488353,5522,41262,17957,293977,11889,441229,23408,735206,California
Santa Clara,2021-04-07,31341,1169602,16155,624801,8624,496977,6562,47824,19100,307391,12169,453398,25583,760789,California
Santa Clara,2021-04-08,30375,1199977,16606,641407,6067,503044,7702,55526,16552,317826,13736,467134,24171,784960,California
Santa Clara,2021-04-09,28502,1228479,14098,655505,7040,510084,7364,62890,14540,325766,13880,481014,21820,806780,California
Santa Clara,2021-04-10,21740,1250219,12542,668047,3784,513868,5414,68304,11591,332598,10100,491114,16932,823712,California
Santa Clara,2021-04-11,16162,1266381,9692,677739,2698,516566,3772,72076,8378,336961,7741,498855,12104,835816,California
Santa Clara,2021-04-12,27377,1293758,19178,696917,5641,522207,2558,74634,18544,349284,8761,507616,21084,856900,California
Santa Clara,2021-04-13,34748,1328506,27239,724156,7480,529687,29,74663,26647,367972,8013,515629,26701,883601,California
Santa Clara,2021-04-14,37276,1365782,28164,752320,9108,538795,4,74667,26270,383361,10925,526554,26314,909915,California
Santa Clara,2021-04-15,44868,1410650,34643,786963,10216,549011,9,74676,34355,407366,10385,536939,34390,944305,California
Santa Clara,2021-04-16,39188,1449838,26734,813697,12450,561461,4,74680,27877,424055,11219,548158,27908,972213,California
Santa Clara,2021-04-17,22388,1472226,15257,828954,7129,568590,2,74682,15384,432525,6936,555094,15406,987619,California
Santa Clara,2021-04-18,17042,1489268,11186,840140,5856,574446,0,74682,10571,436679,6431,561525,10585,998204,California
Santa Clara,2021-04-19,29355,1518623,21154,861294,8199,582645,2,74684,17439,442325,11831,573356,17477,1015681,California
Santa Clara,2021-04-20,38472,1557095,23638,884932,14832,597477,2,74686,23301,450630,15038,588394,23343,1039024,California
Santa Clara,2021-04-21,38672,1595767,22803,907735,15865,613342,4,74690,25269,462668,13278,601672,25316,1064340,California
Santa Clara,2021-04-22,38512,1634279,25766,933501,12743,626085,3,74693,18061,460479,20328,622000,18139,1082479,California
Santa Clara,2021-04-23,33413,1667692,20489,953990,12923,639008,1,74694,15572,458390,17725,639725,15636,1098115,California
Santa Clara,2021-04-24,21633,1689325,15753,969743,5879,644887,1,74695,12246,461379,9290,649015,12279,1110394,California
Santa Clara,2021-04-25,13784,1703109,9964,979707,3812,648699,8,74703,8756,465190,4979,653994,8790,1119184,California
Santa Clara,2021-04-26,25906,1729015,19991,999698,5854,654553,61,74764,10775,461039,15015,669009,10864,1130048,California
Santa Clara,2021-04-27,28284,1757299,20151,1019849,7744,662297,389,75153,12326,457957,15853,684862,12771,1142819,California
Santa Clara,2021-04-28,26968,1784267,20022,1039871,6496,668793,450,75603,11431,454475,15434,700296,11952,1154771,California
Santa Clara,2021-04-29,24865,1809132,18243,1058114,6211,675004,411,76014,9346,448895,15427,715723,9847,1164618,California
Santa Clara,2021-04-30,24137,1833269,16613,1074727,7147,682151,377,76391,10310,445950,13725,729448,10780,1175398,California
Santa Clara,2021-05-01,17750,1851019,14681,1089408,2799,684950,270,76661,5581,439748,12100,741548,5898,1181296,California
Santa Clara,2021-05-02,11430,1862449,9475,1098883,1718,686668,237,76898,3519,435662,7860,749408,3774,1185070,California
Santa Clara,2021-05-03,23412,1885861,19823,1118706,3147,689815,442,77340,5265,423361,18055,767463,5754,1190824,California
Santa Clara,2021-05-04,31490,1917351,24653,1143359,6286,696101,551,77891,5650,403897,25721,793184,6257,1197081,California
Santa Clara,2021-05-05,33111,1950462,25178,1168537,7383,703484,550,78441,5643,382772,27348,820532,6223,1203304,California
Santa Clara,2021-05-06,36256,1986718,30256,1198793,5521,709005,479,78920,4836,356831,31280,851812,5339,1208643,California
Santa Clara,2021-05-07,33150,2019868,26639,1225432,6017,715022,494,79414,4744,333867,28253,880065,5289,1213932,California
Santa Clara,2021-05-08,17397,2037265,14257,1239689,2707,717729,433,79847,3743,324509,13553,893618,4195,1218127,California
Santa Clara,2021-05-09,10664,2047929,9294,1248983,1183,718912,187,80034,2389,318863,8236,901854,2590,1220717,California
Santa Clara,2021-05-10,21440,2069369,17218,1266201,3811,722723,411,80445,2674,303295,18673,920527,3105,1223822,California
Santa Clara,2021-05-11,23255,2092624,17604,1283805,5200,727923,451,80896,4061,288724,19089,939616,4518,1228340,California
Santa Clara,2021-05-12,21725,2114349,15946,1299751,5240,733163,539,81435,4229,276111,17386,957002,4773,1233113,California
Santa Clara,2021-05-13,28554,2142903,23134,1322885,5111,738274,309,81744,11305,270585,17150,974152,11624,1244737,California
Santa Clara,2021-05-14,28276,2171179,19743,1342628,8143,746417,390,82134,9722,262274,18439,992591,10128,1254865,California
Santa Clara,2021-05-15,21199,2192378,17004,1359632,3913,750330,282,82416,8160,257778,12947,1005538,8451,1263316,California
Santa Clara,2021-05-16,16488,2208866,13467,1373099,2843,753173,178,82594,5381,252319,11022,1016560,5563,1268879,California
Santa Clara,2021-05-17,20574,2229440,16158,1389257,4051,757224,365,82959,6885,245967,13604,1030164,7252,1276131,California
Santa Clara,2021-05-18,26347,2255787,16815,1406072,9114,766338,418,83377,7168,234517,19036,1049200,7586,1283717,California
Santa Clara,2021-05-19,24741,2280528,14444,1420516,9872,776210,425,83802,7273,224868,17355,1066555,7706,1291423,California
Santa Clara,2021-05-20,18766,2299294,12375,1432891,5939,782149,452,84254,6167,218980,12505,1079060,6617,1298040,California
Santa Clara,2021-05-21,22415,2321709,14867,1447758,7038,789187,510,84764,7353,211908,14949,1094009,7877,1305917,California
Santa Clara,2021-05-22,13065,2334774,9882,1457640,2826,792013,357,85121,5716,210712,7274,1101283,6078,1311995,California
Santa Clara,2021-05-23,8427,2343201,6282,1463922,1944,793957,201,85322,3393,209318,4991,1106274,3597,1315592,California
Santa Clara,2021-05-24,10953,2354154,7890,1471812,2602,796559,461,85783,3740,206373,7147,1113421,4202,1319794,California
Santa Clara,2021-05-25,11558,2365712,7979,1479791,3158,799717,421,86204,4379,204069,7103,1120524,4799,1324593,California
Santa Clara,2021-05-26,10510,2376222,6778,1486569,3392,803109,340,86544,3954,201914,6443,1126967,4288,1328881,California
Santa Clara,2021-05-27,9424,2385646,6019,1492588,2954,806063,451,86995,3510,200026,5842,1132809,3954,1332835,California
Santa Clara,2021-05-28,11004,2396650,7107,1499695,3449,809512,448,87443,4463,198468,6471,1139280,4913,1337748,California
Santa Clara,2021-05-29,6386,2403036,4326,1504021,1778,811290,282,87725,2717,197842,3621,1142901,2995,1340743,California
Santa Clara,2021-05-30,3933,2406969,2963,1506984,759,812049,211,87936,1848,197851,2050,1144951,2059,1342802,California
Santa Clara,2021-05-31,1107,2408076,632,1507616,366,812415,109,88045,438,197739,659,1145610,547,1343349,California
Santa Clara,2021-06-01,9106,2417182,6379,1513995,2346,814761,381,88426,2992,195070,6039,1151649,3370,1346719,California
Santa Clara,2021-06-02,7749,2424931,5542,1519537,1849,816610,358,88784,2909,193547,4781,1156430,3258,1349977,California
Santa Clara,2021-06-03,12257,2437188,10149,1529686,1762,818372,346,89130,2619,186942,9574,1166004,2969,1352946,California
Santa Clara,2021-06-04,13695,2450883,11457,1541143,1921,820293,317,89447,3277,180187,10344,1176348,3589,1356535,California
Santa Clara,2021-06-05,10567,2461450,9068,1550211,1240,821533,259,89706,2185,174301,8328,1184676,2442,1358977,California
Santa Clara,2021-06-06,6978,2468428,6222,1556433,600,822133,156,89862,1359,170248,5567,1190243,1514,1360491,California
Santa Clara,2021-06-07,10020,2478448,8442,1564875,1332,823465,246,90108,2315,165142,7665,1197908,2559,1363050,California
Santa Clara,2021-06-08,9244,2487692,7541,1572416,1432,824897,271,90379,2460,161147,6724,1204632,2729,1365779,California
Santa Clara,2021-06-09,9588,2497280,7978,1580394,1358,826255,252,90631,2271,156414,7250,1211882,2517,1368296,California
Santa Clara,2021-06-10,8381,2505661,6937,1587331,1113,827368,331,90962,2186,152786,6141,1218023,2513,1370809,California
Santa Clara,2021-06-11,10280,2515941,8715,1596046,1287,828655,278,91240,2521,147879,7707,1225730,2800,1373609,California
Santa Clara,2021-06-12,7202,2523143,5982,1602028,1051,829706,169,91409,1679,144252,5477,1231207,1850,1375459,California
Santa Clara,2021-06-13,3741,2526884,3017,1605045,608,830314,116,91525,860,142373,2855,1234062,976,1376435,California
Santa Clara,2021-06-14,6022,2532906,4858,1609903,927,831241,237,91762,1974,140571,4012,1238074,2210,1378645,California
Santa Clara,2021-06-15,7406,2540312,5990,1615893,1112,832353,304,92066,2084,137696,5266,1243340,2391,1381036,California
Santa Clara,2021-06-16,6413,2546725,5184,1621077,917,833270,312,92378,2101,135850,4259,1247599,2413,1383449,California
Santa Clara,2021-06-17,5382,2552107,4353,1625430,783,834053,246,92624,1846,134473,3465,1251064,2088,1385537,California
Santa Clara,2021-06-18,5519,2557626,4455,1629885,891,834944,173,92797,1828,132867,3607,1254671,2001,1387538,California
Santa Clara,2021-06-19,4539,2562165,3630,1633515,709,835653,200,92997,1288,131151,3205,1257876,1489,1389027,California
Santa Clara,2021-06-20,2153,2564318,1766,1635281,324,835977,63,93060,678,130437,1455,1259331,741,1389768,California
Santa Clara,2021-06-21,3731,2568049,2805,1638086,695,836672,231,93291,1818,130607,1876,1261207,2046,1391814,California
Santa Clara,2021-06-22,5124,2573173,4085,1642171,813,837485,226,93517,1725,129196,3359,1264566,1948,1393762,California
Santa Clara,2021-06-23,4498,2577671,3529,1645700,765,838250,204,93721,1609,128160,2848,1267414,1812,1395574,California
Santa Clara,2021-06-24,4386,2582057,3390,1649090,793,839043,203,93924,1617,127264,2716,1270130,1820,1397394,California
Santa Clara,2021-06-25,5551,2587608,4528,1653618,810,839853,213,94137,1903,125782,3594,1273724,2112,1399506,California
Santa Clara,2021-06-26,3690,2591298,2936,1656554,612,840465,142,94279,1337,124945,2313,1276037,1476,1400982,California
Santa Clara,2021-06-27,1988,2593286,1548,1658102,353,840818,87,94366,680,124419,1292,1277329,766,1401748,California
Santa Clara,2021-06-28,4080,2597366,3443,1661545,408,841226,229,94595,1564,123723,2485,1279814,1789,1403537,California
Santa Clara,2021-06-29,4180,2601546,3251,1664796,747,841973,182,94777,1613,122992,2526,1282340,1795,1405332,California
Santa Clara,2021-06-30,3744,2605290,2933,1667729,636,842609,175,94952,1447,122344,2271,1284611,1623,1406955,California
Santa Clara,2021-07-01,3554,2608844,2815,1670544,547,843156,192,95144,1341,121687,2188,1286799,1531,1408486,California
Santa Clara,2021-07-02,4144,2612988,3350,1673894,631,843787,163,95307,1584,120915,2521,1289320,1749,1410235,California
Santa Clara,2021-07-03,2436,2615424,1901,1675795,425,844212,110,95417,1004,120625,1404,1290724,1114,1411349,California
Santa Clara,2021-07-04,136,2615560,100,1675895,23,844235,13,95430,68,120639,67,1290791,81,1411430,California
Santa Clara,2021-07-05,2380,2617940,1958,1677853,297,844532,125,95555,955,120320,1398,1292189,1079,1412509,California
Santa Clara,2021-07-06,4223,2622163,3283,1681136,780,845312,160,95715,1428,119145,2760,1294949,1585,1414094,California
Santa Clara,2021-07-07,3718,2625881,2898,1684034,651,845963,169,95884,1301,118226,2387,1297336,1468,1415562,California
Santa Clara,2021-07-08,3066,2628947,2364,1686398,555,846518,147,96031,1176,117685,1858,1299194,1317,1416879,California
Santa Clara,2021-07-09,3384,2632331,2658,1689056,611,847129,115,96146,1380,117195,1979,1301173,1489,1418368,California
Santa Clara,2021-07-10,2547,2634878,1936,1690992,468,847597,143,96289,964,116746,1557,1302730,1108,1419476,California
Santa Clara,2021-07-11,1287,2636165,990,1691982,268,847865,29,96318,537,116568,744,1303474,566,1420042,California
Santa Clara,2021-07-12,3286,2639451,2572,1694554,545,848410,169,96487,1223,115931,2033,1305507,1396,1421438,California
Santa Clara,2021-07-13,2968,2642419,2312,1696866,517,848927,139,96626,1166,115461,1773,1307280,1303,1422741,California
Santa Clara,2021-07-14,2759,2645178,2208,1699074,426,849353,125,96751,1107,115061,1632,1308912,1232,1423973,California
Santa Clara,2021-07-15,2725,2647903,2189,1701263,423,849776,113,96864,1181,114837,1515,1310427,1291,1425264,California
Santa Clara,2021-07-16,3274,2651177,2595,1703858,561,850337,118,96982,1420,114546,1830,1312257,1539,1426803,California
Santa Clara,2021-07-17,2552,2653729,2031,1705889,403,850740,118,97100,1039,114230,1472,1313729,1156,1427959,California
Santa Clara,2021-07-18,1212,2654941,949,1706838,215,850955,48,97148,505,114098,684,1314413,552,1428511,California
Santa Clara,2021-07-19,2919,2657860,2288,1709126,495,851450,136,97284,1271,113884,1621,1316034,1407,1429918,California
Santa Clara,2021-07-20,3132,2660992,2457,1711583,537,851987,138,97422,1417,113751,1689,1317723,1556,1431474,California
Santa Clara,2021-07-21,2978,2663970,2370,1713953,499,852486,109,97531,1378,113667,1573,1319296,1489,1432963,California
Santa Clara,2021-07-22,2711,2666681,2094,1716047,515,853001,102,97633,1306,113699,1379,1320675,1411,1434374,California
Santa Clara,2021-07-23,3334,2670015,2594,1718641,647,853648,93,97726,1668,113848,1612,1322287,1761,1436135,California
Santa Clara,2021-07-24,2301,2672316,1777,1720418,427,854075,97,97823,1070,113823,1192,1323479,1167,1437302,California
Santa Clara,2021-07-25,1071,2673387,866,1721284,176,854251,29,97852,700,114192,360,1323839,729,1438031,California
Santa Clara,2021-07-26,2618,2676005,2111,1723395,391,854642,116,97968,1473,114661,1115,1324954,1584,1439615,California
Santa Clara,2021-07-27,3213,2679218,2431,1725826,633,855275,149,98117,1592,114822,1578,1326532,1739,1441354,California
Santa Clara,2021-07-28,2775,2681993,2105,1727931,553,855828,117,98234,1450,115091,1298,1327830,1567,1442921,California
Santa Clara,2021-07-29,2663,2684656,2072,1730003,455,856283,136,98370,1433,115466,1195,1329025,1570,1444491,California
Santa Clara,2021-07-30,3211,2687867,2511,1732514,560,856843,140,98510,1664,115780,1491,1330516,1805,1446296,California
Santa Clara,2021-07-31,1530,2689397,1007,1733521,434,857277,89,98599,800,115962,705,1331221,887,1447183,California
Santa Cruz,2020-12-15,2,2,2,2,0,0,0,0,2,2,0,0,2,2,California
Santa Cruz,2020-12-16,55,57,55,57,0,0,0,0,55,57,0,0,55,57,California
Santa Cruz,2020-12-17,381,438,381,438,0,0,0,0,381,438,0,0,381,438,California
Santa Cruz,2020-12-18,443,881,443,881,0,0,0,0,443,881,0,0,443,881,California
Santa Cruz,2020-12-19,170,1051,169,1050,1,1,0,0,170,1051,0,0,170,1051,California
Santa Cruz,2020-12-20,87,1138,87,1137,0,1,0,0,87,1138,0,0,87,1138,California
Santa Cruz,2020-12-21,430,1568,429,1566,1,2,0,0,430,1568,0,0,430,1568,California
Santa Cruz,2020-12-22,402,1970,401,1967,1,3,0,0,402,1970,0,0,402,1970,California
Santa Cruz,2020-12-23,345,2315,307,2274,38,41,0,0,345,2315,0,0,345,2315,California
Santa Cruz,2020-12-24,115,2430,42,2316,73,114,0,0,115,2430,0,0,115,2430,California
Santa Cruz,2020-12-25,8,2438,8,2324,0,114,0,0,8,2438,0,0,8,2438,California
Santa Cruz,2020-12-26,59,2497,42,2366,17,131,0,0,59,2497,0,0,59,2497,California
Santa Cruz,2020-12-27,31,2528,26,2392,5,136,0,0,31,2528,0,0,31,2528,California
Santa Cruz,2020-12-28,459,2987,102,2494,357,493,0,0,459,2987,0,0,459,2987,California
Santa Cruz,2020-12-29,763,3750,355,2849,408,901,0,0,763,3750,0,0,763,3750,California
Santa Cruz,2020-12-30,332,4082,157,3006,175,1076,0,0,332,4082,0,0,332,4082,California
Santa Cruz,2020-12-31,302,4384,9,3015,293,1369,0,0,302,4384,0,0,302,4384,California
Santa Cruz,2021-01-01,33,4417,1,3016,32,1401,0,0,33,4417,0,0,33,4417,California
Santa Cruz,2021-01-02,63,4480,50,3066,13,1414,0,0,63,4480,0,0,63,4480,California
Santa Cruz,2021-01-03,14,4494,6,3072,8,1422,0,0,14,4494,0,0,14,4494,California
Santa Cruz,2021-01-04,273,4767,121,3193,152,1574,0,0,271,4765,0,0,271,4765,California
Santa Cruz,2021-01-05,548,5315,422,3615,126,1700,0,0,249,4715,299,299,249,5014,California
Santa Cruz,2021-01-06,774,6089,647,4262,127,1827,0,0,448,4838,325,624,448,5462,California
Santa Cruz,2021-01-07,506,6595,196,4458,310,2137,0,0,359,5051,147,771,360,5822,California
Santa Cruz,2021-01-08,893,7488,542,5000,351,2488,0,0,465,5089,428,1199,466,6288,California
Santa Cruz,2021-01-09,438,7926,115,5115,323,2811,0,0,388,5427,50,1249,388,6676,California
Santa Cruz,2021-01-10,67,7993,59,5174,8,2819,0,0,17,5394,50,1299,17,6693,California
Santa Cruz,2021-01-11,697,8690,574,5748,123,2942,0,0,177,5052,520,1819,178,6871,California
Santa Cruz,2021-01-12,696,9386,509,6257,187,3129,0,0,460,5276,236,2055,460,7331,California
Santa Cruz,2021-01-13,486,9872,228,6485,258,3387,0,0,400,5593,83,2138,400,7731,California
Santa Cruz,2021-01-14,507,10379,98,6583,409,3796,0,0,447,5981,59,2197,447,8178,California
Santa Cruz,2021-01-15,1395,11774,72,6655,1323,5119,0,0,1334,7256,61,2258,1336,9514,California
Santa Cruz,2021-01-16,399,12173,43,6698,356,5475,0,0,385,7627,14,2272,385,9899,California
Santa Cruz,2021-01-17,288,12461,41,6739,247,5722,0,0,263,7865,25,2297,263,10162,California
Santa Cruz,2021-01-18,965,13426,91,6830,874,6596,0,0,908,8716,57,2354,908,11070,California
Santa Cruz,2021-01-19,1573,14999,504,7334,1069,7665,0,0,1237,9620,334,2688,1238,12308,California
Santa Cruz,2021-01-20,1221,16220,170,7504,1051,8716,0,0,1029,10460,189,2877,1029,13337,California
Santa Cruz,2021-01-21,1655,17875,212,7716,1443,10159,0,0,1554,11915,101,2978,1556,14893,California
Santa Cruz,2021-01-22,1723,19598,505,8221,1218,11377,0,0,1621,13438,99,3077,1622,16515,California
Santa Cruz,2021-01-23,379,19977,135,8356,244,11621,0,0,326,13711,53,3130,326,16841,California
Santa Cruz,2021-01-24,100,20077,15,8371,85,11706,0,0,84,13779,16,3146,84,16925,California
Santa Cruz,2021-01-25,1007,21084,352,8723,655,12361,0,0,519,13810,488,3634,519,17444,California
Santa Cruz,2021-01-26,1612,22696,242,8965,1370,13731,0,0,1125,14448,487,4121,1125,18569,California
Santa Cruz,2021-01-27,1593,24289,428,9393,1165,14896,0,0,1217,15292,374,4495,1218,19787,California
Santa Cruz,2021-01-28,1685,25974,278,9671,1407,16303,0,0,1415,16438,270,4765,1416,21203,California
Santa Cruz,2021-01-29,1689,27663,477,10148,1212,17515,0,0,1566,17883,121,4886,1566,22769,California
Santa Cruz,2021-01-30,1043,28706,305,10453,738,18253,0,0,909,18658,134,5020,909,23678,California
Santa Cruz,2021-01-31,213,28919,109,10562,104,18357,0,0,200,18845,13,5033,200,23878,California
Santa Cruz,2021-02-01,1173,30092,719,11281,454,18811,0,0,782,19236,391,5424,782,24660,California
Santa Cruz,2021-02-02,937,31029,115,11396,822,19633,0,0,792,19884,144,5568,792,25452,California
Santa Cruz,2021-02-03,2122,33151,890,12286,1232,20865,0,0,1818,21402,300,5868,1818,27270,California
Santa Cruz,2021-02-04,1744,34895,712,12998,1032,21897,0,0,1414,22488,328,6196,1414,28684,California
Santa Cruz,2021-02-05,3029,37924,720,13718,2309,24206,0,0,2733,24926,295,6491,2733,31417,California
Santa Cruz,2021-02-06,2483,40407,133,13851,2350,26556,0,0,2156,26755,327,6818,2156,33573,California
Santa Cruz,2021-02-07,883,41290,118,13969,765,27321,0,0,865,27602,18,6836,865,34438,California
Santa Cruz,2021-02-08,650,41940,180,14149,470,27791,0,0,468,27890,180,7016,468,34906,California
Santa Cruz,2021-02-09,2270,44210,1022,15171,1248,29039,0,0,2023,29666,247,7263,2023,36929,California
Santa Cruz,2021-02-10,2078,46288,535,15706,1543,30582,0,0,1418,30436,650,7913,1420,38349,California
Santa Cruz,2021-02-11,1721,48009,281,15987,1440,32022,0,0,1227,31170,493,8406,1227,39576,California
Santa Cruz,2021-02-12,3066,51075,400,16387,2666,34688,0,0,1714,31543,1343,9749,1716,41292,California
Santa Cruz,2021-02-13,1661,52736,118,16505,1543,36231,0,0,1267,32417,393,10142,1267,42559,California
Santa Cruz,2021-02-14,1348,54084,65,16570,1283,37514,0,0,1096,33261,252,10394,1096,43655,California
Santa Cruz,2021-02-15,1516,55600,270,16840,1246,38760,0,0,522,32791,994,11388,524,44179,California
Santa Cruz,2021-02-16,1641,57241,205,17045,1436,40196,0,0,494,32161,1124,12512,494,44673,California
Santa Cruz,2021-02-17,2828,60069,940,17985,1888,42084,0,0,1148,31645,1667,14179,1151,45824,California
Santa Cruz,2021-02-18,2773,62842,607,18592,2166,44250,0,0,1176,31229,1592,15771,1176,47000,California
Santa Cruz,2021-02-19,3140,65982,1094,19686,2046,46296,0,0,1929,31951,1207,16978,1929,48929,California
Santa Cruz,2021-02-20,2316,68298,1451,21137,865,47161,0,0,1797,33229,519,17497,1797,50726,California
Santa Cruz,2021-02-21,831,69129,352,21489,479,47640,0,0,700,33800,129,17626,700,51426,California
Santa Cruz,2021-02-22,1197,70326,924,22413,273,47913,0,0,489,33585,704,18330,489,51915,California
Santa Cruz,2021-02-23,2073,72399,932,23345,1141,49054,0,0,691,32898,1378,19708,691,52606,California
Santa Cruz,2021-02-24,3194,75593,1682,25027,1512,50566,0,0,1193,32096,1995,21703,1193,53799,California
Santa Cruz,2021-02-25,3220,78813,1417,26444,1803,52369,0,0,1765,32416,1447,23150,1767,55566,California
Santa Cruz,2021-02-26,2703,81516,733,27177,1970,54339,0,0,1537,32795,1160,24310,1539,57105,California
Santa Cruz,2021-02-27,2683,84199,934,28111,1748,56087,1,1,1862,33839,819,25129,1863,58968,California
Santa Cruz,2021-02-28,1318,85517,362,28473,956,57043,0,1,1099,34722,216,25345,1099,60067,California
Santa Cruz,2021-03-01,1883,87400,1256,29729,627,57670,0,1,669,34180,1211,26556,669,60736,California
Santa Cruz,2021-03-02,1465,88865,347,30076,1118,58788,0,1,802,34324,661,27217,805,61541,California
Santa Cruz,2021-03-03,2289,91154,595,30671,1694,60482,0,1,1224,34486,1062,28279,1224,62765,California
Santa Cruz,2021-03-04,2848,94002,1368,32039,1479,61961,1,2,1893,35439,942,29221,1895,64660,California
Santa Cruz,2021-03-05,2554,96556,449,32488,2088,64049,17,19,1088,35081,1463,30684,1105,65765,California
Santa Cruz,2021-03-06,3659,100215,1195,33683,2365,66414,99,118,1965,35451,1693,32377,2063,67828,California
Santa Cruz,2021-03-07,1355,101570,118,33801,1144,67558,93,211,555,35301,798,33175,648,68476,California
Santa Cruz,2021-03-08,1062,102632,206,34007,723,68281,133,344,633,35637,427,33602,763,69239,California
Santa Cruz,2021-03-09,1688,104320,243,34250,1301,69582,144,488,656,35409,1028,34630,800,70039,California
Santa Cruz,2021-03-10,3728,108048,2052,36302,1538,71120,138,626,1927,35682,1793,36423,2066,72105,California
Santa Cruz,2021-03-11,2693,110741,1178,37480,1351,72471,164,790,1503,36162,1189,37612,1669,73774,California
Santa Cruz,2021-03-12,2613,113354,834,38314,1508,73979,271,1061,878,35578,1731,39343,1147,74921,California
Santa Cruz,2021-03-13,2179,115533,1254,39568,889,74868,36,1097,1108,35654,1068,40411,1144,76065,California
Santa Cruz,2021-03-14,847,116380,182,39750,653,75521,12,1109,409,35638,436,40847,420,76485,California
Santa Cruz,2021-03-15,1252,117632,442,40192,778,76299,32,1141,545,35514,702,41549,578,77063,California
Santa Cruz,2021-03-16,2227,119859,1078,41270,1107,77406,42,1183,1277,35886,945,42494,1317,78380,California
Santa Cruz,2021-03-17,3801,123660,2278,43548,1513,78919,10,1193,2470,37041,1326,43820,2481,80861,California
Santa Cruz,2021-03-18,3700,127360,1989,45537,1600,80519,111,1304,1953,37362,1742,45562,2063,82924,California
Santa Cruz,2021-03-19,3265,130625,1301,46838,1759,82278,205,1509,1708,37722,1553,47115,1913,84837,California
Santa Cruz,2021-03-20,2201,132826,1638,48476,497,82775,66,1575,1056,37699,1144,48259,1121,85958,California
Santa Cruz,2021-03-21,829,133655,448,48924,259,83034,122,1697,442,37878,385,48644,564,86522,California
Santa Cruz,2021-03-22,1312,134967,795,49719,494,83528,23,1720,932,38456,377,49021,955,87477,California
Santa Cruz,2021-03-23,2466,137433,1354,51073,1062,84590,50,1770,1627,39295,837,49858,1676,89153,California
Santa Cruz,2021-03-24,2940,140373,1983,53056,936,85526,21,1791,1929,40242,1002,50860,1949,91102,California
Santa Cruz,2021-03-25,2520,142893,1263,54319,1225,86751,32,1823,1257,40274,1256,52116,1288,92390,California
Santa Cruz,2021-03-26,2954,145847,1701,56020,1226,87977,27,1850,2007,41369,939,53055,2034,94424,California
Santa Cruz,2021-03-27,2970,148817,1830,57850,1117,89094,23,1873,1396,41227,1563,54618,1421,95845,California
Santa Cruz,2021-03-28,865,149682,527,58377,324,89418,14,1887,432,41244,429,55047,446,96291,California
Santa Cruz,2021-03-29,1896,151578,815,59192,1009,90427,72,1959,1198,41819,694,55741,1269,97560,California
Santa Cruz,2021-03-30,2525,154103,749,59941,1630,92057,146,2105,1623,42690,899,56640,1770,99330,California
Santa Cruz,2021-03-31,3969,158072,2697,62638,1228,93285,44,2149,2061,42890,1904,58544,2104,101434,California
Santa Cruz,2021-04-01,3807,161879,2055,64693,1644,94929,108,2257,1929,43054,1871,60415,2035,103469,California
Santa Cruz,2021-04-02,3115,164994,1317,66010,1631,96560,167,2424,1742,43594,1369,61784,1909,105378,California
Santa Cruz,2021-04-03,2116,167110,1173,67183,828,97388,115,2539,820,43235,1293,63077,934,106312,California
Santa Cruz,2021-04-04,891,168001,459,67642,378,97766,54,2593,522,43440,369,63446,574,106886,California
Santa Cruz,2021-04-05,2154,170155,717,68359,1274,99040,163,2756,1316,44080,837,64283,1477,108363,California
Santa Cruz,2021-04-06,3202,173357,1562,69921,1281,100321,359,3115,1859,44960,1333,65616,2213,110576,California
Santa Cruz,2021-04-07,3924,177281,1533,71454,2055,102376,336,3451,1666,44707,2254,67870,2001,112577,California
Santa Cruz,2021-04-08,4020,181301,2186,73640,1355,103731,479,3930,2354,45883,1655,69525,2831,115408,California
Santa Cruz,2021-04-09,3555,184856,1421,75061,1757,105488,377,4307,1999,46710,1549,71074,2376,117784,California
Santa Cruz,2021-04-10,2077,186933,964,76025,885,106373,228,4535,949,46758,1124,72198,1172,118956,California
Santa Cruz,2021-04-11,889,187822,437,76462,366,106739,86,4621,394,46743,495,72693,480,119436,California
Santa Cruz,2021-04-12,2183,190005,754,77216,1040,107779,389,5010,1049,47062,1119,73812,1438,120874,California
Santa Cruz,2021-04-13,2770,192775,1366,78582,1403,109182,1,5011,1555,47412,1206,75018,1556,122430,California
Santa Cruz,2021-04-14,4444,197219,2112,80694,2332,111514,0,5011,2154,47291,2277,77295,2156,124586,California
Santa Cruz,2021-04-15,4815,202034,3043,83737,1772,113286,0,5011,3029,48551,1771,79066,3031,127617,California
Santa Cruz,2021-04-16,4231,206265,2283,86020,1946,115232,2,5013,2248,48827,1976,81042,2252,129869,California
Santa Cruz,2021-04-17,2122,208387,835,86855,1287,116519,0,5013,1374,49456,745,81787,1374,131243,California
Santa Cruz,2021-04-18,1027,209414,504,87359,522,117041,1,5014,574,49582,449,82236,575,131818,California
Santa Cruz,2021-04-19,2451,211865,1434,88793,1016,118057,1,5015,1521,50178,925,83161,1521,133339,California
Santa Cruz,2021-04-20,3040,214905,1602,90395,1438,119495,0,5015,1742,50634,1286,84447,1742,135081,California
Santa Cruz,2021-04-21,4076,218981,2737,93132,1339,120834,0,5015,2185,50951,1868,86315,2185,137266,California
Santa Cruz,2021-04-22,4186,223167,2845,95977,1340,122174,1,5016,2350,51477,1827,88142,2353,139619,California
Santa Cruz,2021-04-23,3061,226228,1651,97628,1409,123583,1,5017,1339,51106,1710,89852,1339,140958,California
Santa Cruz,2021-04-24,2167,228395,1070,98698,1094,124677,3,5020,698,50347,1460,91312,701,141659,California
Santa Cruz,2021-04-25,1036,229431,655,99353,368,125045,13,5033,413,50160,612,91924,425,142084,California
Santa Cruz,2021-04-26,2012,231443,969,100322,1026,126071,17,5050,839,49855,1162,93086,857,142941,California
Santa Cruz,2021-04-27,2859,234302,911,101233,1865,127936,83,5133,1415,49915,1436,94522,1496,144437,California
Santa Cruz,2021-04-28,3336,237638,1841,103074,1415,129351,80,5213,1746,50160,1578,96100,1823,146260,California
Santa Cruz,2021-04-29,3628,241266,2422,105496,1148,130499,58,5271,1278,49157,2340,98440,1337,147597,California
Santa Cruz,2021-04-30,2287,243553,1156,106652,1087,131586,44,5315,975,48875,1302,99742,1020,148617,California
Santa Cruz,2021-05-01,1211,244764,956,107608,222,131808,33,5348,590,48883,616,100358,624,149241,California
Santa Cruz,2021-05-02,573,245337,395,108003,153,131961,25,5373,202,48740,371,100729,228,149469,California
Santa Cruz,2021-05-03,1828,247165,919,108922,844,132805,65,5438,632,48256,1183,101912,699,150168,California
Santa Cruz,2021-05-04,2566,249731,1487,110409,1011,133816,68,5506,849,47460,1711,103623,915,151083,California
Santa Cruz,2021-05-05,2666,252397,1319,111728,1270,135086,77,5583,697,46310,1929,105552,779,151862,California
Santa Cruz,2021-05-06,3792,256189,2417,114145,1155,136241,220,5803,859,44473,2913,108465,1076,152938,California
Santa Cruz,2021-05-07,2604,258793,1130,115275,1396,137637,78,5881,418,42794,2177,110642,498,153436,California
Santa Cruz,2021-05-08,1343,260136,680,115955,634,138271,29,5910,368,42218,973,111615,397,153833,California
Santa Cruz,2021-05-09,494,260630,312,116267,160,138431,22,5932,142,42031,351,111966,164,153997,California
Santa Cruz,2021-05-10,2015,262645,1197,117464,758,139189,60,5992,397,40881,1607,113573,457,154454,California
Santa Cruz,2021-05-11,2318,264963,1295,118759,934,140123,89,6081,616,39890,1696,115269,705,155159,California
Santa Cruz,2021-05-12,3075,268038,1302,120061,1697,141820,76,6157,562,38026,2503,117772,639,155798,California
Santa Cruz,2021-05-13,3818,271856,2570,122631,1159,142979,89,6246,1354,37010,2460,120232,1444,157242,California
Santa Cruz,2021-05-14,2843,274699,1537,124168,1269,144248,37,6283,1072,36360,1761,121993,1111,158353,California
Santa Cruz,2021-05-15,2207,276906,1284,125452,912,145160,11,6294,1081,36329,1123,123116,1092,159445,California
Santa Cruz,2021-05-16,738,277644,387,125839,332,145492,19,6313,240,36093,496,123612,260,159705,California
Santa Cruz,2021-05-17,1458,279102,730,126569,661,146153,67,6380,506,35715,951,124563,573,160278,California
Santa Cruz,2021-05-18,2210,281312,1348,127917,835,146988,27,6407,1056,35650,1148,125711,1083,161361,California
Santa Cruz,2021-05-19,3004,284316,1833,129750,1135,148123,36,6443,1285,35260,1711,127422,1321,162682,California
Santa Cruz,2021-05-20,3301,287617,2374,132124,781,148904,146,6589,1563,35237,1732,129154,1709,164391,California
Santa Cruz,2021-05-21,1722,289339,895,133019,746,149650,81,6670,614,34831,1102,130256,696,165087,California
Santa Cruz,2021-05-22,1686,291025,1306,134325,370,150020,10,6680,587,34333,1096,131352,598,165685,California
Santa Cruz,2021-05-23,458,291483,258,134583,181,150201,19,6699,144,34184,312,131664,163,165848,California
Santa Cruz,2021-05-24,1141,292624,661,135244,405,150606,75,6774,299,33724,834,132498,374,166222,California
Santa Cruz,2021-05-25,2206,294830,1275,136519,889,151495,42,6816,452,32609,1608,134106,493,166715,California
Santa Cruz,2021-05-26,1766,296596,772,137291,951,152446,43,6859,464,31824,1291,135397,506,167221,California
Santa Cruz,2021-05-27,1253,297849,688,137979,467,152913,98,6957,428,31531,819,136216,526,167747,California
Santa Cruz,2021-05-28,823,298672,362,138341,431,153344,30,6987,351,31451,462,136678,382,168129,California
Santa Cruz,2021-05-29,571,299243,324,138665,237,153581,10,6997,318,31528,251,136929,328,168457,California
Santa Cruz,2021-05-30,231,299474,115,138780,103,153684,13,7010,91,31494,137,137066,103,168560,California
Santa Cruz,2021-05-31,143,299617,60,138840,82,153766,1,7011,46,31444,97,137163,47,168607,California
Santa Cruz,2021-06-01,895,300512,549,139389,336,154102,10,7021,327,31216,565,137728,337,168944,California
Santa Cruz,2021-06-02,864,301376,506,139895,318,154420,40,7061,329,31055,530,138258,369,169313,California
Santa Cruz,2021-06-03,2209,303585,1493,141388,677,155097,39,7100,506,29908,1692,139950,545,169858,California
Santa Cruz,2021-06-04,1010,304595,689,142077,290,155387,31,7131,235,29407,768,140718,267,170125,California
Santa Cruz,2021-06-05,980,305575,792,142869,183,155570,5,7136,181,28797,796,141514,186,170311,California
Santa Cruz,2021-06-06,363,305938,262,143131,84,155654,17,7153,79,28612,281,141795,96,170407,California
Santa Cruz,2021-06-07,808,306746,593,143724,185,155839,30,7183,220,28274,588,142383,250,170657,California
Santa Cruz,2021-06-08,1404,308150,1113,144837,265,156104,26,7209,294,27489,1107,143490,322,170979,California
Santa Cruz,2021-06-09,1396,309546,1101,145938,277,156381,18,7227,275,26669,1114,144604,294,171273,California
Santa Cruz,2021-06-10,1911,311457,1569,147507,278,156659,64,7291,312,25450,1592,146196,373,171646,California
Santa Cruz,2021-06-11,805,312262,499,148006,273,156932,33,7324,275,25231,525,146721,306,171952,California
Santa Cruz,2021-06-12,965,313227,841,148847,118,157050,6,7330,164,24602,799,147520,170,172122,California
Santa Cruz,2021-06-13,196,313423,128,148975,45,157095,23,7353,29,24487,167,147687,52,172174,California
Santa Cruz,2021-06-14,546,313969,350,149325,162,157257,34,7387,155,24286,389,148076,188,172362,California
Santa Cruz,2021-06-15,904,314873,665,149990,220,157477,19,7406,322,24049,579,148655,342,172704,California
Santa Cruz,2021-06-16,766,315639,563,150553,171,157648,32,7438,228,23775,533,149188,259,172963,California
Santa Cruz,2021-06-17,782,316421,605,151158,141,157789,36,7474,292,23614,488,149676,327,173290,California
Santa Cruz,2021-06-18,626,317047,382,151540,217,158006,27,7501,279,23577,343,150019,306,173596,California
Santa Cruz,2021-06-19,325,317372,258,151798,61,158067,6,7507,112,23485,210,150229,118,173714,California
Santa Cruz,2021-06-20,159,317531,112,151910,30,158097,17,7524,68,23479,91,150320,85,173799,California
Santa Cruz,2021-06-21,339,317870,239,152149,82,158179,18,7542,174,23507,164,150484,192,173991,California
Santa Cruz,2021-06-22,667,318537,472,152621,169,158348,26,7568,264,23396,402,150886,291,174282,California
Santa Cruz,2021-06-23,391,318928,280,152901,102,158450,9,7577,190,23398,195,151081,197,174479,California
Santa Cruz,2021-06-24,533,319461,386,153287,110,158560,37,7614,214,23331,317,151398,250,174729,California
Santa Cruz,2021-06-25,542,320003,356,153643,158,158718,28,7642,251,23323,287,151685,279,175008,California
Santa Cruz,2021-06-26,248,320251,154,153797,86,158804,8,7650,100,23285,146,151831,108,175116,California
Santa Cruz,2021-06-27,160,320411,111,153908,19,158823,30,7680,64,23283,96,151927,94,175210,California
Santa Cruz,2021-06-28,444,320855,360,154268,71,158894,13,7693,193,23238,251,152178,206,175416,California
Santa Cruz,2021-06-29,689,321544,542,154810,119,159013,28,7721,269,23117,417,152595,296,175712,California
Santa Cruz,2021-06-30,412,321956,281,155091,111,159124,20,7741,174,23076,235,152830,194,175906,California
Santa Cruz,2021-07-01,394,322350,282,155373,100,159224,12,7753,175,23045,218,153048,187,176093,California
Santa Cruz,2021-07-02,419,322769,309,155682,96,159320,14,7767,184,23013,230,153278,198,176291,California
Santa Cruz,2021-07-03,206,322975,145,155827,58,159378,3,7770,87,22985,118,153396,90,176381,California
Santa Cruz,2021-07-04,9,322984,8,155835,0,159378,1,7771,7,22991,2,153398,8,176389,California
Santa Cruz,2021-07-05,199,323183,156,155991,40,159418,3,7774,111,23018,86,153484,113,176502,California
Santa Cruz,2021-07-06,663,323846,553,156544,95,159513,15,7789,205,22785,453,153937,220,176722,California
Santa Cruz,2021-07-07,380,324226,272,156816,97,159610,11,7800,152,22722,226,154163,163,176885,California
Santa Cruz,2021-07-08,389,324615,274,157090,79,159689,36,7836,136,22643,251,154414,172,177057,California
Santa Cruz,2021-07-09,437,325052,313,157403,107,159796,17,7853,178,22588,251,154665,196,177253,California
Santa Cruz,2021-07-10,185,325237,132,157535,45,159841,8,7861,85,22582,99,154764,93,177346,California
Santa Cruz,2021-07-11,114,325351,91,157626,20,159861,3,7864,56,22585,56,154820,59,177405,California
Santa Cruz,2021-07-12,363,325714,267,157893,82,159943,14,7878,147,22532,213,155033,160,177565,California
Santa Cruz,2021-07-13,534,326248,413,158306,108,160051,13,7891,210,22437,319,155352,224,177789,California
Santa Cruz,2021-07-14,374,326622,264,158570,92,160143,18,7909,162,22409,207,155559,179,177968,California
Santa Cruz,2021-07-15,362,326984,274,158844,69,160212,19,7928,158,22383,203,155762,177,178145,California
Santa Cruz,2021-07-16,417,327401,298,159142,109,160321,10,7938,204,22386,211,155973,214,178359,California
Santa Cruz,2021-07-17,196,327597,146,159288,45,160366,5,7943,93,22382,102,156075,98,178457,California
Santa Cruz,2021-07-18,140,327737,105,159393,29,160395,6,7949,85,22418,55,156130,91,178548,California
Santa Cruz,2021-07-19,357,328094,257,159650,82,160477,18,7967,164,22409,191,156321,182,178730,California
Santa Cruz,2021-07-20,604,328698,474,160124,117,160594,13,7980,295,22410,307,156628,308,179038,California
Santa Cruz,2021-07-21,364,329062,263,160387,94,160688,7,7987,193,22447,163,156791,200,179238,California
Santa Cruz,2021-07-22,428,329490,294,160681,91,160779,43,8030,214,22492,212,157003,257,179495,California
Santa Cruz,2021-07-23,497,329987,309,160990,161,160940,27,8057,283,22591,210,157213,309,179804,California
Santa Cruz,2021-07-24,240,330227,158,161148,80,161020,2,8059,145,22646,92,157305,147,179951,California
Santa Cruz,2021-07-25,115,330342,97,161245,17,161037,1,8060,81,22695,33,157338,82,180033,California
Santa Cruz,2021-07-26,349,330691,258,161503,81,161118,10,8070,196,22750,151,157489,206,180239,California
Santa Cruz,2021-07-27,567,331258,453,161956,98,161216,16,8086,324,22849,241,157730,340,180579,California
Santa Cruz,2021-07-28,368,331626,237,162193,124,161340,7,8093,202,22894,163,157893,208,180787,California
Santa Cruz,2021-07-29,402,332028,277,162470,91,161431,34,8127,230,22991,167,158060,264,181051,California
Santa Cruz,2021-07-30,483,332511,338,162808,120,161551,25,8152,293,23122,187,158247,318,181369,California
Santa Cruz,2021-07-31,225,332736,157,162965,39,161590,29,8181,142,23211,81,158328,170,181539,California
Shasta,2020-12-15,1,1,1,1,0,0,0,0,1,1,0,0,1,1,California
Shasta,2020-12-16,133,134,133,134,0,0,0,0,133,134,0,0,133,134,California
Shasta,2020-12-17,419,553,419,553,0,0,0,0,419,553,0,0,419,553,California
Shasta,2020-12-18,163,716,163,716,0,0,0,0,163,716,0,0,163,716,California
Shasta,2020-12-19,1,717,1,717,0,0,0,0,1,717,0,0,1,717,California
Shasta,2020-12-21,69,786,68,785,1,1,0,0,69,786,0,0,69,786,California
Shasta,2020-12-22,191,977,186,971,5,6,0,0,191,977,0,0,191,977,California
Shasta,2020-12-23,168,1145,164,1135,4,10,0,0,168,1145,0,0,168,1145,California
Shasta,2020-12-24,25,1170,25,1160,0,10,0,0,25,1170,0,0,25,1170,California
Shasta,2020-12-26,4,1174,1,1161,3,13,0,0,4,1174,0,0,4,1174,California
Shasta,2020-12-27,3,1177,2,1163,1,14,0,0,3,1177,0,0,3,1177,California
Shasta,2020-12-28,38,1215,28,1191,10,24,0,0,38,1215,0,0,38,1215,California
Shasta,2020-12-29,174,1389,173,1364,1,25,0,0,174,1389,0,0,174,1389,California
Shasta,2020-12-30,180,1569,172,1536,8,33,0,0,180,1569,0,0,180,1569,California
Shasta,2020-12-31,80,1649,1,1537,79,112,0,0,80,1649,0,0,80,1649,California
Shasta,2021-01-02,2,1651,0,1537,2,114,0,0,2,1651,0,0,2,1651,California
Shasta,2021-01-03,1,1652,1,1538,0,114,0,0,1,1652,0,0,1,1652,California
Shasta,2021-01-04,358,2010,300,1838,58,172,0,0,359,2011,0,0,359,2011,California
Shasta,2021-01-05,334,2344,312,2150,22,194,0,0,255,2187,79,79,255,2266,California
Shasta,2021-01-06,462,2806,392,2542,70,264,0,0,201,2127,261,340,201,2467,California
Shasta,2021-01-07,129,2935,42,2584,87,351,0,0,102,2202,27,367,102,2569,California
Shasta,2021-01-08,519,3454,440,3024,79,430,0,0,313,2309,206,573,313,2882,California
Shasta,2021-01-09,75,3529,66,3090,9,439,0,0,71,2376,4,577,71,2953,California
Shasta,2021-01-10,5,3534,0,3090,5,444,0,0,3,2379,2,579,5,2958,California
Shasta,2021-01-11,401,3935,188,3278,213,657,0,0,364,2706,37,616,364,3322,California
Shasta,2021-01-12,472,4407,316,3594,156,813,0,0,306,2847,166,782,307,3629,California
Shasta,2021-01-13,594,5001,267,3861,327,1140,0,0,426,3105,168,950,426,4055,California
Shasta,2021-01-14,493,5494,56,3917,437,1577,0,0,469,3550,24,974,469,4524,California
Shasta,2021-01-15,661,6155,140,4057,521,2098,0,0,660,4209,1,975,660,5184,California
Shasta,2021-01-16,886,7041,53,4110,833,2931,0,0,883,5089,3,978,883,6067,California
Shasta,2021-01-17,28,7069,7,4117,21,2952,0,0,23,5107,5,983,23,6090,California
Shasta,2021-01-18,598,7667,127,4244,471,3423,0,0,591,5691,7,990,591,6681,California
Shasta,2021-01-19,1066,8733,408,4652,658,4081,0,0,923,6471,143,1133,923,7604,California
Shasta,2021-01-20,744,9477,494,5146,250,4331,0,0,558,6848,181,1314,558,8162,California
Shasta,2021-01-21,671,10148,335,5481,336,4667,0,0,652,7481,19,1333,652,8814,California
Shasta,2021-01-22,433,10581,179,5660,254,4921,0,0,426,7901,7,1340,427,9241,California
Shasta,2021-01-23,58,10639,5,5665,53,4974,0,0,56,7955,2,1342,56,9297,California
Shasta,2021-01-24,25,10664,3,5668,22,4996,0,0,24,7978,1,1343,24,9321,California
Shasta,2021-01-25,752,11416,496,6164,256,5252,0,0,468,8163,283,1626,468,9789,California
Shasta,2021-01-26,693,12109,338,6502,355,5607,0,0,458,8389,232,1858,458,10247,California
Shasta,2021-01-27,449,12558,196,6698,253,5860,0,0,400,8741,48,1906,400,10647,California
Shasta,2021-01-28,899,13457,585,7283,314,6174,0,0,683,9208,216,2122,683,11330,California
Shasta,2021-01-29,807,14264,327,7610,480,6654,0,0,620,9643,186,2308,621,11951,California
Shasta,2021-01-30,604,14868,14,7624,590,7244,0,0,593,10225,11,2319,593,12544,California
Shasta,2021-01-31,28,14896,4,7628,24,7268,0,0,26,10249,2,2321,26,12570,California
Shasta,2021-02-01,540,15436,156,7784,384,7652,0,0,396,10501,144,2465,396,12966,California
Shasta,2021-02-02,983,16419,501,8285,482,8134,0,0,894,11308,87,2552,894,13860,California
Shasta,2021-02-03,695,17114,217,8502,478,8612,0,0,462,11537,233,2785,462,14322,California
Shasta,2021-02-04,1079,18193,686,9188,393,9005,0,0,889,12239,187,2972,889,15211,California
Shasta,2021-02-05,1267,19460,173,9361,1094,10099,0,0,1051,13076,214,3186,1051,16262,California
Shasta,2021-02-06,1799,21259,38,9399,1761,11860,0,0,1773,14824,26,3212,1774,18036,California
Shasta,2021-02-07,26,21285,3,9402,23,11883,0,0,24,14846,2,3214,24,18060,California
Shasta,2021-02-08,595,21880,170,9572,425,12308,0,0,309,14870,285,3499,309,18369,California
Shasta,2021-02-09,1128,23008,654,10226,474,12782,0,0,700,15143,428,3927,701,19070,California
Shasta,2021-02-10,1127,24135,802,11028,325,13107,0,0,547,15111,579,4506,547,19617,California
Shasta,2021-02-11,878,25013,191,11219,687,13794,0,0,303,14844,570,5076,303,19920,California
Shasta,2021-02-12,1810,26823,1256,12475,554,14348,0,0,1274,15584,534,5610,1274,21194,California
Shasta,2021-02-13,1352,28175,370,12845,982,15330,0,0,554,15342,797,6407,555,21749,California
Shasta,2021-02-14,148,28323,5,12850,143,15473,0,0,123,15440,25,6432,123,21872,California
Shasta,2021-02-15,394,28717,112,12962,282,15755,0,0,214,15474,180,6612,214,22086,California
Shasta,2021-02-16,1198,29915,518,13480,680,16435,0,0,420,15119,775,7387,420,22506,California
Shasta,2021-02-17,1036,30951,461,13941,575,17010,0,0,416,14915,620,8007,416,22922,California
Shasta,2021-02-18,965,31916,488,14429,477,17487,0,0,461,14873,504,8511,462,23384,California
Shasta,2021-02-19,1332,33248,947,15376,385,17872,0,0,867,15276,464,8975,867,24251,California
Shasta,2021-02-20,799,34047,98,15474,701,18573,0,0,310,15097,489,9464,310,24561,California
Shasta,2021-02-21,33,34080,3,15477,30,18603,0,0,11,15086,22,9486,11,24572,California
Shasta,2021-02-22,444,34524,87,15564,357,18960,0,0,185,15013,258,9744,185,24757,California
Shasta,2021-02-23,925,35449,478,16042,447,19407,0,0,332,14752,593,10337,332,25089,California
Shasta,2021-02-24,877,36326,509,16551,368,19775,0,0,275,14430,597,10934,275,25364,California
Shasta,2021-02-25,540,36866,203,16754,337,20112,0,0,157,14206,381,11315,157,25521,California
Shasta,2021-02-26,805,37671,109,16863,696,20808,0,0,349,14101,454,11769,349,25870,California
Shasta,2021-02-27,859,38530,78,16941,781,21589,0,0,244,13735,610,12379,244,26114,California
Shasta,2021-02-28,189,38719,4,16945,185,21774,0,0,136,13818,53,12432,136,26250,California
Shasta,2021-03-01,615,39334,61,17006,554,22328,0,0,307,13819,306,12738,307,26557,California
Shasta,2021-03-02,1027,40361,473,17479,554,22882,0,0,330,13453,696,13434,330,26887,California
Shasta,2021-03-03,691,41052,186,17665,505,23387,0,0,244,13251,446,13880,244,27131,California
Shasta,2021-03-04,3040,44092,2467,20132,573,23960,0,0,1731,13679,1303,15183,1731,28862,California
Shasta,2021-03-05,1914,46006,165,20297,1720,25680,29,29,788,13370,1126,16309,817,29679,California
Shasta,2021-03-06,2730,48736,381,20678,2306,27986,43,72,782,12252,1943,18252,825,30504,California
Shasta,2021-03-07,103,48839,4,20682,60,28046,39,111,41,12268,62,18314,78,30582,California
Shasta,2021-03-08,572,49411,57,20739,375,28421,140,251,156,12149,414,18728,295,30877,California
Shasta,2021-03-09,1216,50627,591,21330,451,28872,174,425,660,12429,553,19281,833,31710,California
Shasta,2021-03-10,791,51418,255,21585,335,29207,201,626,142,12122,648,19929,341,32051,California
Shasta,2021-03-11,1509,52927,467,22052,785,29992,257,883,906,12685,599,20528,1162,33213,California
Shasta,2021-03-12,1553,54480,867,22919,449,30441,237,1120,396,12162,1156,21684,633,33846,California
Shasta,2021-03-13,809,55289,426,23345,286,30727,97,1217,494,12438,313,21997,589,34435,California
Shasta,2021-03-14,1009,56298,8,23353,978,31705,23,1240,871,13196,138,22135,896,35331,California
Shasta,2021-03-15,486,56784,40,23393,354,32059,92,1332,208,13217,278,22413,299,35630,California
Shasta,2021-03-16,1117,57901,145,23538,903,32962,69,1401,830,13833,283,22696,899,36529,California
Shasta,2021-03-17,708,58609,181,23719,469,33431,58,1459,368,13928,331,23027,426,36955,California
Shasta,2021-03-18,1514,60123,586,24305,827,34258,101,1560,1076,14671,434,23461,1177,38132,California
Shasta,2021-03-19,629,60752,205,24510,367,34625,57,1617,384,14868,244,23705,441,38573,California
Shasta,2021-03-20,724,61476,477,24987,236,34861,11,1628,530,15215,194,23899,541,39114,California
Shasta,2021-03-21,313,61789,298,25285,4,34865,11,1639,285,15484,27,23926,296,39410,California
Shasta,2021-03-22,335,62124,34,25319,266,35131,35,1674,192,15570,141,24067,227,39637,California
Shasta,2021-03-23,1314,63438,657,25976,599,35730,58,1732,760,15840,548,24615,818,40455,California
Shasta,2021-03-24,618,64056,164,26140,418,36148,36,1768,374,16008,243,24858,411,40866,California
Shasta,2021-03-25,1104,65160,417,26557,666,36814,21,1789,777,16484,324,25182,800,41666,California
Shasta,2021-03-26,1787,66947,1364,27921,393,37207,30,1819,1416,17562,369,25551,1447,43113,California
Shasta,2021-03-27,1533,68480,362,28283,310,37517,861,2680,527,17940,1004,26555,1382,44495,California
Shasta,2021-03-28,404,68884,300,28583,94,37611,10,2690,296,18140,106,26661,306,44801,California
Shasta,2021-03-29,416,69300,41,28624,363,37974,12,2702,156,18050,258,26919,168,44969,California
Shasta,2021-03-30,1202,70502,743,29367,442,38416,17,2719,595,18059,603,27522,612,45581,California
Shasta,2021-03-31,617,71119,204,29571,406,38822,7,2726,371,18195,242,27764,378,45959,California
Shasta,2021-04-01,871,71990,228,29799,628,39450,15,2741,545,18431,323,28087,559,46518,California
Shasta,2021-04-02,717,72707,175,29974,490,39940,52,2793,382,18533,332,28419,434,46952,California
Shasta,2021-04-03,506,73213,363,30337,127,40067,16,2809,383,18809,123,28542,399,47351,California
Shasta,2021-04-04,286,73499,171,30508,95,40162,20,2829,212,18967,74,28616,232,47583,California
Shasta,2021-04-05,429,73928,69,30577,307,40469,53,2882,250,19091,179,28795,303,47886,California
Shasta,2021-04-06,1111,75039,478,31055,465,40934,168,3050,533,19216,574,29369,699,48585,California
Shasta,2021-04-07,621,75660,186,31241,279,41213,156,3206,231,19216,386,29755,386,48971,California
Shasta,2021-04-08,1116,76776,253,31494,708,41921,155,3361,208,18673,903,30658,360,49331,California
Shasta,2021-04-09,2568,79344,2058,33552,301,42222,209,3570,1995,20308,564,31222,2199,51530,California
Shasta,2021-04-10,860,80204,576,34128,155,42377,129,3699,233,20042,626,31848,360,51890,California
Shasta,2021-04-11,1241,81445,392,34520,829,43206,20,3719,143,19112,1093,32941,163,52053,California
Shasta,2021-04-12,336,81781,8,34528,269,43475,59,3778,94,19023,241,33182,152,52205,California
Shasta,2021-04-13,1246,83027,363,34891,881,44356,2,3780,335,18453,906,34088,336,52541,California
Shasta,2021-04-14,574,83601,147,35038,425,44781,2,3782,215,18312,358,34446,217,52758,California
Shasta,2021-04-15,1053,84654,249,35287,804,45585,0,3782,302,17868,746,35192,302,53060,California
Shasta,2021-04-16,2279,86933,1811,37098,468,46053,0,3782,923,17438,1354,36546,924,53984,California
Shasta,2021-04-17,610,87543,388,37486,222,46275,0,3782,181,17191,429,36975,182,54166,California
Shasta,2021-04-18,265,87808,239,37725,26,46301,0,3782,32,16992,231,37206,32,54198,California
Shasta,2021-04-19,376,88184,29,37754,347,46648,0,3782,162,16940,214,37420,162,54360,California
Shasta,2021-04-20,973,89157,211,37965,762,47410,0,3782,364,16697,607,38027,364,54724,California
Shasta,2021-04-21,589,89746,200,38165,389,47799,0,3782,305,16718,284,38311,305,55029,California
Shasta,2021-04-22,942,90688,260,38425,682,48481,0,3782,301,16381,638,38949,301,55330,California
Shasta,2021-04-23,635,91323,240,38665,395,48876,0,3782,328,16403,306,39255,328,55658,California
Shasta,2021-04-24,595,91918,358,39023,236,49112,1,3783,107,16024,486,39741,107,55765,California
Shasta,2021-04-25,210,92128,178,39201,31,49143,1,3784,39,15893,171,39912,40,55805,California
Shasta,2021-04-26,495,92623,56,39257,434,49577,5,3789,351,16106,142,40054,355,56160,California
Shasta,2021-04-27,537,93160,174,39431,326,49903,37,3826,298,16204,235,40289,333,56493,California
Shasta,2021-04-28,564,93724,139,39570,393,50296,32,3858,249,16169,315,40604,280,56773,California
Shasta,2021-04-29,745,94469,106,39676,617,50913,22,3880,178,15803,566,41170,200,56973,California
Shasta,2021-04-30,2239,96708,1821,41497,387,51300,31,3911,253,14102,1984,43154,283,57256,California
Shasta,2021-05-01,227,96935,22,41519,131,51431,74,3985,102,14153,125,43279,176,57432,California
Shasta,2021-05-02,48,96983,15,41534,20,51451,13,3998,22,14162,26,43305,35,57467,California
Shasta,2021-05-03,355,97338,103,41637,230,51681,22,4020,111,14053,242,43547,133,57600,California
Shasta,2021-05-04,531,97869,202,41839,292,51973,37,4057,252,14066,276,43823,289,57889,California
Shasta,2021-05-05,444,98313,147,41986,280,52253,17,4074,205,14049,239,44062,222,58111,California
Shasta,2021-05-06,684,98997,260,42246,390,52643,34,4108,290,13986,385,44447,322,58433,California
Shasta,2021-05-07,1098,100095,731,42977,329,52972,38,4146,299,13525,798,45245,337,58770,California
Shasta,2021-05-08,169,100264,82,43059,77,53049,10,4156,100,13566,68,45313,109,58879,California
Shasta,2021-05-09,63,100327,14,43073,44,53093,5,4161,33,13574,30,45343,38,58917,California
Shasta,2021-05-10,252,100579,22,43095,183,53276,47,4208,112,13593,137,45480,156,59073,California
Shasta,2021-05-11,497,101076,141,43236,209,53485,147,4355,180,13604,316,45796,327,59400,California
Shasta,2021-05-12,388,101464,141,43377,224,53709,23,4378,130,13501,256,46052,153,59553,California
Shasta,2021-05-13,584,102048,243,43620,327,54036,14,4392,224,13381,358,46410,238,59791,California
Shasta,2021-05-14,635,102683,268,43888,342,54378,25,4417,294,13362,339,46749,320,60111,California
Shasta,2021-05-15,382,103065,122,44010,161,54539,99,4516,159,13398,222,46971,258,60369,California
Shasta,2021-05-16,218,103283,153,44163,55,54594,10,4526,159,13508,59,47030,169,60538,California
Shasta,2021-05-17,527,103810,243,44406,226,54820,58,4584,277,13594,249,47279,335,60873,California
Shasta,2021-05-18,625,104435,295,44701,304,55124,26,4610,330,13657,293,47572,356,61229,California
Shasta,2021-05-19,579,105014,272,44973,240,55364,67,4677,275,13698,301,47873,342,61571,California
Shasta,2021-05-20,564,105578,251,45224,294,55658,19,4696,258,13671,303,48176,276,61847,California
Shasta,2021-05-21,639,106217,285,45509,335,55993,19,4715,330,13713,307,48483,349,62196,California
Shasta,2021-05-22,233,106450,132,45641,93,56086,8,4723,142,13776,88,48571,151,62347,California
Shasta,2021-05-23,111,106561,48,45689,57,56143,6,4729,68,13807,43,48614,74,62421,California
Shasta,2021-05-24,540,107101,171,45860,338,56481,31,4760,191,13683,346,48960,222,62643,California
Shasta,2021-05-25,471,107572,206,46066,220,56701,45,4805,158,13577,308,49268,202,62845,California
Shasta,2021-05-26,372,107944,143,46209,204,56905,25,4830,146,13523,225,49493,171,63016,California
Shasta,2021-05-27,410,108354,151,46360,250,57155,9,4839,156,13437,251,49744,165,63181,California
Shasta,2021-05-28,429,108783,194,46554,208,57363,27,4866,198,13434,228,49972,225,63406,California
Shasta,2021-05-29,223,109006,64,46618,128,57491,31,4897,87,13414,136,50108,116,63522,California
Shasta,2021-05-30,84,109090,48,46666,34,57525,2,4899,52,13437,31,50139,54,63576,California
Shasta,2021-05-31,34,109124,9,46675,24,57549,1,4900,12,13429,21,50160,13,63589,California
Shasta,2021-06-01,517,109641,152,46827,221,57770,144,5044,130,13324,379,50539,274,63863,California
Shasta,2021-06-02,293,109934,120,46947,164,57934,9,5053,119,13280,172,50711,128,63991,California
Shasta,2021-06-03,364,110298,158,47105,199,58133,7,5060,118,13160,245,50956,125,64116,California
Shasta,2021-06-04,557,110855,278,47383,253,58386,26,5086,195,13021,360,51316,221,64337,California
Shasta,2021-06-05,249,111104,145,47528,86,58472,18,5104,79,12950,169,51485,98,64435,California
Shasta,2021-06-06,159,111263,125,47653,32,58504,2,5106,47,12887,112,51597,49,64484,California
Shasta,2021-06-07,397,111660,232,47885,148,58652,17,5123,106,12720,290,51887,123,64607,California
Shasta,2021-06-08,511,112171,314,48199,153,58805,44,5167,149,12552,361,52248,193,64800,California
Shasta,2021-06-09,475,112646,268,48467,120,58925,87,5254,111,12389,361,52609,198,64998,California
Shasta,2021-06-10,405,113051,240,48707,140,59065,25,5279,127,12269,272,52881,152,65150,California
Shasta,2021-06-11,463,113514,250,48957,175,59240,38,5317,126,12097,335,53216,163,65313,California
Shasta,2021-06-12,207,113721,136,49093,65,59305,6,5323,73,12043,133,53349,79,65392,California
Shasta,2021-06-13,88,113809,55,49148,31,59336,2,5325,26,12009,62,53411,28,65420,California
Shasta,2021-06-14,279,114088,153,49301,109,59445,17,5342,79,11906,199,53610,96,65516,California
Shasta,2021-06-15,444,114532,221,49522,113,59558,110,5452,150,11872,288,53898,254,65770,California
Shasta,2021-06-16,258,114790,152,49674,94,59652,12,5464,84,11799,169,54067,96,65866,California
Shasta,2021-06-17,287,115077,122,49796,130,59782,35,5499,101,11750,185,54252,136,66002,California
Shasta,2021-06-18,368,115445,223,50019,125,59907,20,5519,154,11711,213,54465,174,66176,California
Shasta,2021-06-19,116,115561,74,50093,38,59945,4,5523,52,11703,63,54528,55,66231,California
Shasta,2021-06-20,58,115619,36,50129,18,59963,4,5527,21,11691,37,54565,25,66256,California
Shasta,2021-06-21,197,115816,63,50192,106,60069,28,5555,77,11676,120,54685,105,66361,California
Shasta,2021-06-22,372,116188,139,50331,82,60151,151,5706,93,11639,271,54956,234,66595,California
Shasta,2021-06-23,220,116408,129,50460,74,60225,17,5723,91,11619,128,55084,108,66703,California
Shasta,2021-06-24,227,116635,136,50596,73,60298,18,5741,92,11596,133,55217,110,66813,California
Shasta,2021-06-25,297,116932,203,50799,81,60379,13,5754,123,11557,174,55391,135,66948,California
Shasta,2021-06-26,137,117069,80,50879,47,60426,10,5764,55,11541,81,55472,65,67013,California
Shasta,2021-06-27,67,117136,44,50923,19,60445,4,5768,23,11524,44,55516,27,67040,California
Shasta,2021-06-28,184,117320,121,51044,47,60492,16,5784,90,11536,94,55610,106,67146,California
Shasta,2021-06-29,273,117593,165,51209,80,60572,28,5812,100,11494,170,55780,128,67274,California
Shasta,2021-06-30,209,117802,121,51330,75,60647,13,5825,90,11480,117,55897,103,67377,California
Shasta,2021-07-01,204,118006,133,51463,60,60707,11,5836,79,11447,123,56020,90,67467,California
Shasta,2021-07-02,268,118274,173,51636,81,60788,14,5850,119,11435,145,56165,133,67600,California
Shasta,2021-07-03,116,118390,78,51714,32,60820,6,5856,52,11429,64,56229,58,67658,California
Shasta,2021-07-04,4,118394,0,51714,3,60823,1,5857,0,11426,4,56233,1,67659,California
Shasta,2021-07-05,107,118501,60,51774,37,60860,10,5867,45,11420,61,56294,55,67714,California
Shasta,2021-07-06,282,118783,163,51937,99,60959,20,5887,90,11342,188,56482,110,67824,California
Shasta,2021-07-07,197,118980,104,52041,54,61013,39,5926,66,11319,128,56610,105,67929,California
Shasta,2021-07-08,213,119193,119,52160,77,61090,17,5943,83,11289,129,56739,99,68028,California
Shasta,2021-07-09,245,119438,160,52320,78,61168,7,5950,95,11241,150,56889,102,68130,California
Shasta,2021-07-10,97,119535,60,52380,33,61201,4,5954,43,11234,54,56943,47,68177,California
Shasta,2021-07-11,43,119578,21,52401,20,61221,2,5956,17,11227,26,56969,19,68196,California
Shasta,2021-07-12,149,119727,75,52476,55,61276,19,5975,65,11227,84,57053,84,68280,California
Shasta,2021-07-13,221,119948,133,52609,78,61354,10,5985,104,11229,113,57166,115,68395,California
Shasta,2021-07-14,160,120108,95,52704,61,61415,4,5989,74,11224,83,57249,78,68473,California
Shasta,2021-07-15,180,120288,99,52803,75,61490,6,5995,79,11212,97,57346,85,68558,California
Shasta,2021-07-16,241,120529,144,52947,80,61570,17,6012,109,11212,125,57471,125,68683,California
Shasta,2021-07-17,113,120642,64,53011,43,61613,6,6018,61,11228,51,57522,67,68750,California
Shasta,2021-07-18,61,120703,33,53044,24,61637,4,6022,36,11243,25,57547,40,68790,California
Shasta,2021-07-19,194,120897,82,53126,68,61705,44,6066,80,11254,113,57660,124,68914,California
Shasta,2021-07-20,231,121128,139,53265,80,61785,12,6078,135,11306,95,57755,147,69061,California
Shasta,2021-07-21,188,121316,113,53378,62,61847,13,6091,110,11351,78,57833,123,69184,California
Shasta,2021-07-22,218,121534,132,53510,72,61919,14,6105,125,11399,91,57924,139,69323,California
Shasta,2021-07-23,282,121816,175,53685,87,62006,20,6125,138,11416,141,58065,158,69481,California
Shasta,2021-07-24,143,121959,85,53770,53,62059,5,6130,76,11430,67,58132,81,69562,California
Shasta,2021-07-25,65,122024,45,53815,20,62079,0,6130,47,11459,18,58150,47,69609,California
Shasta,2021-07-26,241,122265,118,53933,81,62160,42,6172,139,11539,101,58251,181,69790,California
Shasta,2021-07-27,267,122532,151,54084,96,62256,20,6192,160,11620,97,58348,178,69968,California
Shasta,2021-07-28,216,122748,115,54199,91,62347,10,6202,140,11694,76,58424,150,70118,California
Shasta,2021-07-29,250,122998,155,54354,77,62424,18,6220,154,11773,93,58517,172,70290,California
Shasta,2021-07-30,330,123328,202,54556,113,62537,15,6235,203,11867,123,58640,217,70507,California
Shasta,2021-07-31,58,123386,31,54587,23,62560,4,6239,34,11881,24,58664,38,70545,California
Sierra,2020-12-18,1,1,1,1,0,0,0,0,1,1,0,0,1,1,California
Sierra,2020-12-21,2,3,2,3,0,0,0,0,2,3,0,0,2,3,California
Sierra,2020-12-22,12,15,12,15,0,0,0,0,12,15,0,0,12,15,California
Sierra,2020-12-23,4,19,4,19,0,0,0,0,4,19,0,0,4,19,California
Sierra,2020-12-28,1,20,0,19,1,1,0,0,1,20,0,0,1,20,California
Sierra,2020-12-29,49,69,7,26,42,43,0,0,49,69,0,0,49,69,California
Sierra,2020-12-30,2,71,0,26,2,45,0,0,2,71,0,0,2,71,California
Sierra,2020-12-31,13,84,0,26,13,58,0,0,13,84,0,0,13,84,California
Sierra,2021-01-01,1,85,1,27,0,58,0,0,1,85,0,0,1,85,California
Sierra,2021-01-05,65,150,3,30,62,120,0,0,65,150,0,0,65,150,California
Sierra,2021-01-06,1,151,1,31,0,120,0,0,1,151,0,0,1,151,California
Sierra,2021-01-07,20,171,1,32,19,139,0,0,19,169,1,1,19,170,California
Sierra,2021-01-11,3,174,3,35,0,139,0,0,0,166,3,4,0,170,California
Sierra,2021-01-12,38,212,12,47,26,165,0,0,26,180,12,16,26,196,California
Sierra,2021-01-13,3,215,3,50,0,165,0,0,0,177,3,19,0,196,California
Sierra,2021-01-14,34,249,2,52,32,197,0,0,34,211,0,19,34,230,California
Sierra,2021-01-15,4,253,1,53,3,200,0,0,4,215,0,19,4,234,California
Sierra,2021-01-18,3,256,0,53,3,203,0,0,3,218,0,19,3,237,California
Sierra,2021-01-19,34,290,0,53,34,237,0,0,34,252,0,19,34,271,California
Sierra,2021-01-21,53,343,0,53,53,290,0,0,52,304,1,20,53,324,California
Sierra,2021-01-22,2,345,0,53,2,292,0,0,2,306,0,20,2,326,California
Sierra,2021-01-23,2,347,0,53,2,294,0,0,2,308,0,20,2,328,California
Sierra,2021-01-25,1,348,1,54,0,294,0,0,1,309,0,20,1,329,California
Sierra,2021-01-26,63,411,2,56,61,355,0,0,24,294,39,59,24,353,California
Sierra,2021-01-27,4,415,4,60,0,355,0,0,0,290,4,63,0,353,California
Sierra,2021-01-28,53,468,0,60,53,408,0,0,43,323,10,73,43,396,California
Sierra,2021-01-29,1,469,0,60,1,409,0,0,1,324,0,73,1,397,California
Sierra,2021-01-30,2,471,2,62,0,409,0,0,2,326,0,73,2,399,California
Sierra,2021-02-01,1,472,0,62,1,410,0,0,0,325,1,74,0,399,California
Sierra,2021-02-02,60,532,0,62,60,470,0,0,21,307,39,113,21,420,California
Sierra,2021-02-03,5,537,5,67,0,470,0,0,5,312,0,113,5,425,California
Sierra,2021-02-04,99,636,2,69,97,567,0,0,50,313,49,162,50,475,California
Sierra,2021-02-05,5,641,3,72,2,569,0,0,4,316,1,163,4,479,California
Sierra,2021-02-09,55,696,0,72,55,624,0,0,51,363,4,167,51,530,California
Sierra,2021-02-10,3,699,0,72,3,627,0,0,2,364,1,168,2,532,California
Sierra,2021-02-11,193,892,1,73,192,819,0,0,133,437,60,228,133,665,California
Sierra,2021-02-12,20,912,0,73,20,839,0,0,20,457,0,228,20,685,California
Sierra,2021-02-15,3,915,2,75,1,840,0,0,0,454,3,231,0,685,California
Sierra,2021-02-16,46,961,1,76,45,885,0,0,10,428,36,267,10,695,California
Sierra,2021-02-17,4,965,0,76,4,889,0,0,1,426,3,270,1,696,California
Sierra,2021-02-18,142,1107,0,76,142,1031,0,0,92,469,49,319,92,788,California
Sierra,2021-02-19,1,1108,0,76,1,1032,0,0,0,468,1,320,0,788,California
Sierra,2021-02-20,3,1111,2,78,1,1033,0,0,1,467,2,322,1,789,California
Sierra,2021-02-23,5,1116,0,78,5,1038,0,0,5,472,0,322,5,794,California
Sierra,2021-02-24,1,1117,0,78,1,1039,0,0,1,473,0,322,1,795,California
Sierra,2021-02-25,123,1240,0,78,123,1162,0,0,59,469,63,385,59,854,California
Sierra,2021-02-26,11,1251,6,84,5,1167,0,0,4,466,7,392,4,858,California
Sierra,2021-03-01,1,1252,1,85,0,1167,0,0,0,465,1,393,0,858,California
Sierra,2021-03-02,59,1311,0,85,59,1226,0,0,39,484,20,413,39,897,California
Sierra,2021-03-03,1,1312,1,86,0,1226,0,0,0,483,1,414,0,897,California
Sierra,2021-03-04,107,1419,0,86,107,1333,0,0,59,494,48,462,59,956,California
Sierra,2021-03-05,12,1431,0,86,12,1345,0,0,10,502,2,464,10,966,California
Sierra,2021-03-08,1,1432,1,87,0,1345,0,0,1,503,0,464,1,967,California
Sierra,2021-03-09,58,1490,0,87,58,1403,0,0,11,467,47,511,11,978,California
Sierra,2021-03-10,6,1496,0,87,6,1409,0,0,4,469,2,513,4,982,California
Sierra,2021-03-11,173,1669,1,88,172,1581,0,0,42,380,131,644,42,1024,California
Sierra,2021-03-12,19,1688,0,88,19,1600,0,0,0,361,19,663,0,1024,California
Sierra,2021-03-13,27,1715,0,88,27,1627,0,0,27,388,0,663,27,1051,California
Sierra,2021-03-15,2,1717,0,88,0,1627,2,2,0,388,2,665,2,1053,California
Sierra,2021-03-16,37,1754,0,88,36,1663,1,3,22,396,15,680,23,1076,California
Sierra,2021-03-17,1,1755,0,88,1,1664,0,3,0,395,1,681,0,1076,California
Sierra,2021-03-18,159,1914,0,88,159,1823,0,3,65,366,94,775,65,1141,California
Sierra,2021-03-19,3,1917,1,89,2,1825,0,3,0,363,3,778,0,1141,California
Sierra,2021-03-20,2,1919,0,89,2,1827,0,3,1,363,1,779,1,1142,California
Sierra,2021-03-23,23,1942,0,89,23,1850,0,3,13,366,10,789,13,1155,California
Sierra,2021-03-24,2,1944,0,89,2,1852,0,3,1,366,1,790,1,1156,California
Sierra,2021-03-25,99,2043,0,89,99,1951,0,3,49,366,49,839,49,1205,California
Sierra,2021-03-26,11,2054,0,89,11,1962,0,3,8,371,3,842,8,1213,California
Sierra,2021-03-27,1,2055,0,89,1,1963,0,3,0,370,1,843,0,1213,California
Sierra,2021-03-29,1,2056,1,90,0,1963,0,3,0,369,1,844,0,1213,California
Sierra,2021-03-30,59,2115,0,90,59,2022,0,3,26,362,33,877,26,1239,California
Sierra,2021-03-31,8,2123,0,90,8,2030,0,3,8,370,0,877,8,1247,California
Sierra,2021-04-01,62,2185,1,91,61,2091,0,3,5,320,55,932,5,1252,California
Sierra,2021-04-02,2,2187,1,92,1,2092,0,3,2,322,0,932,2,1254,California
Sierra,2021-04-04,1,2188,0,92,1,2093,0,3,0,322,0,932,0,1254,California
Sierra,2021-04-06,11,2199,0,92,11,2104,0,3,1,313,10,942,1,1255,California
Sierra,2021-04-07,13,2212,2,94,6,2110,5,8,2,310,10,952,7,1262,California
Sierra,2021-04-08,52,2264,2,96,50,2160,0,8,17,292,35,987,17,1279,California
Sierra,2021-04-09,1,2265,1,97,0,2160,0,8,1,293,0,987,1,1280,California
Sierra,2021-04-10,27,2292,0,97,27,2187,0,8,0,266,27,1014,0,1280,California
Sierra,2021-04-12,1,2293,0,97,0,2187,1,9,0,266,1,1015,1,1281,California
Sierra,2021-04-13,45,2338,0,97,45,2232,0,9,5,231,40,1055,5,1286,California
Sierra,2021-04-14,1,2339,0,97,1,2233,0,9,1,232,0,1055,1,1287,California
Sierra,2021-04-15,49,2388,2,99,47,2280,0,9,2,187,47,1102,2,1289,California
Sierra,2021-04-17,2,2390,1,100,1,2281,0,9,1,187,1,1103,1,1290,California
Sierra,2021-04-18,1,2391,0,100,1,2282,0,9,0,187,0,1103,0,1290,California
Sierra,2021-04-19,1,2392,0,100,1,2283,0,9,1,188,0,1103,1,1291,California
Sierra,2021-04-20,33,2425,1,101,32,2315,0,9,6,167,27,1130,6,1297,California
Sierra,2021-04-21,2,2427,1,102,1,2316,0,9,1,167,1,1131,1,1298,California
Sierra,2021-04-22,64,2491,1,103,63,2379,0,9,5,114,58,1189,5,1303,California
Sierra,2021-04-23,12,2503,0,103,12,2391,0,9,3,108,9,1198,3,1306,California
Sierra,2021-04-24,4,2507,0,103,4,2395,0,9,4,112,0,1198,4,1310,California
Sierra,2021-04-26,1,2508,0,103,1,2396,0,9,1,113,0,1198,1,1311,California
Sierra,2021-04-27,31,2539,0,103,31,2427,0,9,4,90,27,1225,4,1315,California
Sierra,2021-04-28,10,2549,2,105,8,2435,0,9,2,84,8,1233,2,1317,California
Sierra,2021-04-29,20,2569,2,107,18,2453,0,9,14,92,6,1239,14,1331,California
Sierra,2021-04-30,3,2572,1,108,2,2455,0,9,1,91,2,1241,1,1332,California
Sierra,2021-05-01,1,2573,0,108,1,2456,0,9,0,91,0,1241,0,1332,California
Sierra,2021-05-03,1,2574,1,109,0,2456,0,9,1,92,0,1241,1,1333,California
Sierra,2021-05-04,3,2577,1,110,1,2457,1,10,1,92,2,1243,2,1335,California
Sierra,2021-05-05,23,2600,1,111,22,2479,0,10,8,85,15,1258,8,1343,California
Sierra,2021-05-06,2,2602,1,112,1,2480,0,10,0,83,2,1260,0,1343,California
Sierra,2021-05-08,1,2603,0,112,0,2480,1,11,0,83,1,1261,1,1344,California
Sierra,2021-05-11,12,2615,0,112,4,2484,8,19,0,79,12,1273,8,1352,California
Sierra,2021-05-12,12,2627,1,113,11,2495,0,19,9,85,3,1276,9,1361,California
Sierra,2021-05-13,3,2630,2,115,1,2496,0,19,2,86,1,1277,2,1363,California
Sierra,2021-05-14,3,2633,1,116,2,2498,0,19,3,89,0,1277,3,1366,California
Sierra,2021-05-15,1,2634,0,116,0,2498,1,20,0,89,1,1278,1,1367,California
Sierra,2021-05-17,1,2635,1,117,0,2498,0,20,1,90,0,1278,1,1368,California
Sierra,2021-05-18,1,2636,0,117,0,2498,1,21,0,90,1,1279,1,1369,California
Sierra,2021-05-19,7,2643,3,120,4,2502,0,21,2,87,5,1284,2,1371,California
Sierra,2021-05-20,9,2652,8,128,0,2502,1,22,8,95,1,1285,9,1380,California
Sierra,2021-05-21,3,2655,1,129,2,2504,0,22,1,94,2,1287,1,1381,California
Sierra,2021-05-22,5,2660,0,129,5,2509,0,22,1,91,4,1291,1,1382,California
Sierra,2021-05-23,1,2661,0,129,1,2510,0,22,1,92,0,1291,1,1383,California
Sierra,2021-05-24,4,2665,1,130,3,2513,0,22,2,93,2,1293,3,1386,California
Sierra,2021-05-25,4,2669,1,131,3,2516,0,22,1,91,3,1296,1,1387,California
Sierra,2021-05-26,8,2677,0,131,8,2524,0,22,4,91,4,1300,4,1391,California
Sierra,2021-05-27,8,2685,1,132,6,2530,1,23,2,88,6,1306,3,1394,California
Sierra,2021-05-28,3,2688,1,133,2,2532,0,23,2,89,1,1307,2,1396,California
Sierra,2021-05-29,2,2690,0,133,2,2534,0,23,2,91,0,1307,2,1398,California
Sierra,2021-05-30,1,2691,1,134,0,2534,0,23,1,92,0,1307,1,1399,California
Sierra,2021-06-01,1,2692,0,134,1,2535,0,23,0,91,1,1308,0,1399,California
Sierra,2021-06-02,23,2715,0,134,21,2556,2,25,0,71,22,1330,2,1401,California
Sierra,2021-06-03,3,2718,2,136,1,2557,0,25,0,68,3,1333,0,1401,California
Sierra,2021-06-04,2,2720,2,138,0,2557,0,25,1,68,1,1334,1,1402,California
Sierra,2021-06-08,1,2721,1,139,0,2557,0,25,1,69,0,1334,1,1403,California
Sierra,2021-06-09,9,2730,1,140,6,2563,2,27,0,62,9,1343,2,1405,California
Sierra,2021-06-10,8,2738,8,148,0,2563,0,27,4,62,4,1347,4,1409,California
Sierra,2021-06-11,3,2741,1,149,2,2565,0,27,0,59,3,1350,0,1409,California
Sierra,2021-06-12,1,2742,1,150,0,2565,0,27,1,60,0,1350,1,1410,California
Sierra,2021-06-13,1,2743,1,151,0,2565,0,27,0,59,1,1351,0,1410,California
Sierra,2021-06-14,7,2750,5,156,1,2566,1,28,3,59,4,1355,4,1414,California
Sierra,2021-06-15,1,2751,0,156,1,2567,0,28,0,59,0,1355,0,1414,California
Sierra,2021-06-16,7,2758,1,157,6,2573,0,28,3,58,4,1359,3,1417,California
Sierra,2021-06-17,5,2763,2,159,1,2574,2,30,2,59,3,1362,4,1421,California
Sierra,2021-06-18,2,2765,1,160,0,2574,1,31,0,58,2,1364,1,1422,California
Sierra,2021-06-21,1,2766,0,160,1,2575,0,31,0,57,1,1365,0,1422,California
Sierra,2021-06-22,5,2771,3,163,2,2577,0,31,3,58,2,1367,3,1425,California
Sierra,2021-06-23,6,2777,0,163,6,2583,0,31,2,56,4,1371,2,1427,California
Sierra,2021-06-24,6,2783,0,163,2,2585,4,35,1,56,5,1376,5,1432,California
Sierra,2021-06-26,1,2784,1,164,0,2585,0,35,1,57,0,1376,1,1433,California
Sierra,2021-06-27,1,2785,1,165,0,2585,0,35,1,58,0,1376,1,1434,California
Sierra,2021-06-28,1,2786,0,165,0,2585,1,36,0,58,1,1377,1,1435,California
Sierra,2021-06-30,3,2789,2,167,0,2585,1,37,1,58,2,1379,2,1437,California
Sierra,2021-07-01,3,2792,1,168,2,2587,0,37,2,59,1,1380,2,1439,California
Sierra,2021-07-02,1,2793,1,169,0,2587,0,37,0,58,1,1381,0,1439,California
Sierra,2021-07-03,1,2794,1,170,0,2587,0,37,0,57,1,1382,0,1439,California
Sierra,2021-07-07,6,2800,6,176,0,2587,0,37,2,55,4,1386,2,1441,California
Sierra,2021-07-08,2,2802,1,177,1,2588,0,37,1,55,1,1387,1,1442,California
Sierra,2021-07-09,2,2804,2,179,0,2588,0,37,2,57,0,1387,2,1444,California
Sierra,2021-07-12,2,2806,1,180,1,2589,0,37,1,57,1,1388,1,1445,California
Sierra,2021-07-13,2,2808,2,182,0,2589,0,37,0,55,2,1390,0,1445,California
Sierra,2021-07-14,5,2813,2,184,2,2591,1,38,1,53,3,1393,1,1446,California
Sierra,2021-07-15,4,2817,1,185,2,2593,1,39,2,55,2,1395,4,1450,California
Sierra,2021-07-16,1,2818,1,186,0,2593,0,39,1,56,0,1395,1,1451,California
Sierra,2021-07-18,3,2821,3,189,0,2593,0,39,2,57,1,1396,2,1453,California
Sierra,2021-07-21,1,2822,1,190,0,2593,0,39,0,56,1,1397,0,1453,California
Sierra,2021-07-22,10,2832,5,195,5,2598,0,39,9,64,1,1398,9,1462,California
Sierra,2021-07-23,3,2835,0,195,3,2601,0,39,1,63,2,1400,1,1463,California
Sierra,2021-07-26,2,2837,2,197,0,2601,0,39,1,63,1,1401,1,1464,California
Sierra,2021-07-27,1,2838,0,197,1,2602,0,39,0,63,0,1401,0,1464,California
Sierra,2021-07-29,5,2843,1,198,4,2606,0,39,3,64,2,1403,3,1467,California
Sierra,2021-07-30,3,2846,3,201,0,2606,0,39,1,63,2,1405,1,1468,California
Siskiyou,2020-12-16,2,2,2,2,0,0,0,0,2,2,0,0,2,2,California
Siskiyou,2020-12-17,4,6,4,6,0,0,0,0,4,6,0,0,4,6,California
Siskiyou,2020-12-18,2,8,2,8,0,0,0,0,2,8,0,0,2,8,California
Siskiyou,2020-12-19,4,12,4,12,0,0,0,0,4,12,0,0,4,12,California
Siskiyou,2020-12-20,1,13,1,13,0,0,0,0,1,13,0,0,1,13,California
Siskiyou,2020-12-21,133,146,133,146,0,0,0,0,133,146,0,0,133,146,California
Siskiyou,2020-12-22,160,306,160,306,0,0,0,0,160,306,0,0,160,306,California
Siskiyou,2020-12-23,142,448,142,448,0,0,0,0,142,448,0,0,142,448,California
Siskiyou,2020-12-24,5,453,5,453,0,0,0,0,5,453,0,0,5,453,California
Siskiyou,2020-12-26,2,455,0,453,2,2,0,0,2,455,0,0,2,455,California
Siskiyou,2020-12-27,2,457,0,453,2,4,0,0,2,457,0,0,2,457,California
Siskiyou,2020-12-28,5,462,3,456,2,6,0,0,5,462,0,0,5,462,California
Siskiyou,2020-12-29,6,468,2,458,4,10,0,0,6,468,0,0,6,468,California
Siskiyou,2020-12-30,103,571,5,463,98,108,0,0,103,571,0,0,103,571,California
Siskiyou,2020-12-31,12,583,0,463,12,120,0,0,12,583,0,0,12,583,California
Siskiyou,2021-01-02,1,584,1,464,0,120,0,0,1,584,0,0,1,584,California
Siskiyou,2021-01-03,1,585,0,464,1,121,0,0,1,585,0,0,1,585,California
Siskiyou,2021-01-04,158,743,3,467,155,276,0,0,158,743,0,0,158,743,California
Siskiyou,2021-01-05,92,835,4,471,88,364,0,0,90,832,2,2,91,834,California
Siskiyou,2021-01-06,61,896,7,478,54,418,0,0,57,885,4,6,57,891,California
Siskiyou,2021-01-07,179,1075,4,482,175,593,0,0,178,1062,1,7,178,1069,California
Siskiyou,2021-01-08,177,1252,3,485,174,767,0,0,175,1235,2,9,175,1244,California
Siskiyou,2021-01-09,3,1255,3,488,0,767,0,0,1,1234,2,11,1,1245,California
Siskiyou,2021-01-11,161,1416,140,628,21,788,0,0,23,1119,138,149,23,1268,California
Siskiyou,2021-01-12,249,1665,199,827,50,838,0,0,90,1051,159,308,91,1359,California
Siskiyou,2021-01-13,162,1827,141,968,21,859,0,0,23,935,139,447,23,1382,California
Siskiyou,2021-01-14,35,1862,1,969,34,893,0,0,34,968,1,448,34,1416,California
Siskiyou,2021-01-15,55,1917,3,972,52,945,0,0,55,1023,0,448,55,1471,California
Siskiyou,2021-01-16,7,1924,2,974,5,950,0,0,7,1030,0,448,7,1478,California
Siskiyou,2021-01-17,1,1925,1,975,0,950,0,0,0,1029,1,449,0,1478,California
Siskiyou,2021-01-18,80,2005,3,978,77,1027,0,0,78,1105,2,451,78,1556,California
Siskiyou,2021-01-19,35,2040,1,979,34,1061,0,0,34,1138,1,452,34,1590,California
Siskiyou,2021-01-20,69,2109,36,1015,33,1094,0,0,64,1197,5,457,64,1654,California
Siskiyou,2021-01-21,68,2177,2,1017,66,1160,0,0,68,1265,0,457,68,1722,California
Siskiyou,2021-01-22,1340,3517,1173,2190,167,1327,0,0,1340,2605,0,457,1340,3062,California
Siskiyou,2021-01-23,6,3523,2,2192,4,1331,0,0,3,2605,3,460,3,3065,California
Siskiyou,2021-01-25,211,3734,10,2202,201,1532,0,0,207,2808,4,464,207,3272,California
Siskiyou,2021-01-26,98,3832,3,2205,95,1627,0,0,89,2888,9,473,89,3361,California
Siskiyou,2021-01-27,201,4033,4,2209,197,1824,0,0,133,2954,67,540,133,3494,California
Siskiyou,2021-01-28,285,4318,116,2325,169,1993,0,0,260,3195,19,559,260,3754,California
Siskiyou,2021-01-29,247,4565,4,2329,243,2236,0,0,229,3406,18,577,229,3983,California
Siskiyou,2021-01-30,5,4570,4,2333,1,2237,0,0,5,3411,0,577,5,3988,California
Siskiyou,2021-02-01,268,4838,3,2336,265,2502,0,0,114,3371,154,731,114,4102,California
Siskiyou,2021-02-02,274,5112,45,2381,229,2731,0,0,156,3409,118,849,156,4258,California
Siskiyou,2021-02-03,319,5431,1,2382,318,3049,0,0,265,3620,54,903,265,4523,California
Siskiyou,2021-02-04,379,5810,7,2389,372,3421,0,0,223,3687,156,1059,223,4746,California
Siskiyou,2021-02-05,563,6373,4,2393,559,3980,0,0,377,3878,186,1245,377,5123,California
Siskiyou,2021-02-06,15,6388,0,2393,15,3995,0,0,15,3893,0,1245,15,5138,California
Siskiyou,2021-02-07,2,6390,1,2394,1,3996,0,0,2,3895,0,1245,2,5140,California
Siskiyou,2021-02-08,237,6627,4,2398,233,4229,0,0,212,4082,25,1270,212,5352,California
Siskiyou,2021-02-09,210,6837,2,2400,208,4437,0,0,179,4230,31,1301,179,5531,California
Siskiyou,2021-02-10,389,7226,42,2442,347,4784,0,0,319,4480,69,1370,319,5850,California
Siskiyou,2021-02-11,216,7442,2,2444,214,4998,0,0,186,4636,30,1400,186,6036,California
Siskiyou,2021-02-12,1699,9141,1196,3640,503,5501,0,0,495,3927,1204,2604,495,6531,California
Siskiyou,2021-02-13,38,9179,2,3642,36,5537,0,0,33,3955,5,2609,33,6564,California
Siskiyou,2021-02-14,6,9185,2,3644,4,5541,0,0,6,3961,0,2609,6,6570,California
Siskiyou,2021-02-15,100,9285,3,3647,97,5638,0,0,96,4053,4,2613,96,6666,California
Siskiyou,2021-02-16,137,9422,2,3649,135,5773,0,0,100,4116,37,2650,100,6766,California
Siskiyou,2021-02-17,286,9708,4,3653,282,6055,0,0,249,4328,37,2687,249,7015,California
Siskiyou,2021-02-18,277,9985,93,3746,184,6239,0,0,129,4309,148,2835,129,7144,California
Siskiyou,2021-02-19,96,10081,34,3780,62,6301,0,0,35,4285,59,2894,35,7179,California
Siskiyou,2021-02-20,22,10103,4,3784,18,6319,0,0,16,4297,6,2900,18,7197,California
Siskiyou,2021-02-21,1,10104,1,3785,0,6319,0,0,1,4298,0,2900,1,7198,California
Siskiyou,2021-02-22,218,10322,2,3787,216,6535,0,0,77,4234,141,3041,77,7275,California
Siskiyou,2021-02-23,270,10592,14,3801,256,6791,0,0,180,4324,90,3131,180,7455,California
Siskiyou,2021-02-24,172,10764,5,3806,167,6958,0,0,50,4252,122,3253,50,7505,California
Siskiyou,2021-02-25,309,11073,16,3822,293,7251,0,0,148,4240,160,3413,148,7653,California
Siskiyou,2021-02-26,681,11754,8,3830,673,7924,0,0,370,4299,311,3724,370,8023,California
Siskiyou,2021-02-27,31,11785,6,3836,25,7949,0,0,27,4322,4,3728,27,8050,California
Siskiyou,2021-02-28,3,11788,3,3839,0,7949,0,0,2,4323,1,3729,2,8052,California
Siskiyou,2021-03-01,300,12088,5,3844,295,8244,0,0,53,4129,247,3976,53,8105,California
Siskiyou,2021-03-02,210,12298,1,3845,209,8453,0,0,72,4063,138,4114,72,8177,California
Siskiyou,2021-03-03,357,12655,12,3857,345,8798,0,0,157,4020,200,4314,157,8334,California
Siskiyou,2021-03-04,829,13484,619,4476,210,9008,0,0,643,4477,186,4500,643,8977,California
Siskiyou,2021-03-05,353,13837,5,4481,337,9345,11,11,107,4352,243,4743,118,9095,California
Siskiyou,2021-03-06,42,13879,3,4484,32,9377,7,18,27,4371,15,4758,34,9129,California
Siskiyou,2021-03-07,11,13890,3,4487,0,9377,8,26,1,4370,10,4768,9,9138,California
Siskiyou,2021-03-08,429,14319,21,4508,375,9752,33,59,68,4110,361,5129,101,9239,California
Siskiyou,2021-03-09,247,14566,2,4510,190,9942,55,114,44,4005,203,5332,98,9337,California
Siskiyou,2021-03-10,294,14860,6,4516,259,10201,29,143,24,3788,270,5602,53,9390,California
Siskiyou,2021-03-11,520,15380,204,4720,270,10471,46,189,281,3880,235,5837,327,9717,California
Siskiyou,2021-03-12,703,16083,148,4868,516,10987,39,228,191,3599,510,6347,229,9946,California
Siskiyou,2021-03-13,426,16509,377,5245,26,11013,23,251,377,3950,49,6396,400,10346,California
Siskiyou,2021-03-14,19,16528,0,5245,3,11016,16,267,2,3950,17,6413,17,10363,California
Siskiyou,2021-03-15,509,17037,256,5501,190,11206,63,330,334,4172,175,6588,397,10760,California
Siskiyou,2021-03-16,251,17288,28,5529,207,11413,16,346,134,4206,116,6704,150,10910,California
Siskiyou,2021-03-17,204,17492,9,5538,186,11599,9,355,35,4081,169,6873,44,10954,California
Siskiyou,2021-03-18,921,18413,783,6321,126,11725,12,367,801,4775,119,6992,813,11767,California
Siskiyou,2021-03-19,61,18474,5,6326,43,11768,13,380,17,4761,44,7036,30,11797,California
Siskiyou,2021-03-20,29,18503,7,6333,18,11786,4,384,5,4746,24,7060,9,11806,California
Siskiyou,2021-03-21,8,18511,2,6335,1,11787,5,389,3,4749,5,7065,8,11814,California
Siskiyou,2021-03-22,207,18718,18,6353,166,11953,23,412,142,4852,62,7127,165,11979,California
Siskiyou,2021-03-23,161,18879,19,6372,133,12086,9,421,120,4939,41,7168,128,12107,California
Siskiyou,2021-03-24,145,19024,48,6420,97,12183,0,421,115,5024,30,7198,115,12222,California
Siskiyou,2021-03-25,561,19585,311,6731,247,12430,3,424,389,5244,172,7370,392,12614,California
Siskiyou,2021-03-26,310,19895,34,6765,276,12706,0,424,101,5138,207,7577,101,12715,California
Siskiyou,2021-03-27,37,19932,6,6771,26,12732,5,429,10,5126,27,7604,15,12730,California
Siskiyou,2021-03-28,7,19939,6,6777,1,12733,0,429,5,5129,2,7606,5,12735,California
Siskiyou,2021-03-29,92,20031,10,6787,80,12813,2,431,43,5125,49,7655,45,12780,California
Siskiyou,2021-03-30,101,20132,6,6793,94,12907,1,432,38,5102,63,7718,40,12820,California
Siskiyou,2021-03-31,175,20307,8,6801,164,13071,3,435,44,5022,128,7846,48,12868,California
Siskiyou,2021-04-01,824,21131,666,7467,158,13229,0,435,210,4618,614,8460,210,13078,California
Siskiyou,2021-04-02,348,21479,197,7664,147,13376,4,439,66,4408,280,8740,70,13148,California
Siskiyou,2021-04-03,26,21505,5,7669,14,13390,7,446,5,4399,21,8761,12,13160,California
Siskiyou,2021-04-04,1,21506,0,7669,1,13391,0,446,1,4400,0,8761,1,13161,California
Siskiyou,2021-04-05,434,21940,331,8000,78,13469,25,471,26,4044,407,9168,51,13212,California
Siskiyou,2021-04-06,222,22162,37,8037,132,13601,53,524,128,4132,92,9260,180,13392,California
Siskiyou,2021-04-07,115,22277,11,8048,63,13664,41,565,64,4187,51,9311,106,13498,California
Siskiyou,2021-04-08,342,22619,172,8220,126,13790,44,609,64,4017,278,9589,108,13606,California
Siskiyou,2021-04-09,548,23167,378,8598,132,13922,38,647,87,3683,460,10049,126,13732,California
Siskiyou,2021-04-10,43,23210,5,8603,2,13924,36,683,5,3686,38,10087,41,13773,California
Siskiyou,2021-04-11,5,23215,3,8606,1,13925,1,684,1,3684,4,10091,2,13775,California
Siskiyou,2021-04-12,128,23343,22,8628,104,14029,2,686,31,3620,97,10188,33,13808,California
Siskiyou,2021-04-13,204,23547,37,8665,166,14195,1,687,81,3579,123,10311,82,13890,California
Siskiyou,2021-04-14,157,23704,64,8729,93,14288,0,687,85,3594,70,10381,85,13975,California
Siskiyou,2021-04-15,1112,24816,953,9682,159,14447,0,687,435,3353,677,11058,436,14411,California
Siskiyou,2021-04-16,310,25126,217,9899,92,14539,1,688,267,3580,40,11098,267,14678,California
Siskiyou,2021-04-17,11,25137,8,9907,3,14542,0,688,6,3581,5,11103,6,14684,California
Siskiyou,2021-04-18,6,25143,3,9910,3,14545,0,688,2,3579,4,11107,2,14686,California
Siskiyou,2021-04-19,129,25272,24,9934,105,14650,0,688,46,3542,83,11190,46,14732,California
Siskiyou,2021-04-20,209,25481,4,9938,205,14855,0,688,88,3510,120,11310,88,14820,California
Siskiyou,2021-04-21,95,25576,10,9948,85,14940,0,688,25,3465,70,11380,25,14845,California
Siskiyou,2021-04-22,407,25983,298,10246,109,15049,0,688,47,3152,360,11740,47,14892,California
Siskiyou,2021-04-23,181,26164,14,10260,167,15216,0,688,158,3288,22,11762,158,15050,California
Siskiyou,2021-04-24,26,26190,4,10264,22,15238,0,688,19,3300,7,11769,19,15069,California
Siskiyou,2021-04-25,2,26192,0,10264,2,15240,0,688,2,3302,0,11769,2,15071,California
Siskiyou,2021-04-26,99,26291,4,10268,90,15330,5,693,24,3256,75,11844,29,15100,California
Siskiyou,2021-04-27,115,26406,5,10273,108,15438,2,695,86,3317,27,11871,88,15188,California
Siskiyou,2021-04-28,110,26516,7,10280,95,15533,8,703,53,3321,57,11928,61,15249,California
Siskiyou,2021-04-29,149,26665,16,10296,132,15665,1,704,30,3233,119,12047,31,15280,California
Siskiyou,2021-04-30,103,26768,22,10318,80,15745,1,705,44,3221,56,12103,44,15324,California
Siskiyou,2021-05-01,10,26778,6,10324,1,15746,3,708,6,3226,4,12107,9,15333,California
Siskiyou,2021-05-02,9,26787,3,10327,6,15752,0,708,8,3233,1,12108,8,15341,California
Siskiyou,2021-05-03,105,26892,22,10349,81,15833,2,710,42,3214,63,12171,44,15385,California
Siskiyou,2021-05-04,121,27013,7,10356,112,15945,2,712,60,3216,60,12231,62,15447,California
Siskiyou,2021-05-05,116,27129,19,10375,88,16033,9,721,39,3188,76,12307,48,15495,California
Siskiyou,2021-05-06,365,27494,295,10670,64,16097,6,727,190,3209,175,12482,196,15691,California
Siskiyou,2021-05-07,306,27800,217,10887,84,16181,5,732,31,2971,274,12756,36,15727,California
Siskiyou,2021-05-08,24,27824,3,10890,20,16201,1,733,19,2986,5,12761,20,15747,California
Siskiyou,2021-05-09,1,27825,0,10890,1,16202,0,733,0,2985,1,12762,0,15747,California
Siskiyou,2021-05-10,100,27925,68,10958,31,16233,1,734,24,2934,76,12838,25,15772,California
Siskiyou,2021-05-11,90,28015,9,10967,75,16308,6,740,52,2954,38,12876,58,15830,California
Siskiyou,2021-05-12,111,28126,4,10971,102,16410,5,745,17,2883,93,12969,22,15852,California
Siskiyou,2021-05-13,130,28256,35,11006,86,16496,9,754,38,2838,92,13061,47,15899,California
Siskiyou,2021-05-14,176,28432,82,11088,93,16589,1,755,108,2880,67,13128,109,16008,California
Siskiyou,2021-05-15,44,28476,14,11102,28,16617,2,757,37,2913,6,13134,39,16047,California
Siskiyou,2021-05-16,6,28482,2,11104,4,16621,0,757,4,2915,2,13136,4,16051,California
Siskiyou,2021-05-17,63,28545,2,11106,38,16659,23,780,12,2899,51,13187,35,16086,California
Siskiyou,2021-05-18,214,28759,82,11188,128,16787,4,784,123,2936,90,13277,127,16213,California
Siskiyou,2021-05-19,200,28959,97,11285,102,16889,1,785,167,3071,33,13310,168,16381,California
Siskiyou,2021-05-20,534,29493,430,11715,102,16991,2,787,239,3019,293,13603,241,16622,California
Siskiyou,2021-05-21,240,29733,94,11809,145,17136,1,788,108,2997,131,13734,109,16731,California
Siskiyou,2021-05-22,41,29774,19,11828,22,17158,0,788,27,3010,14,13748,27,16758,California
Siskiyou,2021-05-23,3,29777,2,11830,1,17159,0,788,2,3011,1,13749,2,16760,California
Siskiyou,2021-05-24,43,29820,3,11833,40,17199,0,788,29,3027,13,13762,29,16789,California
Siskiyou,2021-05-25,154,29974,15,11848,119,17318,20,808,49,2992,104,13866,69,16858,California
Siskiyou,2021-05-26,76,30050,19,11867,57,17375,0,808,41,2998,35,13901,41,16899,California
Siskiyou,2021-05-27,130,30180,93,11960,36,17411,1,809,55,2979,75,13976,56,16955,California
Siskiyou,2021-05-28,151,30331,58,12018,92,17503,1,810,100,3030,50,14026,101,17056,California
Siskiyou,2021-05-29,16,30347,9,12027,4,17507,3,813,5,3027,11,14037,8,17064,California
Siskiyou,2021-05-31,2,30349,1,12028,0,17507,1,814,1,3028,1,14038,2,17066,California
Siskiyou,2021-06-01,86,30435,20,12048,66,17573,0,814,29,3001,56,14094,29,17095,California
Siskiyou,2021-06-02,118,30553,33,12081,85,17658,0,814,46,2975,72,14166,46,17141,California
Siskiyou,2021-06-03,155,30708,108,12189,42,17700,5,819,39,2904,115,14281,44,17185,California
Siskiyou,2021-06-04,100,30808,76,12265,24,17724,0,819,21,2846,79,14360,21,17206,California
Siskiyou,2021-06-05,37,30845,18,12283,18,17742,1,820,13,2836,24,14384,14,17220,California
Siskiyou,2021-06-06,3,30848,2,12285,0,17742,1,821,0,2834,3,14387,1,17221,California
Siskiyou,2021-06-07,38,30886,4,12289,30,17772,4,825,26,2852,12,14399,30,17251,California
Siskiyou,2021-06-08,211,31097,93,12382,115,17887,3,828,67,2783,139,14538,70,17321,California
Siskiyou,2021-06-09,110,31207,81,12463,28,17915,1,829,28,2731,81,14619,29,17350,California
Siskiyou,2021-06-10,176,31383,144,12607,31,17946,1,830,76,2708,100,14719,77,17427,California
Siskiyou,2021-06-11,114,31497,59,12666,48,17994,7,837,23,2670,68,14787,30,17457,California
Siskiyou,2021-06-12,29,31526,6,12672,23,18017,0,837,9,2659,20,14807,9,17466,California
Siskiyou,2021-06-13,24,31550,16,12688,8,18025,0,837,2,2639,22,14829,2,17468,California
Siskiyou,2021-06-14,24,31574,4,12692,16,18041,4,841,11,2640,13,14842,14,17482,California
Siskiyou,2021-06-15,91,31665,24,12716,54,18095,13,854,34,2630,57,14899,47,17529,California
Siskiyou,2021-06-16,102,31767,23,12739,77,18172,2,856,10,2550,92,14991,12,17541,California
Siskiyou,2021-06-17,184,31951,139,12878,32,18204,13,869,40,2460,143,15134,53,17594,California
Siskiyou,2021-06-18,97,32048,62,12940,27,18231,8,877,20,2411,77,15211,28,17622,California
Siskiyou,2021-06-19,26,32074,17,12957,9,18240,0,877,12,2409,14,15225,12,17634,California
Siskiyou,2021-06-20,3,32077,2,12959,0,18240,1,878,2,2411,1,15226,3,17637,California
Siskiyou,2021-06-21,38,32115,3,12962,33,18273,2,880,5,2385,33,15259,7,17644,California
Siskiyou,2021-06-22,66,32181,25,12987,37,18310,4,884,32,2387,34,15293,36,17680,California
Siskiyou,2021-06-23,54,32235,7,12994,42,18352,5,889,11,2361,42,15335,16,17696,California
Siskiyou,2021-06-24,100,32335,60,13054,31,18383,9,898,48,2366,52,15387,57,17753,California
Siskiyou,2021-06-25,98,32433,62,13116,36,18419,0,898,66,2401,31,15418,66,17819,California
Siskiyou,2021-06-26,8,32441,3,13119,5,18424,0,898,4,2401,4,15422,4,17823,California
Siskiyou,2021-06-28,10,32451,4,13123,6,18430,0,898,5,2401,5,15427,5,17828,California
Siskiyou,2021-06-29,79,32530,54,13177,23,18453,2,900,42,2408,37,15464,44,17872,California
Siskiyou,2021-06-30,58,32588,10,13187,45,18498,3,903,14,2382,43,15507,17,17889,California
Siskiyou,2021-07-01,34,32622,22,13209,7,18505,5,908,12,2377,22,15529,17,17906,California
Siskiyou,2021-07-02,58,32680,36,13245,22,18527,0,908,40,2399,18,15547,40,17946,California
Siskiyou,2021-07-03,16,32696,5,13250,11,18538,0,908,9,2401,7,15554,9,17955,California
Siskiyou,2021-07-05,15,32711,5,13255,10,18548,0,908,4,2395,10,15564,4,17959,California
Siskiyou,2021-07-06,60,32771,14,13269,41,18589,5,913,17,2374,43,15607,22,17981,California
Siskiyou,2021-07-07,36,32807,10,13279,24,18613,2,915,12,2364,24,15631,14,17995,California
Siskiyou,2021-07-08,106,32913,73,13352,30,18643,3,918,42,2346,64,15695,46,18041,California
Siskiyou,2021-07-09,72,32985,45,13397,23,18666,4,922,52,2382,20,15715,56,18097,California
Siskiyou,2021-07-10,17,33002,7,13404,10,18676,0,922,8,2381,9,15724,8,18105,California
Siskiyou,2021-07-11,2,33004,0,13404,2,18678,0,922,2,2383,0,15724,2,18107,California
Siskiyou,2021-07-12,24,33028,10,13414,13,18691,1,923,4,2368,20,15744,5,18112,California
Siskiyou,2021-07-13,59,33087,26,13440,31,18722,2,925,26,2363,33,15777,28,18140,California
Siskiyou,2021-07-14,32,33119,12,13452,19,18741,1,926,15,2363,16,15793,16,18156,California
Siskiyou,2021-07-15,74,33193,50,13502,19,18760,5,931,38,2370,36,15829,43,18199,California
Siskiyou,2021-07-16,70,33263,52,13554,14,18774,4,935,14,2333,55,15884,18,18217,California
Siskiyou,2021-07-17,5,33268,2,13556,3,18777,0,935,3,2334,2,15886,3,18220,California
Siskiyou,2021-07-18,5,33273,2,13558,3,18780,0,935,4,2337,1,15887,4,18224,California
Siskiyou,2021-07-19,11,33284,2,13560,9,18789,0,935,6,2339,4,15891,6,18230,California
Siskiyou,2021-07-20,82,33366,54,13614,22,18811,6,941,35,2333,47,15938,41,18271,California
Siskiyou,2021-07-21,32,33398,17,13631,15,18826,0,941,22,2345,10,15948,22,18293,California
Siskiyou,2021-07-22,71,33469,45,13676,23,18849,3,944,43,2363,28,15976,46,18339,California
Siskiyou,2021-07-23,59,33528,36,13712,23,18872,0,944,26,2358,31,16007,26,18365,California
Siskiyou,2021-07-24,18,33546,10,13722,7,18879,1,945,13,2367,5,16012,14,18379,California
Siskiyou,2021-07-25,2,33548,0,13722,1,18880,1,946,1,2368,1,16013,2,18381,California
Siskiyou,2021-07-26,25,33573,16,13738,8,18888,1,947,23,2390,2,16015,24,18405,California
Siskiyou,2021-07-27,63,33636,26,13764,35,18923,2,949,40,2409,23,16038,42,18447,California
Siskiyou,2021-07-28,54,33690,28,13792,24,18947,2,951,38,2434,15,16053,40,18487,California
Siskiyou,2021-07-29,88,33778,48,13840,28,18975,12,963,45,2448,43,16096,57,18544,California
Siskiyou,2021-07-30,78,33856,52,13892,24,18999,2,965,29,2431,48,16144,31,18575,California
Siskiyou,2021-07-31,7,33863,2,13894,5,19004,0,965,3,2430,4,16148,3,18578,California
Solano,2020-12-15,4,4,4,4,0,0,0,0,4,4,0,0,4,4,California
Solano,2020-12-16,71,75,71,75,0,0,0,0,71,75,0,0,71,75,California
Solano,2020-12-17,167,242,167,242,0,0,0,0,167,242,0,0,167,242,California
Solano,2020-12-18,477,719,475,717,2,2,0,0,477,719,0,0,477,719,California
Solano,2020-12-19,523,1242,523,1240,0,2,0,0,523,1242,0,0,523,1242,California
Solano,2020-12-20,348,1590,346,1586,2,4,0,0,348,1590,0,0,348,1590,California
Solano,2020-12-21,575,2165,573,2159,2,6,0,0,575,2165,0,0,575,2165,California
Solano,2020-12-22,658,2823,624,2783,34,40,0,0,658,2823,0,0,658,2823,California
Solano,2020-12-23,857,3680,762,3545,95,135,0,0,856,3678,1,1,856,3679,California
Solano,2020-12-24,412,4092,162,3707,250,385,0,0,412,4090,0,1,412,4091,California
Solano,2020-12-25,9,4101,1,3708,8,393,0,0,9,4099,0,1,9,4100,California
Solano,2020-12-26,173,4274,44,3752,129,522,0,0,173,4272,0,1,173,4273,California
Solano,2020-12-27,108,4382,29,3781,79,601,0,0,108,4380,0,1,108,4381,California
Solano,2020-12-28,890,5272,434,4215,456,1057,0,0,890,5270,0,1,890,5271,California
Solano,2020-12-29,917,6189,372,4587,545,1602,0,0,917,6187,0,1,917,6188,California
Solano,2020-12-30,1239,7428,597,5184,642,2244,0,0,1239,7426,0,1,1239,7427,California
Solano,2020-12-31,544,7972,141,5325,403,2647,0,0,543,7969,0,1,543,7970,California
Solano,2021-01-01,15,7987,14,5339,1,2648,0,0,15,7984,0,1,15,7985,California
Solano,2021-01-02,218,8205,168,5507,50,2698,0,0,218,8202,0,1,218,8203,California
Solano,2021-01-03,55,8260,40,5547,15,2713,0,0,49,8251,0,1,49,8252,California
Solano,2021-01-04,451,8711,241,5788,210,2923,0,0,442,8691,2,3,442,8694,California
Solano,2021-01-05,728,9439,378,6166,350,3273,0,0,568,9104,155,158,568,9262,California
Solano,2021-01-06,842,10281,433,6599,409,3682,0,0,575,9414,265,423,575,9837,California
Solano,2021-01-07,1062,11343,673,7272,389,4071,0,0,595,9545,465,888,596,10433,California
Solano,2021-01-08,1160,12503,781,8053,379,4450,0,0,558,9521,584,1472,560,10993,California
Solano,2021-01-09,900,13403,765,8818,135,4585,0,0,441,9506,456,1928,441,11434,California
Solano,2021-01-10,263,13666,193,9011,70,4655,0,0,162,9567,101,2029,162,11596,California
Solano,2021-01-11,1337,15003,1122,10133,215,4870,0,0,820,9870,517,2546,820,12416,California
Solano,2021-01-12,1571,16574,1172,11305,399,5269,0,0,1025,10351,545,3091,1026,13442,California
Solano,2021-01-13,1478,18052,1001,12306,477,5746,0,0,1224,11323,252,3343,1224,14666,California
Solano,2021-01-14,1932,19984,826,13132,1106,6852,0,0,1618,12630,311,3654,1618,16284,California
Solano,2021-01-15,1719,21703,1059,14191,660,7512,0,0,1421,13753,298,3952,1421,17705,California
Solano,2021-01-16,1299,23002,908,15099,391,7903,0,0,1129,14712,170,4122,1129,18834,California
Solano,2021-01-17,1060,24062,762,15861,298,8201,0,0,1039,15731,21,4143,1040,19874,California
Solano,2021-01-18,1432,25494,858,16719,574,8775,0,0,1308,16915,124,4267,1308,21182,California
Solano,2021-01-19,1665,27159,1343,18062,322,9097,0,0,1394,18039,270,4537,1394,22576,California
Solano,2021-01-20,2075,29234,1435,19497,640,9737,0,0,1580,19127,492,5029,1580,24156,California
Solano,2021-01-21,3263,32497,1043,20540,2220,11957,0,0,2903,21672,360,5389,2905,27061,California
Solano,2021-01-22,1802,34299,859,21399,943,12900,0,0,1603,23077,199,5588,1604,28665,California
Solano,2021-01-23,739,35038,242,21641,497,13397,0,0,532,23402,208,5796,533,29198,California
Solano,2021-01-24,458,35496,63,21704,395,13792,0,0,389,23722,69,5865,389,29587,California
Solano,2021-01-25,1691,37187,633,22337,1058,14850,0,0,1125,24283,565,6430,1126,30713,California
Solano,2021-01-26,1818,39005,747,23084,1071,15921,0,0,1170,24806,648,7078,1171,31884,California
Solano,2021-01-27,1820,40825,728,23812,1092,17013,0,0,1196,25382,620,7698,1196,33080,California
Solano,2021-01-28,1986,42811,711,24523,1275,18288,0,0,1391,26180,594,8292,1392,34472,California
Solano,2021-01-29,1732,44543,788,25311,944,19232,0,0,1366,27184,362,8654,1366,35838,California
Solano,2021-01-30,943,45486,434,25745,509,19741,0,0,616,27474,327,8981,617,36455,California
Solano,2021-01-31,271,45757,181,25926,90,19831,0,0,173,27550,97,9078,173,36628,California
Solano,2021-02-01,1568,47325,1037,26963,531,20362,0,0,778,27542,786,9864,778,37406,California
Solano,2021-02-02,3392,50717,1093,28056,2299,22661,0,0,2575,29305,812,10676,2575,39981,California
Solano,2021-02-03,2278,52995,1308,29364,970,23631,0,0,1167,29364,1108,11784,1167,41148,California
Solano,2021-02-04,1841,54836,908,30272,933,24564,0,0,1095,29719,741,12525,1096,42244,California
Solano,2021-02-05,3141,57977,1416,31688,1725,26289,0,0,2120,30826,1014,13539,2121,44365,California
Solano,2021-02-06,3114,61091,1177,32865,1937,28226,0,0,2279,32274,831,14370,2279,46644,California
Solano,2021-02-07,858,61949,784,33649,74,28300,0,0,236,31889,621,14991,236,46880,California
Solano,2021-02-08,1778,63727,1238,34887,540,28840,0,0,722,31558,1053,16044,722,47602,California
Solano,2021-02-09,1957,65684,1495,36382,462,29302,0,0,690,30983,1265,17309,690,48292,California
Solano,2021-02-10,2306,67990,1508,37890,798,30100,0,0,825,30328,1480,18789,825,49117,California
Solano,2021-02-11,2557,70547,1501,39391,1056,31156,0,0,1197,30177,1348,20137,1197,50314,California
Solano,2021-02-12,4305,74852,1634,41025,2671,33827,0,0,2929,31740,1366,21503,2929,53243,California
Solano,2021-02-13,2908,77760,248,41273,2660,36487,0,0,2485,33807,418,21921,2485,55728,California
Solano,2021-02-14,729,78489,205,41478,524,37011,0,0,405,33891,322,22243,406,56134,California
Solano,2021-02-15,1316,79805,310,41788,1006,38017,0,0,679,33934,636,22879,679,56813,California
Solano,2021-02-16,2585,82390,1386,43174,1199,39216,0,0,1679,34709,905,23784,1680,58493,California
Solano,2021-02-17,3292,85682,1447,44621,1845,41061,0,0,2233,35887,1056,24840,2234,60727,California
Solano,2021-02-18,2966,88648,849,45470,2117,43178,0,0,859,34647,2099,26939,859,61586,California
Solano,2021-02-19,2520,91168,1476,46946,1044,44222,0,0,1183,34501,1331,28270,1185,62771,California
Solano,2021-02-20,2801,93969,396,47342,2405,46627,0,0,2271,36243,529,28799,2271,65042,California
Solano,2021-02-21,2399,96368,2017,49359,382,47009,0,0,2024,37897,370,29169,2024,67066,California
Solano,2021-02-22,1856,98224,1091,50450,765,47774,0,0,962,37969,891,30060,963,68029,California
Solano,2021-02-23,2983,101207,1123,51573,1860,49634,0,0,2022,39034,957,31017,2022,70051,California
Solano,2021-02-24,2609,103816,1298,52871,1311,50945,0,0,1429,39288,1176,32193,1430,71481,California
Solano,2021-02-25,2710,106526,1599,54470,1111,52056,0,0,1477,39538,1227,33420,1477,72958,California
Solano,2021-02-26,3632,110158,2309,56779,1323,53379,0,0,2144,40201,1481,34901,2144,75102,California
Solano,2021-02-27,4037,114195,1553,58332,2483,55862,1,1,3250,42678,775,35676,3252,78354,California
Solano,2021-02-28,1963,116158,1579,59911,383,56245,1,2,1621,43964,337,36013,1623,79977,California
Solano,2021-03-01,2799,118957,1237,61148,1561,57806,1,3,2108,45390,683,36696,2109,82086,California
Solano,2021-03-02,2424,121381,1455,62603,969,58775,0,3,1326,45619,1097,37793,1326,83412,California
Solano,2021-03-03,2302,123683,1290,63893,1012,59787,0,3,1418,46165,874,38667,1420,84832,California
Solano,2021-03-04,4471,128154,3458,67351,1011,60798,2,5,3185,48079,1276,39943,3190,88022,California
Solano,2021-03-05,5044,133198,1704,69055,3334,64132,6,11,4018,51087,1015,40958,4023,92045,California
Solano,2021-03-06,3917,137115,858,69913,3017,67149,42,53,2656,52537,1248,42206,2698,94743,California
Solano,2021-03-07,3646,140761,770,70683,2850,69999,26,79,1970,52872,1662,43868,1997,96740,California
Solano,2021-03-08,2197,142958,1347,72030,579,70578,271,350,1626,54200,567,44435,1895,98635,California
Solano,2021-03-09,3267,146225,1578,73608,1633,72211,56,406,2353,55690,913,45348,2403,101038,California
Solano,2021-03-10,2443,148668,1760,75368,598,72809,85,491,1285,55907,1151,46499,1368,102406,California
Solano,2021-03-11,6077,154745,1769,77137,4059,76868,249,740,5022,60129,1050,47549,5272,107678,California
Solano,2021-03-12,6154,160899,1573,78710,4402,81270,179,919,3251,60669,2890,50439,3430,111108,California
Solano,2021-03-13,4637,165536,811,79521,3745,85015,81,1000,2251,60628,2376,52815,2335,113443,California
Solano,2021-03-14,4035,169571,3150,82671,416,85431,469,1469,1544,60151,2486,55301,2009,115452,California
Solano,2021-03-15,4060,173631,2473,85144,1254,86685,333,1802,2532,61497,1517,56818,2863,118315,California
Solano,2021-03-16,3109,176740,1330,86474,1545,88230,234,2036,1566,61763,1533,58351,1799,120114,California
Solano,2021-03-17,6582,183322,1681,88155,4806,93036,95,2131,4968,65217,1609,59960,5063,125177,California
Solano,2021-03-18,5260,188582,1863,90018,3357,96393,40,2171,3761,67529,1490,61450,3802,128979,California
Solano,2021-03-19,3610,192192,2663,92681,870,97263,77,2248,1624,67254,1977,63427,1702,130681,California
Solano,2021-03-20,5616,197808,1685,94366,3879,101142,52,2300,2627,66954,2978,66405,2678,133359,California
Solano,2021-03-21,1687,199495,1585,95951,77,101219,25,2325,364,66028,1313,67718,387,133746,California
Solano,2021-03-22,2703,202198,2054,98005,600,101819,49,2374,1559,66496,1137,68855,1605,135351,California
Solano,2021-03-23,3619,205817,1705,99710,1869,103688,45,2419,1397,65723,2214,71069,1441,136792,California
Solano,2021-03-24,2851,208668,1783,101493,1034,104722,34,2453,1357,65627,1485,72554,1389,138181,California
Solano,2021-03-25,4916,213584,4023,105516,858,105580,35,2488,2286,65323,2624,75178,2320,140501,California
Solano,2021-03-26,3271,216855,2128,107644,1106,106686,37,2525,1736,65574,1523,76701,1774,142275,California
Solano,2021-03-27,4235,221090,1155,108799,3038,109724,42,2567,1652,64692,2574,79275,1692,143967,California
Solano,2021-03-28,1436,222526,1121,109920,298,110022,17,2584,538,64354,893,80168,555,144522,California
Solano,2021-03-29,3576,226102,2054,111974,1503,111525,19,2603,1533,63878,2029,82197,1553,146075,California
Solano,2021-03-30,3073,229175,2027,114001,944,112469,102,2705,1900,64707,1171,83368,2000,148075,California
Solano,2021-03-31,3157,232332,2149,116150,849,113318,159,2864,1846,65403,1306,84674,2002,150077,California
Solano,2021-04-01,5600,237932,2117,118267,3329,116647,154,3018,3530,67031,2056,86730,3684,153761,California
Solano,2021-04-02,6669,244601,2240,120507,4262,120909,167,3185,2537,65620,4112,90842,2701,156462,California
Solano,2021-04-03,1550,246151,988,121495,408,121317,154,3339,585,65395,963,91805,738,157200,California
Solano,2021-04-04,783,246934,288,121783,190,121507,305,3644,237,65395,542,92347,542,157742,California
Solano,2021-04-05,3036,249970,2084,123867,741,122248,211,3855,1516,65605,1515,93862,1725,159467,California
Solano,2021-04-06,6131,256101,1644,125511,3998,126246,489,4344,1626,63224,4495,98357,2114,161581,California
Solano,2021-04-07,6018,262119,4658,130169,956,127202,404,4748,3419,64465,2580,100937,3821,165402,California
Solano,2021-04-08,6535,268654,1795,131964,3865,131067,875,5623,1796,62419,4707,105644,2661,168063,California
Solano,2021-04-09,6466,275120,1684,133648,3927,134994,855,6478,1565,59956,4875,110519,2412,170475,California
Solano,2021-04-10,1804,276924,972,134620,456,135450,376,6854,815,60158,987,111506,1189,171664,California
Solano,2021-04-11,1203,278127,772,135392,327,135777,104,6958,643,60348,557,112063,747,172411,California
Solano,2021-04-12,3296,281423,1712,137104,1218,136995,366,7324,1347,60113,1944,114007,1709,174120,California
Solano,2021-04-13,2570,283993,1120,138224,1449,138444,1,7325,1329,60207,1236,115243,1330,175450,California
Solano,2021-04-14,6572,290565,1967,140191,4605,143049,0,7325,1845,57335,4718,119961,1846,177296,California
Solano,2021-04-15,5792,296357,2180,142371,3611,146660,1,7326,1748,55055,4029,123990,1749,179045,California
Solano,2021-04-16,3726,300083,2627,144998,1097,147757,2,7328,2305,55950,1412,125402,2307,181352,California
Solano,2021-04-17,3318,303401,1077,146075,2241,149998,0,7328,1128,54901,2179,127581,1130,182482,California
Solano,2021-04-18,1052,304453,661,146736,391,150389,0,7328,545,54939,507,128088,545,183027,California
Solano,2021-04-19,2154,306607,1162,147898,992,151381,0,7328,1161,55116,986,129074,1163,184190,California
Solano,2021-04-20,3072,309679,1872,149770,1200,152581,0,7328,1685,55420,1381,130455,1685,185875,California
Solano,2021-04-21,3895,313574,2407,152177,1488,154069,0,7328,2034,55602,1852,132307,2034,187909,California
Solano,2021-04-22,3086,316660,1537,153714,1549,155618,0,7328,1829,56177,1254,133561,1829,189738,California
Solano,2021-04-23,4247,320907,2151,155865,2096,157714,0,7328,2556,57052,1683,135244,2558,192296,California
Solano,2021-04-24,3941,324848,2375,158240,1564,159278,2,7330,2618,58439,1233,136477,2620,194916,California
Solano,2021-04-25,1446,326294,1121,159361,325,159603,0,7330,1144,59288,295,136772,1144,196060,California
Solano,2021-04-26,2632,328926,1703,161064,925,160528,4,7334,1447,59569,1170,137942,1451,197511,California
Solano,2021-04-27,2624,331550,1312,162376,1282,161810,30,7364,1487,59961,1126,139068,1518,199029,California
Solano,2021-04-28,6148,337698,5083,167459,1018,162828,47,7411,3844,61561,2290,141358,3890,202919,California
Solano,2021-04-29,4661,342359,1497,168956,3130,165958,34,7445,2100,61142,2553,143911,2134,205053,California
Solano,2021-04-30,4204,346563,2237,171193,1823,167781,144,7589,1958,61013,2229,146140,2100,207153,California
Solano,2021-05-01,2201,348764,1690,172883,308,168089,203,7792,1302,61626,892,147032,1505,208658,California
Solano,2021-05-02,1221,349985,964,173847,230,168319,27,7819,673,61783,543,147575,700,209358,California
Solano,2021-05-03,1483,351468,1026,174873,371,168690,86,7905,610,61610,870,148445,697,210055,California
Solano,2021-05-04,1835,353303,1067,175940,702,169392,66,7971,823,61488,1011,149456,889,210944,California
Solano,2021-05-05,2328,355631,1468,177408,745,170137,115,8086,1120,61517,1204,150660,1233,212177,California
Solano,2021-05-06,2042,357673,1215,178623,614,170751,213,8299,741,61176,1288,151948,947,213124,California
Solano,2021-05-07,2878,360551,2009,180632,751,171502,118,8417,994,60410,1875,153823,1109,214233,California
Solano,2021-05-08,1492,362043,944,181576,431,171933,117,8534,574,60188,913,154736,691,214924,California
Solano,2021-05-09,453,362496,275,181851,166,172099,12,8546,175,60100,276,155012,188,215112,California
Solano,2021-05-10,1393,363889,646,182497,640,172739,107,8653,387,59592,1002,156014,494,215606,California
Solano,2021-05-11,2336,366225,1197,183694,1049,173788,90,8743,682,58715,1649,157663,772,216378,California
Solano,2021-05-12,2198,368423,1258,184952,767,174555,173,8916,731,58166,1452,159115,903,217281,California
Solano,2021-05-13,3114,371537,2134,187086,769,175324,211,9127,1629,58527,1480,160595,1841,219122,California
Solano,2021-05-14,2535,374072,1727,188813,686,176010,122,9249,1072,58269,1452,162047,1194,220316,California
Solano,2021-05-15,3447,377519,2793,191606,566,176576,88,9337,1307,57534,2129,164176,1394,221710,California
Solano,2021-05-16,1556,379075,1153,192759,371,176947,32,9369,281,56574,1272,165448,312,222022,California
Solano,2021-05-17,2471,381546,1408,194167,977,177924,86,9455,867,55940,1583,167031,949,222971,California
Solano,2021-05-18,2960,384506,1636,195803,1235,179159,89,9544,1471,56024,1476,168507,1560,224531,California
Solano,2021-05-19,5832,390338,4213,200016,1484,180643,135,9679,2199,54739,3620,172127,2335,226866,California
Solano,2021-05-20,2648,392986,1584,201600,1001,181644,63,9742,939,54044,1697,173824,1002,227868,California
Solano,2021-05-21,3579,396565,1869,203469,1640,183284,70,9812,1358,53262,2211,176035,1429,229297,California
Solano,2021-05-22,2743,399308,2114,205583,535,183819,94,9906,1156,52931,1580,177615,1249,230546,California
Solano,2021-05-23,1426,400734,1176,206759,226,184045,24,9930,754,53040,669,178284,778,231324,California
Solano,2021-05-24,1886,402620,1087,207846,727,184772,72,10002,635,52502,1243,179527,705,232029,California
Solano,2021-05-25,1629,404249,817,208663,751,185523,61,10063,583,52107,1038,180565,643,232672,California
Solano,2021-05-26,1900,406149,1092,209755,752,186275,56,10119,704,51677,1191,181756,761,233433,California
Solano,2021-05-27,2155,408304,958,210713,1120,187395,77,10196,887,51382,1258,183014,963,234396,California
Solano,2021-05-28,2032,410336,1037,211750,939,188334,56,10252,760,50935,1264,184278,817,235213,California
Solano,2021-05-29,661,410997,333,212083,296,188630,32,10284,309,50926,349,184627,340,235553,California
Solano,2021-05-30,322,411319,151,212234,146,188776,25,10309,114,50861,205,184832,140,235693,California
Solano,2021-05-31,126,411445,18,212252,100,188876,8,10317,24,50791,102,184934,32,235725,California
Solano,2021-06-01,1840,413285,1184,213436,579,189455,77,10394,727,50489,1107,186041,805,236530,California
Solano,2021-06-02,1829,415114,1287,214723,476,189931,66,10460,923,50576,899,186940,986,237516,California
Solano,2021-06-03,2220,417334,1751,216474,385,190316,84,10544,708,49865,1504,188444,793,238309,California
Solano,2021-06-04,1663,418997,1156,217630,442,190758,65,10609,500,49271,1159,189603,565,238874,California
Solano,2021-06-05,1419,420416,1027,218657,341,191099,51,10660,471,48852,941,190544,522,239396,California
Solano,2021-06-06,674,421090,554,219211,88,191187,32,10692,360,48930,314,190858,392,239788,California
Solano,2021-06-07,1238,422328,945,220156,229,191416,64,10756,404,48568,830,191688,468,240256,California
Solano,2021-06-08,1842,424170,1334,221490,473,191889,35,10791,489,47744,1348,193036,524,240780,California
Solano,2021-06-09,2119,426289,1808,223298,250,192139,61,10852,665,47022,1447,194483,725,241505,California
Solano,2021-06-10,1297,427586,841,224139,381,192520,75,10927,416,46641,871,195354,490,241995,California
Solano,2021-06-11,1602,429188,1275,225414,261,192781,66,10993,584,46276,1013,196367,648,242643,California
Solano,2021-06-12,1203,430391,925,226339,218,192999,60,11053,203,45546,993,197360,263,242906,California
Solano,2021-06-13,614,431005,525,226864,80,193079,9,11062,110,45162,503,197863,119,243025,California
Solano,2021-06-14,1322,432327,931,227795,356,193435,35,11097,275,44431,1039,198902,308,243333,California
Solano,2021-06-15,1477,433804,933,228728,492,193927,52,11149,608,44228,862,199764,659,243992,California
Solano,2021-06-16,1164,434968,769,229497,325,194252,70,11219,394,43926,765,200529,463,244455,California
Solano,2021-06-17,1224,436192,936,230433,218,194470,70,11289,435,43654,776,201305,504,244959,California
Solano,2021-06-18,1227,437419,921,231354,240,194710,66,11355,456,43410,766,202071,522,245481,California
Solano,2021-06-19,425,437844,297,231651,100,194810,28,11383,157,43331,264,202335,185,245666,California
Solano,2021-06-20,181,438025,139,231790,35,194845,7,11390,84,43325,97,202432,91,245757,California
Solano,2021-06-21,634,438659,404,232194,166,195011,64,11454,394,43544,239,202671,458,246215,California
Solano,2021-06-22,1186,439845,890,233084,241,195252,55,11509,436,43289,746,203417,491,246706,California
Solano,2021-06-23,1434,441279,1187,234271,174,195426,73,11582,493,42919,935,204352,565,247271,California
Solano,2021-06-24,928,442207,692,234963,170,195596,66,11648,396,42852,526,204878,459,247730,California
Solano,2021-06-25,1057,443264,737,235700,247,195843,73,11721,492,42869,547,205425,564,248294,California
Solano,2021-06-26,605,443869,470,236170,95,195938,40,11761,258,42821,345,205770,297,248591,California
Solano,2021-06-27,467,444336,408,236578,57,195995,2,11763,164,42686,301,206071,166,248757,California
Solano,2021-06-28,990,445326,817,237395,133,196128,40,11803,408,42557,577,206648,448,249205,California
Solano,2021-06-29,857,446183,653,238048,149,196277,55,11858,373,42504,480,207128,427,249632,California
Solano,2021-06-30,820,447003,606,238654,171,196448,43,11901,375,42476,445,207573,417,250049,California
Solano,2021-07-01,665,447668,489,239143,112,196560,64,11965,253,42383,410,207983,317,250366,California
Solano,2021-07-02,755,448423,575,239718,145,196705,35,12000,299,42267,450,208433,334,250700,California
Solano,2021-07-03,312,448735,209,239927,88,196793,15,12015,155,42284,153,208586,170,250870,California
Solano,2021-07-04,32,448767,3,239930,16,196809,13,12028,12,42289,20,208606,25,250895,California
Solano,2021-07-05,350,449117,243,240173,92,196901,15,12043,174,42306,172,208778,189,251084,California
Solano,2021-07-06,1024,450141,812,240985,190,197091,22,12065,371,42050,650,209428,394,251478,California
Solano,2021-07-07,717,450858,510,241495,147,197238,60,12125,278,41956,432,209860,338,251816,California
Solano,2021-07-08,623,451481,440,241935,159,197397,24,12149,266,41897,351,210211,292,252108,California
Solano,2021-07-09,786,452267,528,242463,230,197627,28,12177,338,41820,443,210654,366,252474,California
Solano,2021-07-10,295,452562,197,242660,90,197717,8,12185,135,41807,156,210810,143,252617,California
Solano,2021-07-11,243,452805,178,242838,61,197778,4,12189,104,41793,122,210932,108,252725,California
Solano,2021-07-12,767,453572,600,243438,123,197901,44,12233,316,41706,447,211379,360,253085,California
Solano,2021-07-13,764,454336,536,243974,186,198087,42,12275,340,41669,419,211798,382,253467,California
Solano,2021-07-14,720,455056,560,244534,119,198206,41,12316,340,41677,370,212168,378,253845,California
Solano,2021-07-15,620,455676,436,244970,138,198344,46,12362,257,41620,360,212528,303,254148,California
Solano,2021-07-16,920,456596,740,245710,139,198483,41,12403,426,41594,492,213020,466,254614,California
Solano,2021-07-17,365,456961,277,245987,78,198561,10,12413,155,41550,209,213229,165,254779,California
Solano,2021-07-18,253,457214,206,246193,42,198603,5,12418,154,41612,97,213326,159,254938,California
Solano,2021-07-19,839,458053,695,246888,113,198716,31,12449,407,41621,428,213754,437,255375,California
Solano,2021-07-20,794,458847,631,247519,132,198848,31,12480,396,41654,395,214149,428,255803,California
Solano,2021-07-21,799,459646,573,248092,199,199047,27,12507,420,41727,374,214523,447,256250,California
Solano,2021-07-22,732,460378,568,248660,116,199163,48,12555,384,41813,346,214869,432,256682,California
Solano,2021-07-23,850,461228,611,249271,218,199381,21,12576,469,41923,380,215249,490,257172,California
Solano,2021-07-24,403,461631,318,249589,76,199457,9,12585,246,42025,152,215401,254,257426,California
Solano,2021-07-25,183,461814,134,249723,43,199500,6,12591,140,42128,43,215444,146,257572,California
Solano,2021-07-26,739,462553,480,250203,229,199729,30,12621,529,42480,207,215651,559,258131,California
Solano,2021-07-27,716,463269,442,250645,248,199977,26,12647,464,42724,245,215896,489,258620,California
Solano,2021-07-28,904,464173,723,251368,138,200115,43,12690,535,42942,360,216256,578,259198,California
Solano,2021-07-29,651,464824,392,251760,240,200355,19,12709,459,43229,191,216447,478,259676,California
Solano,2021-07-30,837,465661,638,252398,155,200510,44,12753,550,43546,276,216723,593,260269,California
Solano,2021-07-31,242,465903,142,252540,90,200600,10,12763,161,43641,75,216798,170,260439,California
Sonoma,2020-12-15,4,4,4,4,0,0,0,0,4,4,0,0,4,4,California
Sonoma,2020-12-16,28,32,28,32,0,0,0,0,28,32,0,0,28,32,California
Sonoma,2020-12-17,113,145,113,145,0,0,0,0,113,145,0,0,113,145,California
Sonoma,2020-12-18,440,585,440,585,0,0,0,0,440,585,0,0,440,585,California
Sonoma,2020-12-19,117,702,116,701,1,1,0,0,117,702,0,0,117,702,California
Sonoma,2020-12-20,178,880,178,879,0,1,0,0,178,880,0,0,178,880,California
Sonoma,2020-12-21,911,1791,909,1788,2,3,0,0,910,1790,0,0,910,1790,California
Sonoma,2020-12-22,1357,3148,1270,3058,87,90,0,0,1357,3147,0,0,1357,3147,California
Sonoma,2020-12-23,1604,4752,1231,4289,373,463,0,0,1605,4752,0,0,1605,4752,California
Sonoma,2020-12-24,313,5065,103,4392,210,673,0,0,313,5065,0,0,313,5065,California
Sonoma,2020-12-25,8,5073,1,4393,7,680,0,0,8,5073,0,0,8,5073,California
Sonoma,2020-12-26,265,5338,256,4649,9,689,0,0,265,5338,0,0,265,5338,California
Sonoma,2020-12-27,96,5434,81,4730,15,704,0,0,96,5434,0,0,96,5434,California
Sonoma,2020-12-28,975,6409,540,5270,435,1139,0,0,948,6381,1,1,948,6382,California
Sonoma,2020-12-29,1141,7550,784,6054,357,1496,0,0,1107,7488,0,1,1107,7489,California
Sonoma,2020-12-30,1096,8646,483,6537,613,2109,0,0,1088,8576,0,1,1088,8577,California
Sonoma,2020-12-31,520,9166,68,6605,452,2561,0,0,520,9096,0,1,520,9097,California
Sonoma,2021-01-01,433,9599,216,6821,217,2778,0,0,433,9529,0,1,433,9530,California
Sonoma,2021-01-02,135,9734,128,6949,7,2785,0,0,135,9664,0,1,135,9665,California
Sonoma,2021-01-03,27,9761,11,6960,16,2801,0,0,27,9691,0,1,27,9692,California
Sonoma,2021-01-04,341,10102,105,7065,236,3037,0,0,340,10031,0,1,340,10032,California
Sonoma,2021-01-05,431,10533,98,7163,333,3370,0,0,405,10420,16,17,405,10437,California
Sonoma,2021-01-06,951,11484,433,7596,518,3888,0,0,837,11149,108,125,837,11274,California
Sonoma,2021-01-07,1048,12532,548,8144,500,4388,0,0,865,11832,182,307,865,12139,California
Sonoma,2021-01-08,1827,14359,1256,9400,571,4959,0,0,1338,12683,487,794,1338,13477,California
Sonoma,2021-01-09,643,15002,400,9800,243,5202,0,0,597,13234,46,840,597,14074,California
Sonoma,2021-01-10,472,15474,460,10260,12,5214,0,0,276,13314,196,1036,276,14350,California
Sonoma,2021-01-11,1392,16866,1246,11506,146,5360,0,0,419,12765,968,2004,419,14769,California
Sonoma,2021-01-12,1552,18418,1296,12802,256,5616,0,0,399,12013,1151,3155,399,15168,California
Sonoma,2021-01-13,2048,20466,1362,14164,686,6302,0,0,1179,12327,866,4021,1180,16348,California
Sonoma,2021-01-14,1544,22010,809,14973,735,7037,0,0,1313,13409,231,4252,1313,17661,California
Sonoma,2021-01-15,1563,23573,627,15600,936,7973,0,0,1339,14536,214,4466,1341,19002,California
Sonoma,2021-01-16,1150,24723,613,16213,537,8510,0,0,903,15196,243,4709,903,19905,California
Sonoma,2021-01-17,681,25404,559,16772,122,8632,0,0,601,15717,80,4789,601,20506,California
Sonoma,2021-01-18,1102,26506,931,17703,171,8803,0,0,618,15852,484,5273,619,21125,California
Sonoma,2021-01-19,2100,28606,1003,18706,1097,9900,0,0,1388,16531,710,5983,1389,22514,California
Sonoma,2021-01-20,2191,30797,712,19418,1479,11379,0,0,1511,17374,669,6652,1512,24026,California
Sonoma,2021-01-21,2337,33134,676,20094,1661,13040,0,0,2103,19246,232,6884,2104,26130,California
Sonoma,2021-01-22,2781,35915,1058,21152,1723,14763,0,0,2626,21718,154,7038,2626,28756,California
Sonoma,2021-01-23,773,36688,593,21745,180,14943,0,0,662,22270,110,7148,662,29418,California
Sonoma,2021-01-24,854,37542,716,22461,138,15081,0,0,835,23086,19,7167,835,30253,California
Sonoma,2021-01-25,2202,39744,538,22999,1664,16745,0,0,1709,24303,492,7659,1709,31962,California
Sonoma,2021-01-26,2074,41818,310,23309,1764,18509,0,0,1604,25438,469,8128,1604,33566,California
Sonoma,2021-01-27,3756,45574,1279,24588,2477,20986,0,0,3166,28019,587,8715,3168,36734,California
Sonoma,2021-01-28,4151,49725,1850,26438,2301,23287,0,0,3450,30774,697,9412,3452,40186,California
Sonoma,2021-01-29,3032,52757,1432,27870,1600,24887,0,0,2168,32082,862,10274,2170,42356,California
Sonoma,2021-01-30,2591,55348,2395,30265,196,25083,0,0,2234,33962,355,10629,2235,44591,California
Sonoma,2021-01-31,792,56140,675,30940,117,25200,0,0,560,34291,231,10860,560,45151,California
Sonoma,2021-02-01,2510,58650,861,31801,1649,26849,0,0,2116,36018,389,11249,2116,47267,California
Sonoma,2021-02-02,3630,62280,1405,33206,2225,29074,0,0,3039,38471,586,11835,3039,50306,California
Sonoma,2021-02-03,4072,66352,1326,34532,2746,31820,0,0,3126,40655,942,12777,3126,53432,California
Sonoma,2021-02-04,4260,70612,1751,36283,2509,34329,0,0,3441,43281,817,13594,3443,56875,California
Sonoma,2021-02-05,4853,75465,1748,38031,3105,37434,0,0,3787,46008,1061,14655,3788,60663,California
Sonoma,2021-02-06,2694,78159,2321,40352,373,37807,0,0,2141,47599,551,15206,2142,62805,California
Sonoma,2021-02-07,1574,79733,1436,41788,138,37945,0,0,1304,48633,270,15476,1304,64109,California
Sonoma,2021-02-08,3290,83023,1033,42821,2257,40202,0,0,2685,50715,603,16079,2685,66794,California
Sonoma,2021-02-09,3628,86651,1731,44552,1897,42099,0,0,3132,53354,494,16573,3133,69927,California
Sonoma,2021-02-10,4609,91260,2516,47068,2093,44192,0,0,3574,55903,1026,17599,3575,73502,California
Sonoma,2021-02-11,5655,96915,3049,50117,2606,46798,0,0,4366,58986,1283,18882,4366,77868,California
Sonoma,2021-02-12,6015,102930,3320,53437,2695,49493,0,0,4532,62047,1475,20357,4536,82404,California
Sonoma,2021-02-13,2008,104938,1164,54601,844,50337,0,0,1190,62422,815,21172,1190,83594,California
Sonoma,2021-02-14,2360,107298,1859,56460,501,50838,0,0,1596,63259,759,21931,1596,85190,California
Sonoma,2021-02-15,2174,109472,819,57279,1355,52193,0,0,1613,64314,558,22489,1613,86803,California
Sonoma,2021-02-16,5040,114512,2163,59442,2877,55070,0,0,3744,66772,1288,23777,3746,90549,California
Sonoma,2021-02-17,5684,120196,2952,62394,2732,57802,0,0,3565,68237,2103,25880,3568,94117,California
Sonoma,2021-02-18,7124,127320,3233,65627,3891,61693,0,0,4069,69278,3029,28909,4070,98187,California
Sonoma,2021-02-19,5739,133059,1740,67367,3999,65692,0,0,3557,70669,2168,31077,3559,101746,California
Sonoma,2021-02-20,3145,136204,2848,70215,297,65989,0,0,1218,69970,1917,32994,1218,102964,California
Sonoma,2021-02-21,558,136762,440,70655,118,66107,0,0,138,69697,411,33405,138,103102,California
Sonoma,2021-02-22,3075,139837,1456,72111,1619,67726,0,0,1259,69155,1801,35206,1259,104361,California
Sonoma,2021-02-23,3520,143357,2153,74264,1367,69093,0,0,1645,68937,1863,37069,1645,106006,California
Sonoma,2021-02-24,5942,149299,2653,76917,3289,72382,0,0,3023,69064,2897,39966,3024,109030,California
Sonoma,2021-02-25,6247,155546,2426,79343,3821,76203,0,0,3331,69514,2881,42847,3331,112361,California
Sonoma,2021-02-26,6861,162407,3032,82375,3829,80032,0,0,4335,71339,2510,45357,4335,116696,California
Sonoma,2021-02-27,4409,166816,2056,84431,2353,82385,0,0,2928,72797,1470,46827,2928,119624,California
Sonoma,2021-02-28,2629,169445,1953,86384,675,83060,1,1,755,71699,1854,48681,756,120380,California
Sonoma,2021-03-01,4283,173728,1346,87730,2936,85996,1,2,2194,71832,2064,50745,2197,122577,California
Sonoma,2021-03-02,4562,178290,1574,89304,2985,88981,3,5,2597,72480,1952,52697,2600,125177,California
Sonoma,2021-03-03,5162,183452,2675,91979,2487,91468,0,5,2338,72016,2803,55500,2339,127516,California
Sonoma,2021-03-04,6094,189546,2742,94721,3352,94820,0,5,2615,71177,3454,58954,2615,130131,California
Sonoma,2021-03-05,6567,196113,2920,97641,3632,98452,15,20,2729,70106,3816,62770,2745,132876,California
Sonoma,2021-03-06,2824,198937,1240,98881,1444,99896,140,160,1925,71281,887,63657,2062,134938,California
Sonoma,2021-03-07,1833,200770,1423,100304,315,100211,95,255,399,70342,1430,65087,491,135429,California
Sonoma,2021-03-08,4104,204874,658,100962,3264,103475,182,437,2391,71218,1696,66783,2572,138001,California
Sonoma,2021-03-09,5674,210548,3123,104085,2281,105756,270,707,2701,71222,2954,69737,2958,140959,California
Sonoma,2021-03-10,6068,216616,3215,107300,2505,108261,348,1055,2418,70360,3620,73357,2758,143717,California
Sonoma,2021-03-11,7588,224204,3052,110352,3713,111974,823,1878,2527,68672,5027,78384,3339,147056,California
Sonoma,2021-03-12,7462,231666,2264,112616,3823,115797,1375,3253,2054,66718,5370,83754,3416,150472,California
Sonoma,2021-03-13,3494,235160,1734,114350,1517,117314,243,3496,2040,67548,1447,85201,2277,152749,California
Sonoma,2021-03-14,1380,236540,378,114728,859,118173,143,3639,843,67999,533,85734,984,153733,California
Sonoma,2021-03-15,5277,241817,1533,116261,3356,121529,388,4027,2172,67477,3080,88814,2558,156291,California
Sonoma,2021-03-16,6334,248151,2270,118531,3834,125363,230,4257,2885,67158,3430,92244,3111,159402,California
Sonoma,2021-03-17,6875,255026,3604,122135,3085,128448,186,4443,3270,67032,3580,95824,3454,162856,California
Sonoma,2021-03-18,7193,262219,2963,125098,3613,132061,617,5060,3093,66656,4079,99903,3703,166559,California
Sonoma,2021-03-19,7555,269774,3273,128371,4052,136113,230,5290,2957,65287,4560,104463,3191,169750,California
Sonoma,2021-03-20,3756,273530,1770,130141,1152,137265,834,6124,2023,66412,1722,106185,2847,172597,California
Sonoma,2021-03-21,1397,274927,603,130744,758,138023,36,6160,1204,67467,185,106370,1240,173837,California
Sonoma,2021-03-22,4613,279540,3128,133872,1385,139408,100,6260,3352,69667,1252,107622,3452,177289,California
Sonoma,2021-03-23,5918,285458,3664,137536,2180,141588,74,6334,4445,72728,1458,109080,4519,181808,California
Sonoma,2021-03-24,6930,292388,4340,141876,2511,144099,79,6413,4186,74273,2716,111796,4261,186069,California
Sonoma,2021-03-25,7231,299619,4247,146123,2867,146966,117,6530,4254,75700,2945,114741,4372,190441,California
Sonoma,2021-03-26,7558,307177,3503,149626,3956,150922,99,6629,3793,75863,3729,118470,3892,194333,California
Sonoma,2021-03-27,3955,311132,1523,151149,2063,152985,369,6998,1003,74296,2935,121405,1368,195701,California
Sonoma,2021-03-28,1523,312655,951,152100,544,153529,28,7026,797,74399,721,122126,824,196525,California
Sonoma,2021-03-29,3011,315666,1114,153214,1864,155393,33,7059,1538,74509,1461,123587,1571,198096,California
Sonoma,2021-03-30,6004,321670,3275,156489,2665,158058,64,7123,3116,74813,2875,126462,3179,201275,California
Sonoma,2021-03-31,5812,327482,3443,159932,2153,160211,216,7339,3366,75969,2424,128886,3580,204855,California
Sonoma,2021-04-01,7005,334487,4085,164017,2568,162779,352,7691,3770,76878,3202,132088,4111,208966,California
Sonoma,2021-04-02,6017,340504,3599,167616,2308,165087,110,7801,3596,78178,2402,134490,3702,212668,California
Sonoma,2021-04-03,3812,344316,1887,169503,1700,166787,225,8026,1686,77972,2109,136599,1903,214571,California
Sonoma,2021-04-04,1078,345394,699,170202,288,167075,91,8117,652,78293,422,137021,743,215314,California
Sonoma,2021-04-05,4468,349862,663,170865,3458,170533,347,8464,1668,77513,2794,139815,2014,217328,California
Sonoma,2021-04-06,6991,356853,3535,174400,3040,173573,416,8880,4060,79074,2910,142725,4471,221799,California
Sonoma,2021-04-07,6925,363778,3916,178316,2160,175733,849,9729,3364,79737,3542,146267,4205,226004,California
Sonoma,2021-04-08,7712,371490,4176,182492,2762,178495,774,10503,4226,81261,3467,149734,4991,230995,California
Sonoma,2021-04-09,6884,378374,3836,186328,2150,180645,898,11401,3526,82338,3339,153073,4416,235411,California
Sonoma,2021-04-10,3934,382308,1706,188034,1667,182312,561,11962,1155,81282,2765,155838,1709,237120,California
Sonoma,2021-04-11,1290,383598,613,188647,597,182909,80,12042,443,80960,844,156682,522,237642,California
Sonoma,2021-04-12,5001,388599,2082,190729,2428,185337,491,12533,1853,80167,3129,159811,2336,239978,California
Sonoma,2021-04-13,7978,396577,4688,195417,3286,188623,4,12537,3042,78296,4916,164727,3045,243023,California
Sonoma,2021-04-14,6747,403324,3822,199239,2904,191527,21,12558,2557,76696,4176,168903,2576,245599,California
Sonoma,2021-04-15,7562,410886,4288,203527,3273,194800,1,12559,3630,76413,3914,172817,3631,249230,California
Sonoma,2021-04-16,6975,417861,3489,207016,3484,198284,2,12561,3896,77244,3068,175885,3899,253129,California
Sonoma,2021-04-17,3562,421423,1837,208853,1725,200009,0,12561,1683,77076,1852,177737,1684,254813,California
Sonoma,2021-04-18,1409,422832,1014,209867,395,200404,0,12561,534,76740,870,178607,534,255347,California
Sonoma,2021-04-19,3465,426297,1902,211769,1562,201966,1,12562,1528,76339,1930,180537,1529,256876,California
Sonoma,2021-04-20,6464,432761,3562,215331,2902,204868,0,12562,2388,74669,4060,184597,2390,259266,California
Sonoma,2021-04-21,6929,439690,4389,219720,2538,207406,2,12564,3135,74041,3765,188362,3137,262403,California
Sonoma,2021-04-22,6600,446290,4617,224337,1982,209388,1,12565,2644,72750,3935,192297,2644,265047,California
Sonoma,2021-04-23,7713,454003,4760,229097,2946,212334,7,12572,3736,72540,3955,196252,3745,268792,California
Sonoma,2021-04-24,2838,456841,1532,230629,1291,213625,15,12587,1558,72842,1271,197523,1573,270365,California
Sonoma,2021-04-25,1103,457944,803,231432,300,213925,0,12587,437,72617,662,198185,437,270802,California
Sonoma,2021-04-26,3022,460966,1434,232866,1560,215485,28,12615,1634,72903,1377,199562,1663,272465,California
Sonoma,2021-04-27,5617,466583,3789,236655,1705,217190,123,12738,2246,71916,3356,202918,2369,274834,California
Sonoma,2021-04-28,5023,471606,3300,239955,1519,218709,204,12942,2030,71173,2971,205889,2228,277062,California
Sonoma,2021-04-29,5193,476799,3655,243610,1392,220101,146,13088,1943,70033,3229,209118,2089,279151,California
Sonoma,2021-04-30,5646,482445,3692,247302,1659,221760,295,13383,1849,68402,3774,212892,2143,281294,California
Sonoma,2021-05-01,2583,485028,1828,249130,647,222407,108,13491,1218,68373,1351,214243,1322,282616,California
Sonoma,2021-05-02,881,485909,656,249786,173,222580,52,13543,561,68667,320,214563,614,283230,California
Sonoma,2021-05-03,3316,489225,1715,251501,1448,224028,153,13696,1083,67688,2214,216777,1235,284465,California
Sonoma,2021-05-04,4678,493903,2436,253937,2056,226084,186,13882,1463,66144,3186,219963,1642,286107,California
Sonoma,2021-05-05,3791,497694,2225,256162,1371,227455,195,14077,1340,65246,2431,222394,1533,287640,California
Sonoma,2021-05-06,4668,502362,2460,258622,2078,229533,130,14207,1314,63402,3285,225679,1441,289081,California
Sonoma,2021-05-07,3677,506039,2349,260971,1204,230737,124,14331,1089,62044,2571,228250,1213,290294,California
Sonoma,2021-05-08,1953,507992,1303,262274,558,231295,92,14423,685,61569,1252,229502,777,291071,California
Sonoma,2021-05-09,506,508498,286,262560,177,231472,43,14466,160,61431,341,229843,203,291274,California
Sonoma,2021-05-10,2378,510876,1050,263610,1195,232667,133,14599,296,59792,2065,231908,426,291700,California
Sonoma,2021-05-11,3654,514530,1974,265584,1554,234221,126,14725,883,58052,2749,234657,1009,292709,California
Sonoma,2021-05-12,4115,518645,2530,268114,1432,235653,153,14878,851,55806,3249,237906,1003,293712,California
Sonoma,2021-05-13,5034,523679,2866,270980,2035,237688,133,15011,1666,54250,3353,241259,1797,295509,California
Sonoma,2021-05-14,5906,529585,3648,274628,2121,239809,137,15148,2227,52955,3660,244919,2365,297874,California
Sonoma,2021-05-15,3012,532597,2218,276846,732,240541,62,15210,1894,53805,1107,246026,1957,299831,California
Sonoma,2021-05-16,1358,533955,1139,277985,160,240701,59,15269,999,54511,352,246378,1058,300889,California
Sonoma,2021-05-17,2466,536421,1834,279819,536,241237,96,15365,900,53946,1559,247937,994,301883,California
Sonoma,2021-05-18,4357,540778,2869,282688,1378,242615,110,15475,1455,52631,2879,250816,1564,303447,California
Sonoma,2021-05-19,3903,544681,2431,285119,1357,243972,115,15590,1480,51819,2407,253223,1595,305042,California
Sonoma,2021-05-20,3458,548139,2261,287380,1102,245074,95,15685,1326,51116,2118,255341,1415,306457,California
Sonoma,2021-05-21,4288,552427,2404,289784,1753,246827,131,15816,1491,49954,2771,258112,1609,308066,California
Sonoma,2021-05-22,2363,554790,1295,291079,1028,247855,40,15856,661,48971,1684,259796,701,308767,California
Sonoma,2021-05-23,1513,556303,1232,292311,264,248119,17,15873,770,49020,738,260534,787,309554,California
Sonoma,2021-05-24,2031,558334,1263,293574,634,248753,134,16007,657,48471,1340,261874,791,310345,California
Sonoma,2021-05-25,2959,561293,1808,295382,1064,249817,87,16094,733,47079,2209,264083,817,311162,California
Sonoma,2021-05-26,2498,563791,1743,297125,644,250461,111,16205,1000,46707,1481,265564,1109,312271,California
Sonoma,2021-05-27,2088,565879,1138,298263,854,251315,96,16301,679,46082,1397,266961,772,313043,California
Sonoma,2021-05-28,2209,568088,1138,299401,978,252293,93,16394,620,45218,1577,268538,713,313756,California
Sonoma,2021-05-29,1354,569442,925,300326,361,252654,68,16462,634,45210,710,269248,702,314458,California
Sonoma,2021-05-30,351,569793,216,300542,124,252778,11,16473,137,45151,206,269454,147,314605,California
Sonoma,2021-05-31,71,569864,27,300569,43,252821,1,16474,18,45117,53,269507,19,314624,California
Sonoma,2021-06-01,1963,571827,1121,301690,765,253586,77,16551,698,44638,1250,270757,771,315395,California
Sonoma,2021-06-02,1587,573414,973,302663,499,254085,115,16666,661,44491,921,271678,774,316169,California
Sonoma,2021-06-03,2029,575443,1401,304064,547,254632,81,16747,433,43418,1586,273264,513,316682,California
Sonoma,2021-06-04,2718,578161,2211,306275,399,255031,108,16855,512,41841,2195,275459,618,317300,California
Sonoma,2021-06-05,1834,579995,1509,307784,294,255325,31,16886,279,40602,1549,277008,310,317610,California
Sonoma,2021-06-06,1035,581030,955,308739,70,255395,10,16896,144,39870,887,277895,155,317765,California
Sonoma,2021-06-07,1504,582534,1257,309996,192,255587,55,16951,333,39092,1163,279058,385,318150,California
Sonoma,2021-06-08,1908,584442,1531,311527,328,255915,49,17000,527,38297,1369,280427,574,318724,California
Sonoma,2021-06-09,1662,586104,1375,312902,225,256140,62,17062,394,37499,1255,281682,457,319181,California
Sonoma,2021-06-10,1852,587956,1510,314412,237,256377,105,17167,553,36872,1283,282965,656,319837,California
Sonoma,2021-06-11,2008,589964,1639,316051,278,256655,91,17258,549,36060,1452,284417,640,320477,California
Sonoma,2021-06-12,1126,591090,889,316940,191,256846,46,17304,344,35675,775,285192,390,320867,California
Sonoma,2021-06-13,559,591649,468,317408,72,256918,19,17323,105,35347,451,285643,123,320990,California
Sonoma,2021-06-14,950,592599,681,318089,207,257125,62,17385,344,35155,598,286241,406,321396,California
Sonoma,2021-06-15,1849,594448,1385,319474,356,257481,108,17493,599,34622,1239,287480,706,322102,California
Sonoma,2021-06-16,1583,596031,1216,320690,265,257746,102,17595,498,34144,1076,288556,598,322700,California
Sonoma,2021-06-17,1038,597069,786,321476,172,257918,80,17675,410,34010,623,289179,489,323189,California
Sonoma,2021-06-18,1078,598147,773,322249,203,258121,102,17777,450,33942,617,289796,549,323738,California
Sonoma,2021-06-19,838,598985,692,322941,107,258228,39,17816,275,33695,560,290356,313,324051,California
Sonoma,2021-06-20,240,599225,198,323139,36,258264,6,17822,81,33626,156,290512,87,324138,California
Sonoma,2021-06-21,549,599774,312,323451,159,258423,78,17900,259,33687,275,290787,336,324474,California
Sonoma,2021-06-22,1254,601028,991,324442,171,258594,92,17992,584,33695,665,291452,673,325147,California
Sonoma,2021-06-23,1224,602252,941,325383,198,258792,85,18077,473,33510,744,292196,559,325706,California
Sonoma,2021-06-24,954,603206,633,326016,219,259011,102,18179,418,33503,525,292721,518,326224,California
Sonoma,2021-06-25,1199,604405,917,326933,202,259213,80,18259,523,33448,656,293377,601,326825,California
Sonoma,2021-06-26,690,605095,494,327427,116,259329,80,18339,331,33502,356,293733,410,327235,California
Sonoma,2021-06-27,193,605288,159,327586,23,259352,11,18350,100,33522,91,293824,111,327346,California
Sonoma,2021-06-28,713,606001,575,328161,82,259434,56,18406,312,33490,399,294223,367,327713,California
Sonoma,2021-06-29,948,606949,730,328891,168,259602,50,18456,399,33393,546,294769,449,328162,California
Sonoma,2021-06-30,894,607843,692,329583,161,259763,41,18497,386,33318,501,295270,426,328588,California
Sonoma,2021-07-01,972,608815,760,330343,140,259903,72,18569,424,33268,544,295814,494,329082,California
Sonoma,2021-07-02,769,609584,549,330892,171,260074,49,18618,362,33278,401,296215,411,329493,California
Sonoma,2021-07-03,565,610149,465,331357,75,260149,25,18643,229,33198,334,296549,254,329747,California
Sonoma,2021-07-04,23,610172,13,331370,9,260158,1,18644,15,33206,8,296557,16,329763,California
Sonoma,2021-07-05,330,610502,247,331617,59,260217,24,18668,152,33204,177,296734,175,329938,California
Sonoma,2021-07-06,1125,611627,900,332517,154,260371,71,18739,416,32989,700,297434,485,330423,California
Sonoma,2021-07-07,785,612412,597,333114,131,260502,57,18796,312,32890,469,297903,370,330793,California
Sonoma,2021-07-08,874,613286,662,333776,125,260627,87,18883,345,32796,524,298427,430,331223,California
Sonoma,2021-07-09,854,614140,637,334413,157,260784,60,18943,400,32803,452,298879,459,331682,California
Sonoma,2021-07-10,601,614741,478,334891,82,260866,41,18984,264,32775,331,299210,303,331985,California
Sonoma,2021-07-11,222,614963,154,335045,65,260931,3,18987,93,32742,129,299339,96,332081,California
Sonoma,2021-07-12,571,615534,417,335462,108,261039,46,19033,235,32692,329,299668,279,332360,California
Sonoma,2021-07-13,1026,616560,829,336291,139,261178,58,19091,400,32528,621,300289,457,332817,California
Sonoma,2021-07-14,706,617266,556,336847,114,261292,36,19127,322,32505,381,300670,358,333175,California
Sonoma,2021-07-15,938,618204,762,337609,115,261407,61,19188,433,32495,503,301173,493,333668,California
Sonoma,2021-07-16,879,619083,688,338297,147,261554,44,19232,409,32480,468,301641,453,334121,California
Sonoma,2021-07-17,791,619874,646,338943,106,261660,39,19271,345,32423,440,302081,383,334504,California
Sonoma,2021-07-18,192,620066,153,339096,24,261684,15,19286,96,32440,92,302173,109,334613,California
Sonoma,2021-07-19,688,620754,518,339614,112,261796,58,19344,328,32470,353,302526,383,334996,California
Sonoma,2021-07-20,1040,621794,851,340465,130,261926,59,19403,545,32586,486,303012,602,335598,California
Sonoma,2021-07-21,786,622580,645,341110,109,262035,32,19435,399,32632,384,303396,430,336028,California
Sonoma,2021-07-22,1001,623581,791,341901,156,262191,54,19489,487,32665,507,303903,540,336568,California
Sonoma,2021-07-23,893,624474,648,342549,179,262370,66,19555,456,32757,430,304333,522,337090,California
Sonoma,2021-07-24,678,625152,550,343099,90,262460,38,19593,407,32934,267,304600,444,337534,California
Sonoma,2021-07-25,196,625348,160,343259,30,262490,6,19599,137,33021,56,304656,143,337677,California
Sonoma,2021-07-26,526,625874,392,343651,95,262585,39,19638,336,33210,185,304841,374,338051,California
Sonoma,2021-07-27,1114,626988,927,344578,138,262723,49,19687,650,33452,456,305297,698,338749,California
Sonoma,2021-07-28,754,627742,598,345176,100,262823,56,19743,412,33583,337,305634,468,339217,California
Sonoma,2021-07-29,890,628632,701,345877,135,262958,54,19797,536,33823,349,305983,589,339806,California
Sonoma,2021-07-30,895,629527,718,346595,153,263111,24,19821,506,33976,377,306360,530,340336,California
Sonoma,2021-07-31,766,630293,653,347248,77,263188,36,19857,534,34317,229,306589,570,340906,California
Stanislaus,2020-12-15,6,6,6,6,0,0,0,0,6,6,0,0,6,6,California
Stanislaus,2020-12-16,39,45,39,45,0,0,0,0,39,45,0,0,39,45,California
Stanislaus,2020-12-17,76,121,76,121,0,0,0,0,76,121,0,0,76,121,California
Stanislaus,2020-12-18,345,466,339,460,6,6,0,0,345,466,0,0,345,466,California
Stanislaus,2020-12-19,132,598,132,592,0,6,0,0,132,598,0,0,132,598,California
Stanislaus,2020-12-20,88,686,87,679,1,7,0,0,88,686,0,0,88,686,California
Stanislaus,2020-12-21,1003,1689,1002,1681,1,8,0,0,1002,1688,1,1,1003,1689,California
Stanislaus,2020-12-22,795,2484,783,2464,12,20,0,0,795,2483,0,1,795,2484,California
Stanislaus,2020-12-23,450,2934,431,2895,19,39,0,0,449,2932,1,2,450,2934,California
Stanislaus,2020-12-24,96,3030,88,2983,8,47,0,0,96,3028,0,2,96,3030,California
Stanislaus,2020-12-26,54,3084,10,2993,44,91,0,0,54,3082,0,2,54,3084,California
Stanislaus,2020-12-27,11,3095,6,2999,5,96,0,0,11,3093,0,2,11,3095,California
Stanislaus,2020-12-28,488,3583,395,3394,93,189,0,0,487,3579,1,3,487,3582,California
Stanislaus,2020-12-29,494,4077,412,3806,82,271,0,0,494,4073,0,3,494,4076,California
Stanislaus,2020-12-30,537,4614,284,4090,253,524,0,0,536,4608,1,4,536,4612,California
Stanislaus,2020-12-31,280,4894,160,4250,120,644,0,0,280,4888,0,4,280,4892,California
Stanislaus,2021-01-01,22,4916,9,4259,13,657,0,0,21,4908,1,5,21,4913,California
Stanislaus,2021-01-02,33,4949,25,4284,8,665,0,0,33,4941,0,5,33,4946,California
Stanislaus,2021-01-03,90,5039,87,4371,3,668,0,0,90,5031,0,5,90,5036,California
Stanislaus,2021-01-04,235,5274,156,4527,79,747,0,0,235,5266,0,5,235,5271,California
Stanislaus,2021-01-05,858,6132,361,4888,497,1244,0,0,828,6076,29,34,839,6110,California
Stanislaus,2021-01-06,1011,7143,606,5494,405,1649,0,0,931,6939,77,111,940,7050,California
Stanislaus,2021-01-07,1087,8230,709,6203,378,2027,0,0,891,7643,191,302,895,7945,California
Stanislaus,2021-01-08,1303,9533,744,6947,559,2586,0,0,948,8250,352,654,959,8904,California
Stanislaus,2021-01-09,294,9827,145,7092,149,2735,0,0,206,8368,88,742,206,9110,California
Stanislaus,2021-01-10,47,9874,20,7112,27,2762,0,0,28,8377,19,761,28,9138,California
Stanislaus,2021-01-11,1515,11389,1228,8340,287,3049,0,0,575,8040,932,1693,595,9733,California
Stanislaus,2021-01-12,1491,12880,877,9217,614,3663,0,0,834,8240,653,2346,853,10586,California
Stanislaus,2021-01-13,1459,14339,689,9906,770,4433,0,0,1124,9050,334,2680,1144,11730,California
Stanislaus,2021-01-14,2286,16625,288,10194,1998,6431,0,0,2078,11025,204,2884,2179,13909,California
Stanislaus,2021-01-15,2858,19483,1170,11364,1688,8119,0,0,2676,13629,176,3060,2780,16689,California
Stanislaus,2021-01-16,476,19959,51,11415,425,8544,0,0,457,14070,18,3078,459,17148,California
Stanislaus,2021-01-17,245,20204,203,11618,42,8586,0,0,237,14300,7,3085,237,17385,California
Stanislaus,2021-01-18,2215,22419,1032,12650,1183,9769,0,0,1805,15790,405,3490,1895,19280,California
Stanislaus,2021-01-19,1275,23694,725,13375,550,10319,0,0,824,16169,446,3936,825,20105,California
Stanislaus,2021-01-20,1042,24736,496,13871,546,10865,0,0,745,16620,294,4230,745,20850,California
Stanislaus,2021-01-21,3750,28486,3012,16883,738,11603,0,0,3376,19767,369,4599,3516,24366,California
Stanislaus,2021-01-22,1126,29612,315,17198,811,12414,0,0,1079,20806,43,4642,1082,25448,California
Stanislaus,2021-01-23,375,29987,40,17238,335,12749,0,0,316,21065,58,4700,317,25765,California
Stanislaus,2021-01-24,315,30302,99,17337,216,12965,0,0,248,21249,67,4767,251,26016,California
Stanislaus,2021-01-25,3210,33512,234,17571,2976,15941,0,0,2846,23947,327,5094,3025,29041,California
Stanislaus,2021-01-26,1759,35271,757,18328,1002,16943,0,0,1305,24830,443,5537,1326,30367,California
Stanislaus,2021-01-27,1939,37210,1071,19399,868,17811,0,0,1221,25390,664,6201,1224,31591,California
Stanislaus,2021-01-28,2243,39453,1534,20933,709,18520,0,0,1729,26693,504,6705,1807,33398,California
Stanislaus,2021-01-29,2491,41944,1220,22153,1271,19791,0,0,1929,28181,505,7210,1993,35391,California
Stanislaus,2021-01-30,295,42239,131,22284,164,19955,0,0,227,28352,56,7266,227,35618,California
Stanislaus,2021-01-31,373,42612,318,22602,55,20010,0,0,357,28696,13,7279,357,35975,California
Stanislaus,2021-02-01,1345,43957,580,23182,765,20775,0,0,978,29323,352,7631,979,36954,California
Stanislaus,2021-02-02,1269,45226,353,23535,916,21691,0,0,826,29723,430,8061,830,37784,California
Stanislaus,2021-02-03,2671,47897,1229,24764,1442,23133,0,0,1963,31000,703,8764,1980,39764,California
Stanislaus,2021-02-04,2140,50037,719,25483,1421,24554,0,0,1614,32112,512,9276,1624,41388,California
Stanislaus,2021-02-05,2893,52930,1487,26970,1406,25960,0,0,1610,32534,1206,10482,1628,43016,California
Stanislaus,2021-02-06,897,53827,303,27273,594,26554,0,0,700,33042,194,10676,702,43718,California
Stanislaus,2021-02-07,229,54056,203,27476,26,26580,0,0,40,32898,185,10861,41,43759,California
Stanislaus,2021-02-08,2090,56146,1358,28834,732,27312,0,0,1133,33150,910,11771,1162,44921,California
Stanislaus,2021-02-09,1877,58023,795,29629,1082,28394,0,0,1062,33439,785,12556,1074,45995,California
Stanislaus,2021-02-10,1987,60010,544,30173,1443,29837,0,0,1047,33583,905,13461,1049,47044,California
Stanislaus,2021-02-11,5469,65479,3300,33473,2169,32006,0,0,1233,30874,3950,17411,1241,48285,California
Stanislaus,2021-02-12,3357,68836,928,34401,2429,34435,0,0,1477,30582,1782,19193,1490,49775,California
Stanislaus,2021-02-13,1387,70223,676,35077,711,35146,0,0,1013,31235,365,19558,1018,50793,California
Stanislaus,2021-02-14,426,70649,170,35247,256,35402,0,0,353,31518,70,19628,353,51146,California
Stanislaus,2021-02-15,1842,72491,235,35482,1607,37009,0,0,583,30972,1134,20762,588,51734,California
Stanislaus,2021-02-16,1389,73880,429,35911,960,37969,0,0,584,30768,790,21552,586,52320,California
Stanislaus,2021-02-17,2814,76694,1726,37637,1088,39057,0,0,1925,31835,877,22429,1944,54264,California
Stanislaus,2021-02-18,3421,80115,1937,39574,1484,40541,0,0,1768,32121,1545,23974,1831,56095,California
Stanislaus,2021-02-19,2850,82965,1115,40689,1735,42276,0,0,1540,32434,1249,25223,1562,57657,California
Stanislaus,2021-02-20,764,83729,388,41077,376,42652,0,0,471,32635,271,25494,472,58129,California
Stanislaus,2021-02-21,915,84644,699,41776,216,42868,0,0,533,32828,353,25847,546,58675,California
Stanislaus,2021-02-22,2393,87037,1716,43492,677,43545,0,0,1631,33723,738,26585,1633,60308,California
Stanislaus,2021-02-23,3771,90808,683,44175,3088,46633,0,0,1718,33595,1857,28442,1729,62037,California
Stanislaus,2021-02-24,4264,95072,2909,47084,1355,47988,0,0,3122,35611,1112,29554,3128,65165,California
Stanislaus,2021-02-25,4018,99090,2765,49849,1253,49241,0,0,3183,37985,813,30367,3187,68352,California
Stanislaus,2021-02-26,4270,103360,1232,51081,3038,52279,0,0,2846,39485,1359,31726,2859,71211,California
Stanislaus,2021-02-27,2105,105465,717,51798,1387,53666,1,1,1868,41150,206,31932,1871,73082,California
Stanislaus,2021-02-28,841,106306,268,52066,573,54239,0,1,785,41892,44,31976,786,73868,California
Stanislaus,2021-03-01,3169,109475,1680,53746,1483,55722,6,7,1678,42154,1436,33412,1698,75566,California
Stanislaus,2021-03-02,2443,111918,1458,55204,984,56706,1,8,1679,43092,745,34157,1683,77249,California
Stanislaus,2021-03-03,3759,115677,2266,57470,1489,58195,4,12,2928,45213,812,34969,2933,80182,California
Stanislaus,2021-03-04,5494,121171,3143,60613,2334,60529,17,29,4210,48197,1238,36207,4222,84404,California
Stanislaus,2021-03-05,4157,125328,1148,61761,2993,63522,16,45,3134,50357,989,37196,3149,87553,California
Stanislaus,2021-03-06,3610,128938,2244,64005,1272,64794,94,139,2744,52337,860,38056,2840,90393,California
Stanislaus,2021-03-07,915,129853,394,64399,444,65238,77,216,682,52869,227,38283,759,91152,California
Stanislaus,2021-03-08,2034,131887,882,65281,1054,66292,98,314,1342,53638,670,38953,1439,92591,California
Stanislaus,2021-03-09,2704,134591,1028,66309,1584,67876,92,406,1649,54343,1040,39993,1745,94336,California
Stanislaus,2021-03-10,5584,140175,2728,69037,2626,70502,230,636,3764,56556,1791,41784,4004,98340,California
Stanislaus,2021-03-11,6189,146364,3378,72415,2329,72831,482,1118,4136,59318,1860,43644,4622,102962,California
Stanislaus,2021-03-12,6326,152690,1373,73788,3016,75847,1937,3055,2930,60818,3360,47004,4860,107822,California
Stanislaus,2021-03-13,3750,156440,2343,76131,1336,77183,71,3126,2836,62824,906,47910,2912,110734,California
Stanislaus,2021-03-14,1000,157440,594,76725,350,77533,56,3182,491,62869,503,48413,548,111282,California
Stanislaus,2021-03-15,3825,161265,1992,78717,1470,79003,363,3545,1651,62818,2070,50483,2019,113301,California
Stanislaus,2021-03-16,5130,166395,2515,81232,2173,81176,442,3987,3677,65507,1427,51910,4116,117417,California
Stanislaus,2021-03-17,4958,171353,2950,84182,1828,83004,180,4167,2985,66746,1929,53839,3168,120585,California
Stanislaus,2021-03-18,5583,176936,3470,87652,2046,85050,67,4234,3046,67481,2382,56221,3117,123702,California
Stanislaus,2021-03-19,6049,182985,1594,89246,2931,87981,1524,5758,3196,69384,2810,59031,4713,128415,California
Stanislaus,2021-03-20,3865,186850,3030,92276,767,88748,68,5826,3382,72358,478,59509,3452,131867,California
Stanislaus,2021-03-21,1022,187872,914,93190,44,88792,64,5890,774,72955,241,59750,838,132705,California
Stanislaus,2021-03-22,3023,190895,1395,94585,903,89695,725,6615,1407,73513,1577,61327,2135,134840,California
Stanislaus,2021-03-23,4140,195035,2116,96701,1764,91459,260,6875,2972,75623,1142,62469,3252,138092,California
Stanislaus,2021-03-24,4724,199759,3294,99995,1351,92810,79,6954,2756,76546,1916,64385,2839,140931,California
Stanislaus,2021-03-25,4440,204199,3015,103010,1411,94221,14,6968,1961,76127,2397,66782,1978,142909,California
Stanislaus,2021-03-26,4950,209149,1418,104428,3459,97680,73,7041,2528,76355,2383,69165,2611,145520,California
Stanislaus,2021-03-27,4438,213587,2773,107201,1581,99261,84,7125,1388,74804,3028,72193,1477,146997,California
Stanislaus,2021-03-28,1118,214705,445,107646,565,99826,108,7233,319,74452,784,72977,432,147429,California
Stanislaus,2021-03-29,3187,217892,1843,109489,1303,101129,41,7274,2162,75648,1011,73988,2207,149636,California
Stanislaus,2021-03-30,3871,221763,2082,111571,1763,102892,26,7300,2387,76598,1469,75457,2419,152055,California
Stanislaus,2021-03-31,5642,227405,3886,115457,1627,104519,129,7429,2933,76981,2683,78140,3066,155121,California
Stanislaus,2021-04-01,5946,233351,3874,119331,1956,106475,116,7545,2751,76695,3160,81300,2874,157995,California
Stanislaus,2021-04-02,5218,238569,1235,120566,3816,110291,167,7712,2379,76512,2737,84037,2554,160549,California
Stanislaus,2021-04-03,4706,243275,3453,124019,1215,111506,38,7750,2256,76378,2437,86474,2303,162852,California
Stanislaus,2021-04-04,1339,244614,479,124498,830,112336,30,7780,649,76381,681,87155,684,163536,California
Stanislaus,2021-04-05,3770,248384,2563,127061,949,113285,258,8038,2449,77782,1309,88464,2710,166246,California
Stanislaus,2021-04-06,5974,254358,4242,131303,1445,114730,287,8325,3218,78554,2735,91199,3507,169753,California
Stanislaus,2021-04-07,6545,260903,3677,134980,2427,117157,441,8766,2897,78277,3622,94821,3345,173098,California
Stanislaus,2021-04-08,5930,266833,3434,138414,2049,119206,447,9213,2944,78719,2951,97772,3393,176491,California
Stanislaus,2021-04-09,5013,271846,2185,140599,2446,121652,382,9595,2286,78696,2695,100467,2672,179163,California
Stanislaus,2021-04-10,6522,278368,4003,144602,878,122530,1641,11236,1995,77825,4501,104968,3630,182793,California
Stanislaus,2021-04-11,1534,279902,857,145459,544,123074,133,11369,663,77755,867,105835,797,183590,California
Stanislaus,2021-04-12,3798,283700,2127,147586,1225,124299,446,11815,1956,78362,1807,107642,2414,186004,California
Stanislaus,2021-04-13,5414,289114,3503,151089,1897,126196,14,11829,2969,78948,2393,110035,2979,188983,California
Stanislaus,2021-04-14,4819,293933,3330,154419,1487,127683,2,11831,2345,78868,2431,112466,2351,191334,California
Stanislaus,2021-04-15,5579,299512,3388,157807,2188,129871,3,11834,3246,79839,2278,114744,3249,194583,California
Stanislaus,2021-04-16,4490,304002,1055,158862,3434,133305,1,11835,1853,79117,2578,117322,1856,196439,California
Stanislaus,2021-04-17,3173,307175,2136,160998,1037,134342,0,11835,1842,79644,1317,118639,1844,198283,California
Stanislaus,2021-04-18,620,307795,298,161296,320,134662,2,11837,435,79907,175,118814,438,198721,California
Stanislaus,2021-04-19,3638,311433,2460,163756,1176,135838,2,11839,1654,79628,1939,120753,1660,200381,California
Stanislaus,2021-04-20,4165,315598,2482,166238,1683,137521,0,11839,1762,79033,2359,123112,1764,202145,California
Stanislaus,2021-04-21,4061,319659,2687,168925,1373,138894,1,11840,1628,78288,2380,125492,1635,203780,California
Stanislaus,2021-04-22,4142,323801,2454,171379,1686,140580,2,11842,1633,77468,2457,127949,1637,205417,California
Stanislaus,2021-04-23,3840,327641,911,172290,2927,143507,2,11844,1565,76870,2171,130120,1573,206990,California
Stanislaus,2021-04-24,3888,331529,2974,175264,914,144421,0,11844,1855,76716,2014,132134,1860,208850,California
Stanislaus,2021-04-25,945,332474,488,175752,457,144878,0,11844,693,77168,245,132379,697,209547,California
Stanislaus,2021-04-26,3666,336140,2438,178190,1222,146100,6,11850,1154,75848,2485,134864,1165,210712,California
Stanislaus,2021-04-27,4306,340446,2889,181079,1369,147469,48,11898,1247,74121,3025,137889,1298,212010,California
Stanislaus,2021-04-28,4617,345063,3160,184239,1394,148863,63,11961,1952,73507,2638,140527,2024,214034,California
Stanislaus,2021-04-29,3985,349048,2445,186684,1492,150355,48,12009,1561,72727,2397,142924,1617,215651,California
Stanislaus,2021-04-30,4841,353889,2156,188840,2600,152955,85,12094,1907,71819,2909,145833,2001,217652,California
Stanislaus,2021-05-01,2736,356625,1935,190775,760,153715,41,12135,1026,71196,1698,147531,1075,218727,California
Stanislaus,2021-05-02,1092,357717,627,191402,427,154142,38,12173,524,71203,561,148092,568,219295,California
Stanislaus,2021-05-03,2614,360331,2034,193436,507,154649,73,12246,998,70679,1599,149691,1075,220370,California
Stanislaus,2021-05-04,3782,364113,2580,196016,1098,155747,104,12350,1177,69379,2587,152278,1287,221657,California
Stanislaus,2021-05-05,3475,367588,2263,198279,1136,156883,76,12426,1199,68406,2251,154529,1278,222935,California
Stanislaus,2021-05-06,3779,371367,2864,201143,791,157674,124,12550,1164,67113,2586,157115,1293,224228,California
Stanislaus,2021-05-07,2591,373958,1033,202176,1396,159070,162,12712,1110,66919,1468,158583,1274,225502,California
Stanislaus,2021-05-08,2022,375980,1403,203579,586,159656,33,12745,752,66462,1249,159832,792,226294,California
Stanislaus,2021-05-09,725,376705,351,203930,348,160004,26,12771,305,66377,417,160249,332,226626,California
Stanislaus,2021-05-10,1828,378533,1159,205089,571,160575,98,12869,495,65652,1320,161569,595,227221,California
Stanislaus,2021-05-11,2531,381064,1579,206668,794,161369,158,13027,753,64800,1769,163338,917,228138,California
Stanislaus,2021-05-12,2405,383469,1367,208035,927,162296,111,13138,933,64391,1456,164794,1047,229185,California
Stanislaus,2021-05-13,2181,385650,1287,209322,775,163071,119,13257,1035,64411,1137,165931,1157,230342,California
Stanislaus,2021-05-14,2786,388436,1256,210578,1393,164464,137,13394,1307,64400,1457,167388,1446,231788,California
Stanislaus,2021-05-15,2497,390933,1782,212360,664,165128,51,13445,1208,64390,1278,168666,1268,233056,California
Stanislaus,2021-05-16,1110,392043,750,213110,352,165480,8,13453,590,64476,516,169182,602,233658,California
Stanislaus,2021-05-17,2062,394105,1391,214501,588,166068,83,13536,992,64495,1063,170245,1082,234740,California
Stanislaus,2021-05-18,2334,396439,1612,216113,607,166675,115,13651,1208,64703,1114,171359,1322,236062,California
Stanislaus,2021-05-19,3159,399598,2165,218278,839,167514,155,13806,1385,64488,1758,173117,1543,237605,California
Stanislaus,2021-05-20,2257,401855,1223,219501,924,168438,110,13916,898,64154,1347,174464,1013,238618,California
Stanislaus,2021-05-21,2506,404361,1227,220728,1180,169618,99,14015,998,63764,1490,175954,1100,239718,California
Stanislaus,2021-05-22,2015,406376,1219,221947,725,170343,71,14086,878,63586,1128,177082,950,240668,California
Stanislaus,2021-05-23,1077,407453,704,222651,357,170700,16,14102,512,63554,560,177642,528,241196,California
Stanislaus,2021-05-24,1830,409283,1272,223923,479,171179,79,14181,725,63264,1100,178742,810,242006,California
Stanislaus,2021-05-25,1818,411101,1241,225164,476,171655,101,14282,864,63287,947,179689,970,242976,California
Stanislaus,2021-05-26,2045,413146,1270,226434,720,172375,55,14337,957,63218,1080,180769,1011,243987,California
Stanislaus,2021-05-27,1800,414946,987,227421,726,173101,87,14424,618,62754,1170,181939,706,244693,California
Stanislaus,2021-05-28,2198,417144,1038,228459,1073,174174,87,14511,944,62538,1247,183186,1031,245724,California
Stanislaus,2021-05-29,1322,418466,852,229311,427,174601,43,14554,591,62447,727,183913,636,246360,California
Stanislaus,2021-05-30,453,418919,271,229582,148,174749,34,14588,205,62443,243,184156,239,246599,California
Stanislaus,2021-05-31,260,419179,123,229705,130,174879,7,14595,97,62384,163,184319,104,246703,California
Stanislaus,2021-06-01,1689,420868,1055,230760,578,175457,56,14651,635,62031,1047,185366,694,247397,California
Stanislaus,2021-06-02,1814,422682,1152,231912,591,176048,71,14722,750,61805,1050,186416,824,248221,California
Stanislaus,2021-06-03,1400,424082,830,232742,520,176568,50,14772,517,61504,871,187287,570,248791,California
Stanislaus,2021-06-04,1918,426000,1149,233891,700,177268,69,14841,722,61110,1189,188476,795,249586,California
Stanislaus,2021-06-05,1572,427572,1222,235113,307,177575,43,14884,517,60622,1048,189524,560,250146,California
Stanislaus,2021-06-06,510,428082,418,235531,83,177658,9,14893,186,60495,323,189847,196,250342,California
Stanislaus,2021-06-07,1611,429693,1232,236763,334,177992,45,14938,602,60143,998,190845,646,250988,California
Stanislaus,2021-06-08,1919,431612,1445,238208,396,178388,78,15016,675,59662,1234,192079,753,251741,California
Stanislaus,2021-06-09,1862,433474,1314,239522,466,178854,82,15098,637,59161,1221,193300,720,252461,California
Stanislaus,2021-06-10,1485,434959,941,240463,479,179333,65,15163,605,58962,873,194173,674,253135,California
Stanislaus,2021-06-11,1507,436466,908,241371,549,179882,50,15213,555,58631,938,195111,607,253742,California
Stanislaus,2021-06-12,1032,437498,751,242122,255,180137,26,15239,382,58398,644,195755,411,254153,California
Stanislaus,2021-06-13,552,438050,409,242531,137,180274,6,15245,180,58217,369,196124,188,254341,California
Stanislaus,2021-06-14,1356,439406,961,243492,371,180645,24,15269,491,57877,855,196979,515,254856,California
Stanislaus,2021-06-15,1591,440997,1146,244638,398,181043,47,15316,534,57409,1052,198031,584,255440,California
Stanislaus,2021-06-16,1945,442942,1392,246030,484,181527,69,15385,776,57090,1165,199196,846,256286,California
Stanislaus,2021-06-17,1168,444110,741,246771,377,181904,50,15435,548,57076,615,199811,601,256887,California
Stanislaus,2021-06-18,1381,445491,854,247625,442,182346,85,15520,555,56897,821,200632,642,257529,California
Stanislaus,2021-06-19,856,446347,629,248254,183,182529,44,15564,371,56832,481,201113,416,257945,California
Stanislaus,2021-06-20,331,446678,238,248492,87,182616,6,15570,155,56817,176,201289,161,258106,California
Stanislaus,2021-06-21,987,447665,580,249072,280,182896,127,15697,513,56990,469,201758,642,258748,California
Stanislaus,2021-06-22,1219,448884,885,249957,261,183157,73,15770,499,56854,710,202468,574,259322,California
Stanislaus,2021-06-23,1237,450121,822,250779,353,183510,62,15832,525,56730,710,203178,586,259908,California
Stanislaus,2021-06-24,954,451075,636,251415,269,183779,49,15881,484,56800,466,203644,536,260444,California
Stanislaus,2021-06-25,1110,452185,716,252131,332,184111,62,15943,468,56691,637,204281,528,260972,California
Stanislaus,2021-06-26,615,452800,464,252595,123,184234,28,15971,282,56671,330,204611,310,261282,California
Stanislaus,2021-06-27,392,453192,296,252891,86,184320,10,15981,200,56690,191,204802,210,261492,California
Stanislaus,2021-06-28,983,454175,776,253667,164,184484,43,16024,436,56623,546,205348,479,261971,California
Stanislaus,2021-06-29,959,455134,764,254431,151,184635,44,16068,433,56580,520,205868,477,262448,California
Stanislaus,2021-06-30,971,456105,669,255100,267,184902,35,16103,459,56570,506,206374,496,262944,California
Stanislaus,2021-07-01,982,457087,640,255740,303,185205,39,16142,477,56590,496,206870,516,263460,California
Stanislaus,2021-07-02,745,457832,425,256165,284,185489,36,16178,370,56627,368,207238,405,263865,California
Stanislaus,2021-07-03,398,458230,298,256463,90,185579,10,16188,210,56660,188,207426,221,264086,California
Stanislaus,2021-07-04,61,458291,29,256492,26,185605,6,16194,19,56644,41,207467,25,264111,California
Stanislaus,2021-07-05,544,458835,400,256892,141,185746,3,16197,262,56629,281,207748,266,264377,California
Stanislaus,2021-07-06,834,459669,599,257491,190,185936,45,16242,376,56596,453,208201,420,264797,California
Stanislaus,2021-07-07,931,460600,609,258100,270,186206,52,16294,377,56476,551,208752,431,265228,California
Stanislaus,2021-07-08,843,461443,530,258630,267,186473,46,16340,419,56521,420,209172,465,265693,California
Stanislaus,2021-07-09,918,462361,574,259204,299,186772,45,16385,465,56587,445,209617,511,266204,California
Stanislaus,2021-07-10,465,462826,368,259572,87,186859,10,16395,242,56618,221,209838,252,266456,California
Stanislaus,2021-07-11,335,463161,259,259831,74,186933,2,16397,174,56637,157,209995,176,266632,California
Stanislaus,2021-07-12,908,464069,665,260496,209,187142,34,16431,459,56688,444,210439,495,267127,California
Stanislaus,2021-07-13,755,464824,574,261070,142,187284,39,16470,400,56776,350,210789,438,267565,California
Stanislaus,2021-07-14,779,465603,523,261593,236,187520,20,16490,394,56809,379,211168,412,267977,California
Stanislaus,2021-07-15,836,466439,569,262162,243,187763,24,16514,414,56830,418,211586,439,268416,California
Stanislaus,2021-07-16,804,467243,525,262687,263,188026,16,16530,438,56921,363,211949,454,268870,California
Stanislaus,2021-07-17,549,467792,419,263106,107,188133,23,16553,316,57030,230,212179,339,269209,California
Stanislaus,2021-07-18,436,468228,348,263454,83,188216,5,16558,242,57086,192,212371,248,269457,California
Stanislaus,2021-07-19,836,469064,645,264099,176,188392,15,16573,468,57204,366,212737,484,269941,California
Stanislaus,2021-07-20,881,469945,675,264774,162,188554,44,16617,473,57322,396,213133,514,270455,California
Stanislaus,2021-07-21,1001,470946,706,265480,270,188824,25,16642,568,57495,430,213563,603,271058,California
Stanislaus,2021-07-22,1006,471952,707,266187,263,189087,36,16678,560,57656,434,213997,595,271653,California
Stanislaus,2021-07-23,925,472877,591,266778,315,189402,19,16697,570,57893,350,214347,587,272240,California
Stanislaus,2021-07-24,602,473479,447,267225,133,189535,22,16719,385,58085,215,214562,407,272647,California
Stanislaus,2021-07-25,404,473883,318,267543,78,189613,8,16727,335,58362,68,214630,345,272992,California
Stanislaus,2021-07-26,846,474729,643,268186,188,189801,15,16742,568,58673,274,214904,585,273577,California
Stanislaus,2021-07-27,865,475594,676,268862,164,189965,25,16767,548,58937,309,215213,573,274150,California
Stanislaus,2021-07-28,904,476498,616,269478,248,190213,40,16807,552,59183,345,215558,591,274741,California
Stanislaus,2021-07-29,1020,477518,636,270114,352,190565,32,16839,646,59489,365,215923,671,275412,California
Stanislaus,2021-07-30,739,478257,394,270508,327,190892,18,16857,486,59746,249,216172,506,275918,California
Stanislaus,2021-07-31,163,478420,93,270601,66,190958,4,16861,110,59812,49,216221,115,276033,California
Sutter,2020-12-15,1,1,1,1,0,0,0,0,1,1,0,0,1,1,California
Sutter,2020-12-16,4,5,4,5,0,0,0,0,4,5,0,0,4,5,California
Sutter,2020-12-17,3,8,3,8,0,0,0,0,3,8,0,0,3,8,California
Sutter,2020-12-18,20,28,20,28,0,0,0,0,20,28,0,0,20,28,California
Sutter,2020-12-19,46,74,46,74,0,0,0,0,46,74,0,0,46,74,California
Sutter,2020-12-20,43,117,43,117,0,0,0,0,43,117,0,0,43,117,California
Sutter,2020-12-21,100,217,100,217,0,0,0,0,100,217,0,0,100,217,California
Sutter,2020-12-22,171,388,171,388,0,0,0,0,171,388,0,0,171,388,California
Sutter,2020-12-23,117,505,112,500,5,5,0,0,117,505,0,0,117,505,California
Sutter,2020-12-24,17,522,11,511,6,11,0,0,17,522,0,0,17,522,California
Sutter,2020-12-26,38,560,34,545,4,15,0,0,38,560,0,0,38,560,California
Sutter,2020-12-27,24,584,23,568,1,16,0,0,24,584,0,0,24,584,California
Sutter,2020-12-28,85,669,57,625,28,44,0,0,85,669,0,0,85,669,California
Sutter,2020-12-29,103,772,14,639,89,133,0,0,103,772,0,0,103,772,California
Sutter,2020-12-30,138,910,33,672,105,238,0,0,138,910,0,0,138,910,California
Sutter,2020-12-31,69,979,6,678,63,301,0,0,69,979,0,0,69,979,California
Sutter,2021-01-01,3,982,3,681,0,301,0,0,3,982,0,0,3,982,California
Sutter,2021-01-02,134,1116,132,813,2,303,0,0,134,1116,0,0,134,1116,California
Sutter,2021-01-03,1,1117,0,813,1,304,0,0,1,1117,0,0,1,1117,California
Sutter,2021-01-04,244,1361,137,950,107,411,0,0,244,1361,0,0,244,1361,California
Sutter,2021-01-05,100,1461,56,1006,44,455,0,0,97,1455,3,3,97,1458,California
Sutter,2021-01-06,203,1664,50,1056,153,608,0,0,198,1648,5,8,198,1656,California
Sutter,2021-01-07,255,1919,154,1210,101,709,0,0,246,1885,9,17,246,1902,California
Sutter,2021-01-08,150,2069,40,1250,110,819,0,0,133,2001,17,34,133,2035,California
Sutter,2021-01-09,45,2114,44,1294,1,820,0,0,3,1962,42,76,3,2038,California
Sutter,2021-01-10,397,2511,38,1332,359,1179,0,0,359,2284,37,113,359,2397,California
Sutter,2021-01-11,132,2643,116,1448,16,1195,0,0,24,2200,108,221,24,2421,California
Sutter,2021-01-12,202,2845,165,1613,37,1232,0,0,58,2114,144,365,58,2479,California
Sutter,2021-01-13,163,3008,99,1712,64,1296,0,0,72,2096,90,455,72,2551,California
Sutter,2021-01-14,148,3156,52,1764,96,1392,0,0,128,2204,20,475,128,2679,California
Sutter,2021-01-15,436,3592,130,1894,306,1698,0,0,421,2610,15,490,421,3100,California
Sutter,2021-01-16,390,3982,42,1936,348,2046,0,0,360,2940,30,520,360,3460,California
Sutter,2021-01-17,28,4010,25,1961,3,2049,0,0,12,2936,16,536,12,3472,California
Sutter,2021-01-18,121,4131,64,2025,57,2106,0,0,72,2959,49,585,72,3544,California
Sutter,2021-01-19,112,4243,45,2070,67,2173,0,0,87,3021,25,610,87,3631,California
Sutter,2021-01-20,274,4517,210,2280,64,2237,0,0,252,3251,22,632,252,3883,California
Sutter,2021-01-21,531,5048,359,2639,172,2409,0,0,513,3746,18,650,513,4396,California
Sutter,2021-01-22,243,5291,52,2691,191,2600,0,0,234,3971,9,659,234,4630,California
Sutter,2021-01-23,400,5691,39,2730,361,2961,0,0,374,4319,26,685,374,5004,California
Sutter,2021-01-24,18,5709,15,2745,3,2964,0,0,16,4333,2,687,16,5020,California
Sutter,2021-01-25,308,6017,195,2940,113,3077,0,0,152,4331,155,842,153,5173,California
Sutter,2021-01-26,253,6270,109,3049,144,3221,0,0,144,4367,108,950,144,5317,California
Sutter,2021-01-27,392,6662,257,3306,135,3356,0,0,322,4619,70,1020,322,5639,California
Sutter,2021-01-28,593,7255,360,3666,233,3589,0,0,412,4853,178,1198,412,6051,California
Sutter,2021-01-29,368,7623,88,3754,280,3869,0,0,245,4975,123,1321,245,6296,California
Sutter,2021-01-30,779,8402,38,3792,741,4610,0,0,768,5732,11,1332,768,7064,California
Sutter,2021-01-31,27,8429,26,3818,1,4611,0,0,27,5759,0,1332,27,7091,California
Sutter,2021-02-01,173,8602,52,3870,121,4732,0,0,141,5869,31,1363,141,7232,California
Sutter,2021-02-02,248,8850,26,3896,222,4954,0,0,212,6045,36,1399,212,7444,California
Sutter,2021-02-03,446,9296,36,3932,410,5364,0,0,212,6024,233,1632,212,7656,California
Sutter,2021-02-04,685,9981,369,4301,316,5680,0,0,630,6600,54,1686,630,8286,California
Sutter,2021-02-05,293,10274,33,4334,260,5940,0,0,140,6587,153,1839,140,8426,California
Sutter,2021-02-06,744,11018,30,4364,714,6654,0,0,724,7291,20,1859,724,9150,California
Sutter,2021-02-07,23,11041,19,4383,4,6658,0,0,18,7304,5,1864,18,9168,California
Sutter,2021-02-08,135,11176,32,4415,103,6761,0,0,99,7367,36,1900,99,9267,California
Sutter,2021-02-09,252,11428,49,4464,203,6964,0,0,187,7489,65,1965,187,9454,California
Sutter,2021-02-10,825,12253,387,4851,438,7402,0,0,179,7023,645,2610,179,9633,California
Sutter,2021-02-11,612,12865,272,5123,340,7742,0,0,317,7045,295,2905,317,9950,California
Sutter,2021-02-12,646,13511,71,5194,575,8317,0,0,317,7034,328,3233,317,10267,California
Sutter,2021-02-13,918,14429,48,5242,870,9187,0,0,798,7712,120,3353,798,11065,California
Sutter,2021-02-14,100,14529,26,5268,74,9261,0,0,88,7788,12,3365,88,11153,California
Sutter,2021-02-15,205,14734,70,5338,135,9396,0,0,124,7831,81,3446,124,11277,California
Sutter,2021-02-16,293,15027,44,5382,249,9645,0,0,206,7952,85,3531,206,11483,California
Sutter,2021-02-17,842,15869,439,5821,403,10048,0,0,138,7387,703,4234,138,11621,California
Sutter,2021-02-18,728,16597,60,5881,668,10716,0,0,506,7673,220,4454,506,12127,California
Sutter,2021-02-19,676,17273,381,6262,295,11011,0,0,467,7934,206,4660,467,12594,California
Sutter,2021-02-20,631,17904,58,6320,573,11584,0,0,522,8348,108,4768,522,13116,California
Sutter,2021-02-21,30,17934,27,6347,3,11587,0,0,9,8336,21,4789,9,13125,California
Sutter,2021-02-22,217,18151,125,6472,92,11679,0,0,87,8294,129,4918,87,13212,California
Sutter,2021-02-23,245,18396,34,6506,211,11890,0,0,107,8265,136,5054,107,13319,California
Sutter,2021-02-24,1059,19455,386,6892,673,12563,0,0,205,7618,852,5906,205,13524,California
Sutter,2021-02-25,886,20341,560,7452,326,12889,0,0,676,8088,206,6112,676,14200,California
Sutter,2021-02-26,420,20761,63,7515,357,13246,0,0,176,8025,239,6351,176,14376,California
Sutter,2021-02-27,930,21691,51,7566,879,14125,0,0,753,8601,177,6528,753,15129,California
Sutter,2021-02-28,99,21790,50,7616,49,14174,0,0,76,8655,22,6550,76,15205,California
Sutter,2021-03-01,278,22068,66,7682,212,14386,0,0,164,8705,114,6664,164,15369,California
Sutter,2021-03-02,363,22431,64,7746,299,14685,0,0,173,8691,187,6851,173,15542,California
Sutter,2021-03-03,1486,23917,545,8291,941,15626,0,0,681,8575,797,7648,681,16223,California
Sutter,2021-03-04,1287,25204,867,9158,420,16046,0,0,957,9206,326,7974,957,17180,California
Sutter,2021-03-05,345,25549,81,9239,263,16309,1,1,210,9282,135,8109,211,17391,California
Sutter,2021-03-06,1031,26580,49,9288,977,17286,5,6,858,9974,171,8280,863,18254,California
Sutter,2021-03-07,66,26646,22,9310,43,17329,1,7,42,9994,23,8303,43,18297,California
Sutter,2021-03-08,234,26880,78,9388,144,17473,12,19,164,10100,70,8373,176,18473,California
Sutter,2021-03-09,398,27278,143,9531,243,17716,12,31,193,10100,205,8578,205,18678,California
Sutter,2021-03-10,1594,28872,683,10214,847,18563,64,95,530,9638,1056,9634,594,19272,California
Sutter,2021-03-11,908,29780,442,10656,449,19012,17,112,656,10063,248,9882,673,19945,California
Sutter,2021-03-12,687,30467,110,10766,396,19408,181,293,201,9961,481,10363,379,20324,California
Sutter,2021-03-13,1004,31471,752,11518,233,19641,19,312,784,10547,217,10580,803,21127,California
Sutter,2021-03-14,141,31612,22,11540,108,19749,11,323,46,10509,95,10675,57,21184,California
Sutter,2021-03-15,333,31945,68,11608,216,19965,49,372,156,10539,175,10850,205,21389,California
Sutter,2021-03-16,391,32336,85,11693,258,20223,48,420,210,10615,181,11031,257,21646,California
Sutter,2021-03-17,1501,33837,564,12257,916,21139,21,441,264,9678,1222,12253,285,21931,California
Sutter,2021-03-18,978,34815,176,12433,599,21738,203,644,570,10046,402,12655,770,22701,California
Sutter,2021-03-19,465,35280,166,12599,269,22007,30,674,281,10174,182,12837,310,23011,California
Sutter,2021-03-20,944,36224,115,12714,818,22825,11,685,850,10943,92,12929,861,23872,California
Sutter,2021-03-21,72,36296,50,12764,19,22844,3,688,28,10931,43,12972,31,23903,California
Sutter,2021-03-22,292,36588,120,12884,145,22989,27,715,207,11083,82,13054,234,24137,California
Sutter,2021-03-23,379,36967,116,13000,228,23217,35,750,244,11228,133,13187,278,24415,California
Sutter,2021-03-24,1701,38668,775,13775,857,24074,69,819,288,10189,1396,14583,357,24772,California
Sutter,2021-03-25,1056,39724,683,14458,329,24403,44,863,360,9903,690,15273,404,25176,California
Sutter,2021-03-26,503,40227,179,14637,308,24711,16,879,282,9986,215,15488,298,25474,California
Sutter,2021-03-27,939,41166,63,14700,874,25585,2,881,815,10687,116,15604,817,26291,California
Sutter,2021-03-28,125,41291,72,14772,53,25638,0,881,74,10713,49,15653,75,26366,California
Sutter,2021-03-29,423,41714,139,14911,228,25866,56,937,211,10770,210,15863,267,26633,California
Sutter,2021-03-30,481,42195,162,15073,309,26175,10,947,307,10914,173,16036,317,26950,California
Sutter,2021-03-31,1253,43448,180,15253,1058,27233,15,962,421,10530,819,16855,435,27385,California
Sutter,2021-04-01,1394,44842,742,15995,464,27697,188,1150,426,10186,957,17812,613,27998,California
Sutter,2021-04-02,519,45361,102,16097,300,27997,117,1267,205,10195,310,18122,319,28317,California
Sutter,2021-04-03,922,46283,79,16176,216,28213,627,1894,126,10158,789,18911,752,29069,California
Sutter,2021-04-04,118,46401,23,16199,89,28302,6,1900,55,10157,62,18973,61,29130,California
Sutter,2021-04-05,376,46777,145,16344,194,28496,37,1937,174,10169,199,19172,211,29341,California
Sutter,2021-04-06,516,47293,198,16542,262,28758,56,1993,273,10257,241,19413,329,29670,California
Sutter,2021-04-07,1487,48780,886,17428,523,29281,78,2071,599,10059,875,20288,677,30347,California
Sutter,2021-04-08,1051,49831,577,18005,361,29642,113,2184,569,10263,475,20763,679,31026,California
Sutter,2021-04-09,576,50407,249,18254,261,29903,66,2250,238,10234,333,21096,304,31330,California
Sutter,2021-04-10,840,51247,109,18363,98,30001,633,2883,116,10255,718,21814,739,32069,California
Sutter,2021-04-11,124,51371,34,18397,44,30045,46,2929,42,10260,81,21895,86,32155,California
Sutter,2021-04-12,344,51715,95,18492,196,30241,53,2982,135,10240,208,22103,188,32343,California
Sutter,2021-04-13,436,52151,127,18619,309,30550,0,2982,212,10230,222,22325,212,32555,California
Sutter,2021-04-14,1323,53474,160,18779,1162,31712,1,2983,223,9363,1091,23416,224,32779,California
Sutter,2021-04-15,540,54014,173,18952,367,32079,0,2983,216,9261,318,23734,216,32995,California
Sutter,2021-04-16,409,54423,128,19080,281,32360,0,2983,190,9233,218,23952,190,33185,California
Sutter,2021-04-17,583,55006,86,19166,497,32857,0,2983,510,9673,70,24022,510,33695,California
Sutter,2021-04-18,94,55100,34,19200,60,32917,0,2983,60,9701,32,24054,60,33755,California
Sutter,2021-04-19,290,55390,108,19308,182,33099,0,2983,118,9650,169,24223,118,33873,California
Sutter,2021-04-20,469,55859,181,19489,288,33387,0,2983,225,9634,241,24464,225,34098,California
Sutter,2021-04-21,1339,57198,504,19993,835,34222,0,2983,520,9350,804,25268,520,34618,California
Sutter,2021-04-22,544,57742,196,20189,348,34570,0,2983,270,9349,271,25539,270,34888,California
Sutter,2021-04-23,443,58185,156,20345,287,34857,0,2983,202,9314,237,25776,202,35090,California
Sutter,2021-04-24,335,58520,108,20453,226,35083,1,2984,190,9361,143,25919,190,35280,California
Sutter,2021-04-25,164,58684,77,20530,87,35170,0,2984,89,9377,73,25992,89,35369,California
Sutter,2021-04-26,325,59009,107,20637,216,35386,2,2986,136,9328,187,26179,138,35507,California
Sutter,2021-04-27,566,59575,288,20925,274,35660,4,2990,256,9283,305,26484,260,35767,California
Sutter,2021-04-28,868,60443,389,21314,471,36131,8,2998,285,9000,576,27060,293,36060,California
Sutter,2021-04-29,822,61265,173,21487,648,36779,1,2999,334,8854,481,27541,335,36395,California
Sutter,2021-04-30,404,61669,145,21632,246,37025,13,3012,177,8821,222,27763,189,36584,California
Sutter,2021-05-01,303,61972,107,21739,156,37181,40,3052,132,8825,168,27931,172,36756,California
Sutter,2021-05-02,81,62053,52,21791,27,37208,2,3054,46,8838,35,27966,48,36804,California
Sutter,2021-05-03,228,62281,117,21908,100,37308,11,3065,92,8806,135,28101,103,36907,California
Sutter,2021-05-04,562,62843,254,22162,243,37551,65,3130,231,8773,327,28428,294,37201,California
Sutter,2021-05-05,569,63412,174,22336,387,37938,8,3138,166,8549,398,28826,174,37375,California
Sutter,2021-05-06,439,63851,236,22572,185,38123,18,3156,196,8521,241,29067,213,37588,California
Sutter,2021-05-07,434,64285,160,22732,253,38376,21,3177,159,8433,269,29336,181,37769,California
Sutter,2021-05-08,243,64528,95,22827,143,38519,5,3182,116,8427,127,29463,121,37890,California
Sutter,2021-05-09,108,64636,80,22907,23,38542,5,3187,59,8443,48,29511,64,37954,California
Sutter,2021-05-10,194,64830,46,22953,130,38672,18,3205,50,8368,143,29654,68,38022,California
Sutter,2021-05-11,478,65308,241,23194,216,38888,21,3226,194,8302,279,29933,213,38235,California
Sutter,2021-05-12,472,65780,266,23460,195,39083,11,3237,157,8159,311,30244,168,38403,California
Sutter,2021-05-13,498,66278,266,23726,210,39293,22,3259,194,8073,302,30546,216,38619,California
Sutter,2021-05-14,446,66724,191,23917,239,39532,16,3275,202,8054,238,30784,219,38838,California
Sutter,2021-05-15,851,67575,317,24234,503,40035,31,3306,309,7855,539,31323,340,39178,California
Sutter,2021-05-16,177,67752,119,24353,50,40085,8,3314,93,7873,83,31406,101,39279,California
Sutter,2021-05-17,291,68043,116,24469,161,40246,14,3328,150,7899,138,31544,164,39443,California
Sutter,2021-05-18,559,68602,316,24785,238,40484,5,3333,301,7951,254,31798,306,39749,California
Sutter,2021-05-19,463,69065,265,25050,191,40675,7,3340,223,7944,237,32035,230,39979,California
Sutter,2021-05-20,469,69534,245,25295,212,40887,12,3352,217,7927,246,32281,229,40208,California
Sutter,2021-05-21,494,70028,222,25517,260,41147,12,3364,213,7872,279,32560,224,40432,California
Sutter,2021-05-22,373,70401,206,25723,164,41311,3,3367,184,7874,184,32744,186,40618,California
Sutter,2021-05-23,192,70593,95,25818,88,41399,9,3376,89,7876,96,32840,98,40716,California
Sutter,2021-05-24,242,70835,92,25910,127,41526,23,3399,97,7854,142,32982,120,40836,California
Sutter,2021-05-25,403,71238,196,26106,195,41721,12,3411,166,7799,233,33215,178,41014,California
Sutter,2021-05-26,320,71558,155,26261,156,41877,9,3420,112,7717,203,33418,121,41135,California
Sutter,2021-05-27,437,71995,119,26380,298,42175,20,3440,121,7547,311,33729,141,41276,California
Sutter,2021-05-28,340,72335,164,26544,159,42334,17,3457,169,7569,164,33893,186,41462,California
Sutter,2021-05-29,254,72589,120,26664,119,42453,15,3472,132,7598,118,34011,147,41609,California
Sutter,2021-05-30,88,72677,63,26727,22,42475,3,3475,40,7596,45,34056,43,41652,California
Sutter,2021-05-31,21,72698,3,26730,14,42489,4,3479,7,7593,14,34070,11,41663,California
Sutter,2021-06-01,310,73008,133,26863,169,42658,8,3487,114,7521,194,34264,122,41785,California
Sutter,2021-06-02,282,73290,120,26983,156,42814,6,3493,96,7442,181,34445,102,41887,California
Sutter,2021-06-03,341,73631,222,27205,109,42923,10,3503,116,7348,220,34665,126,42013,California
Sutter,2021-06-04,343,73974,198,27403,138,43061,7,3510,120,7258,217,34882,127,42140,California
Sutter,2021-06-05,441,74415,370,27773,67,43128,4,3514,153,7132,283,35165,157,42297,California
Sutter,2021-06-06,134,74549,115,27888,16,43144,3,3517,45,7093,87,35252,48,42345,California
Sutter,2021-06-07,165,74714,107,27995,49,43193,9,3526,59,7056,105,35357,68,42413,California
Sutter,2021-06-08,368,75082,208,28203,147,43340,13,3539,156,7015,210,35567,169,42582,California
Sutter,2021-06-09,370,75452,235,28438,130,43470,5,3544,128,6909,239,35806,133,42715,California
Sutter,2021-06-10,388,75840,279,28717,99,43569,10,3554,153,6841,231,36037,163,42878,California
Sutter,2021-06-11,340,76180,218,28935,116,43685,6,3560,114,6739,221,36258,119,42997,California
Sutter,2021-06-12,244,76424,170,29105,59,43744,15,3575,69,6648,175,36433,84,43081,California
Sutter,2021-06-13,83,76507,65,29170,17,43761,1,3576,22,6611,60,36493,23,43104,California
Sutter,2021-06-14,190,76697,111,29281,68,43829,11,3587,74,6581,115,36608,85,43189,California
Sutter,2021-06-15,285,76982,153,29434,119,43948,13,3600,101,6513,182,36790,114,43303,California
Sutter,2021-06-16,223,77205,144,29578,70,44018,9,3609,109,6517,114,36904,118,43421,California
Sutter,2021-06-17,283,77488,173,29751,104,44122,6,3615,121,6484,160,37064,127,43548,California
Sutter,2021-06-18,266,77754,172,29923,79,44201,15,3630,92,6421,170,37234,107,43655,California
Sutter,2021-06-19,208,77962,139,30062,65,44266,4,3634,59,6337,147,37381,63,43718,California
Sutter,2021-06-20,70,78032,49,30111,19,44285,2,3636,30,6329,40,37421,32,43750,California
Sutter,2021-06-21,111,78143,52,30163,47,44332,12,3648,49,6330,60,37481,61,43811,California
Sutter,2021-06-22,223,78366,128,30291,92,44424,3,3651,87,6286,134,37615,90,43901,California
Sutter,2021-06-23,184,78550,107,30398,69,44493,8,3659,76,6262,107,37722,83,43984,California
Sutter,2021-06-24,238,78788,161,30559,67,44560,10,3669,102,6238,136,37858,112,44096,California
Sutter,2021-06-25,225,79013,145,30704,74,44634,6,3675,89,6202,131,37989,95,44191,California
Sutter,2021-06-26,219,79232,178,30882,36,44670,5,3680,76,6143,141,38130,82,44273,California
Sutter,2021-06-27,78,79310,65,30947,12,44682,1,3681,28,6123,49,38179,29,44302,California
Sutter,2021-06-28,121,79431,75,31022,40,44722,6,3687,60,6129,60,38239,66,44368,California
Sutter,2021-06-29,234,79665,153,31175,70,44792,11,3698,82,6073,149,38388,93,44461,California
Sutter,2021-06-30,183,79848,117,31292,56,44848,10,3708,77,6058,102,38490,87,44548,California
Sutter,2021-07-01,206,80054,174,31466,25,44873,7,3715,75,6010,130,38620,82,44630,California
Sutter,2021-07-02,198,80252,130,31596,56,44929,12,3727,94,6019,97,38717,106,44736,California
Sutter,2021-07-03,116,80368,90,31686,23,44952,3,3730,42,5996,68,38785,45,44781,California
Sutter,2021-07-04,6,80374,3,31689,3,44955,0,3730,2,5995,3,38788,2,44783,California
Sutter,2021-07-05,85,80459,57,31746,18,44973,10,3740,38,5996,46,38834,47,44830,California
Sutter,2021-07-06,228,80687,135,31881,72,45045,21,3761,77,5945,149,38983,98,44928,California
Sutter,2021-07-07,189,80876,106,31987,75,45120,8,3769,61,5888,126,39109,69,44997,California
Sutter,2021-07-08,217,81093,135,32122,76,45196,6,3775,77,5833,138,39247,83,45080,California
Sutter,2021-07-09,205,81298,137,32259,61,45257,7,3782,100,5838,102,39349,107,45187,California
Sutter,2021-07-10,151,81449,113,32372,33,45290,5,3787,74,5841,76,39425,79,45266,California
Sutter,2021-07-11,63,81512,45,32417,17,45307,1,3788,34,5847,29,39454,35,45301,California
Sutter,2021-07-12,139,81651,84,32501,44,45351,11,3799,62,5845,75,39529,73,45374,California
Sutter,2021-07-13,153,81804,85,32586,64,45415,4,3803,76,5852,73,39602,80,45454,California
Sutter,2021-07-14,189,81993,97,32683,85,45500,7,3810,90,5851,98,39700,97,45551,California
Sutter,2021-07-15,175,82168,108,32791,60,45560,7,3817,72,5828,102,39802,79,45630,California
Sutter,2021-07-16,176,82344,103,32894,60,45620,13,3830,87,5839,89,39891,100,45730,California
Sutter,2021-07-17,127,82471,95,32989,31,45651,1,3831,60,5834,66,39957,61,45791,California
Sutter,2021-07-18,48,82519,29,33018,16,45667,3,3834,27,5844,20,39977,30,45821,California
Sutter,2021-07-19,95,82614,42,33060,45,45712,8,3842,56,5869,39,40016,64,45885,California
Sutter,2021-07-20,203,82817,126,33186,70,45782,7,3849,99,5872,103,40119,106,45991,California
Sutter,2021-07-21,213,83030,118,33304,78,45860,17,3866,106,5889,105,40224,122,46113,California
Sutter,2021-07-22,190,83220,119,33423,66,45926,5,3871,107,5920,81,40305,112,46225,California
Sutter,2021-07-23,236,83456,145,33568,78,46004,13,3884,130,5959,104,40409,143,46368,California
Sutter,2021-07-24,138,83594,106,33674,29,46033,3,3887,85,5996,51,40460,88,46456,California
Sutter,2021-07-25,97,83691,77,33751,16,46049,4,3891,70,6045,25,40485,74,46530,California
Sutter,2021-07-26,157,83848,88,33839,57,46106,12,3903,91,6082,66,40551,103,46633,California
Sutter,2021-07-27,238,84086,169,34008,54,46160,15,3918,139,6139,97,40648,154,46787,California
Sutter,2021-07-28,183,84269,108,34116,69,46229,6,3924,119,6200,64,40712,125,46912,California
Sutter,2021-07-29,176,84445,131,34247,39,46268,6,3930,118,6266,58,40770,124,47036,California
Sutter,2021-07-30,264,84709,191,34438,62,46330,11,3941,162,6338,101,40871,173,47209,California
Sutter,2021-07-31,115,84824,98,34536,17,46347,0,3941,75,6375,38,40909,75,47284,California
Tehama,2020-12-16,5,5,5,5,0,0,0,0,5,5,0,0,5,5,California
Tehama,2020-12-17,20,25,20,25,0,0,0,0,20,25,0,0,20,25,California
Tehama,2020-12-18,5,30,5,30,0,0,0,0,6,31,0,0,6,31,California
Tehama,2020-12-21,44,74,44,74,0,0,0,0,44,75,0,0,44,75,California
Tehama,2020-12-22,82,156,76,150,6,6,0,0,82,157,0,0,82,157,California
Tehama,2020-12-23,55,211,47,197,8,14,0,0,55,212,0,0,55,212,California
Tehama,2020-12-24,5,216,3,200,2,16,0,0,5,217,0,0,5,217,California
Tehama,2020-12-26,4,220,3,203,1,17,0,0,4,221,0,0,4,221,California
Tehama,2020-12-27,2,222,2,205,0,17,0,0,2,223,0,0,2,223,California
Tehama,2020-12-28,59,281,46,251,13,30,0,0,59,282,0,0,59,282,California
Tehama,2020-12-29,43,324,43,294,0,30,0,0,43,325,0,0,43,325,California
Tehama,2020-12-30,62,386,44,338,18,48,0,0,61,386,0,0,61,386,California
Tehama,2020-12-31,16,402,5,343,11,59,0,0,16,402,0,0,16,402,California
Tehama,2021-01-01,3,405,0,343,3,62,0,0,3,405,0,0,3,405,California
Tehama,2021-01-04,49,454,17,360,32,94,0,0,49,454,0,0,49,454,California
Tehama,2021-01-05,76,530,47,407,29,123,0,0,70,518,6,6,70,524,California
Tehama,2021-01-06,87,617,33,440,54,177,0,0,72,577,13,19,72,596,California
Tehama,2021-01-07,63,680,7,447,56,233,0,0,62,638,1,20,62,658,California
Tehama,2021-01-08,43,723,31,478,12,245,0,0,35,665,8,28,35,693,California
Tehama,2021-01-09,7,730,5,483,2,247,0,0,6,670,1,29,6,699,California
Tehama,2021-01-10,1,731,0,483,1,248,0,0,1,671,0,29,1,700,California
Tehama,2021-01-11,64,795,56,539,8,256,0,0,22,651,42,71,22,722,California
Tehama,2021-01-12,151,946,131,670,20,276,0,0,93,686,58,129,93,815,California
Tehama,2021-01-13,88,1034,62,732,26,302,0,0,37,672,51,180,37,852,California
Tehama,2021-01-14,245,1279,52,784,193,495,0,0,243,913,2,182,243,1095,California
Tehama,2021-01-15,292,1571,75,859,217,712,0,0,288,1197,4,186,288,1383,California
Tehama,2021-01-16,275,1846,20,879,255,967,0,0,272,1466,3,189,272,1655,California
Tehama,2021-01-17,7,1853,3,882,4,971,0,0,4,1467,3,192,4,1659,California
Tehama,2021-01-18,16,1869,8,890,8,979,0,0,10,1471,6,198,10,1669,California
Tehama,2021-01-19,313,2182,79,969,234,1213,0,0,250,1658,63,261,250,1919,California
Tehama,2021-01-20,346,2528,103,1072,243,1456,0,0,289,1891,56,317,289,2208,California
Tehama,2021-01-21,249,2777,21,1093,228,1684,0,0,233,2108,16,333,233,2441,California
Tehama,2021-01-22,246,3023,22,1115,224,1908,0,0,243,2348,3,336,243,2684,California
Tehama,2021-01-23,270,3293,7,1122,263,2171,0,0,269,2616,1,337,269,2953,California
Tehama,2021-01-24,3,3296,1,1123,2,2173,0,0,3,2619,0,337,3,2956,California
Tehama,2021-01-25,46,3342,22,1145,24,2197,0,0,21,2615,25,362,21,2977,California
Tehama,2021-01-26,358,3700,47,1192,311,2508,0,0,320,2897,38,400,320,3297,California
Tehama,2021-01-27,344,4044,24,1216,320,2828,0,0,321,3195,23,423,321,3618,California
Tehama,2021-01-28,377,4421,42,1258,335,3163,0,0,354,3526,23,446,354,3972,California
Tehama,2021-01-29,360,4781,25,1283,335,3498,0,0,340,3846,20,466,340,4312,California
Tehama,2021-01-30,115,4896,2,1285,113,3611,0,0,114,3959,1,467,114,4426,California
Tehama,2021-01-31,2,4898,1,1286,1,3612,0,0,2,3961,0,467,2,4428,California
Tehama,2021-02-01,90,4988,24,1310,66,3678,0,0,40,3951,50,517,40,4468,California
Tehama,2021-02-02,388,5376,72,1382,316,3994,0,0,287,4137,101,618,287,4755,California
Tehama,2021-02-03,459,5835,14,1396,445,4439,0,0,403,4484,56,674,403,5158,California
Tehama,2021-02-04,564,6399,106,1502,458,4897,0,0,474,4868,90,764,474,5632,California
Tehama,2021-02-05,201,6600,72,1574,129,5026,0,0,137,4941,64,828,137,5769,California
Tehama,2021-02-06,48,6648,16,1590,32,5058,0,0,36,4965,12,840,36,5805,California
Tehama,2021-02-07,6,6654,5,1595,1,5059,0,0,2,4964,3,843,2,5807,California
Tehama,2021-02-08,48,6702,13,1608,35,5094,0,0,31,4978,17,860,31,5838,California
Tehama,2021-02-09,97,6799,51,1659,46,5140,0,0,51,4983,46,906,51,5889,California
Tehama,2021-02-10,260,7059,72,1731,188,5328,0,0,166,5055,94,1000,166,6055,California
Tehama,2021-02-11,247,7306,17,1748,230,5558,0,0,93,4996,152,1152,93,6148,California
Tehama,2021-02-12,417,7723,81,1829,336,5894,0,0,192,4963,225,1377,192,6340,California
Tehama,2021-02-13,415,8138,19,1848,396,6290,0,0,162,4872,253,1630,162,6502,California
Tehama,2021-02-14,39,8177,2,1850,37,6327,0,0,36,4905,3,1633,36,6538,California
Tehama,2021-02-15,66,8243,12,1862,54,6381,0,0,57,4953,9,1642,57,6595,California
Tehama,2021-02-16,269,8512,23,1885,246,6627,0,0,76,4836,193,1835,76,6671,California
Tehama,2021-02-17,332,8844,22,1907,310,6937,0,0,66,4636,266,2101,66,6737,California
Tehama,2021-02-18,398,9242,37,1944,361,7298,0,0,152,4542,246,2347,152,6889,California
Tehama,2021-02-19,243,9485,31,1975,212,7510,0,0,52,4403,191,2538,52,6941,California
Tehama,2021-02-20,289,9774,8,1983,281,7791,0,0,33,4180,256,2794,33,6974,California
Tehama,2021-02-21,5,9779,2,1985,3,7794,0,0,2,4179,3,2797,2,6976,California
Tehama,2021-02-22,49,9828,16,2001,33,7827,0,0,30,4190,19,2816,30,7006,California
Tehama,2021-02-23,91,9919,26,2027,65,7892,0,0,34,4167,57,2873,34,7040,California
Tehama,2021-02-24,359,10278,29,2056,330,8222,0,0,41,3890,318,3191,41,7081,California
Tehama,2021-02-25,416,10694,66,2122,350,8572,0,0,47,3568,369,3560,47,7128,California
Tehama,2021-02-26,511,11205,24,2146,487,9059,0,0,82,3221,429,3989,82,7210,California
Tehama,2021-02-27,335,11540,7,2153,328,9387,0,0,41,2969,293,4282,41,7251,California
Tehama,2021-02-28,21,11561,2,2155,19,9406,0,0,18,2984,3,4285,18,7269,California
Tehama,2021-03-01,75,11636,10,2165,65,9471,0,0,33,2975,42,4327,33,7302,California
Tehama,2021-03-02,181,11817,21,2186,160,9631,0,0,39,2873,141,4468,39,7341,California
Tehama,2021-03-03,187,12004,35,2221,152,9783,0,0,59,2804,128,4596,59,7400,California
Tehama,2021-03-04,769,12773,70,2291,699,10482,0,0,262,2564,502,5098,262,7662,California
Tehama,2021-03-05,449,13222,25,2316,424,10906,0,0,224,2565,223,5321,224,7886,California
Tehama,2021-03-06,362,13584,20,2336,339,11245,3,3,89,2386,272,5593,93,7979,California
Tehama,2021-03-07,7,13591,1,2337,6,11251,0,3,4,2387,3,5596,4,7983,California
Tehama,2021-03-08,72,13663,11,2348,44,11295,17,20,29,2391,42,5638,46,8029,California
Tehama,2021-03-09,409,14072,16,2364,372,11667,21,41,348,2699,61,5699,369,8398,California
Tehama,2021-03-10,379,14451,23,2387,333,12000,23,64,76,2496,302,6001,99,8497,California
Tehama,2021-03-11,560,15011,28,2415,467,12467,65,129,389,2779,171,6172,454,8951,California
Tehama,2021-03-12,351,15362,32,2447,246,12713,73,202,200,2903,150,6322,274,9225,California
Tehama,2021-03-13,68,15430,11,2458,48,12761,9,211,11,2866,57,6379,20,9245,California
Tehama,2021-03-14,64,15494,2,2460,53,12814,9,220,21,2853,43,6422,30,9275,California
Tehama,2021-03-15,174,15668,22,2482,126,12940,26,246,89,2883,85,6507,115,9390,California
Tehama,2021-03-16,453,16121,19,2501,396,13336,38,284,341,3151,111,6618,379,9769,California
Tehama,2021-03-17,475,16596,34,2535,410,13746,31,315,384,3477,89,6707,415,10184,California
Tehama,2021-03-18,539,17135,39,2574,473,14219,27,342,350,3667,187,6894,377,10561,California
Tehama,2021-03-19,348,17483,25,2599,310,14529,13,355,306,3944,42,6936,319,10880,California
Tehama,2021-03-20,58,17541,18,2617,36,14565,4,359,40,3970,18,6954,44,10924,California
Tehama,2021-03-21,12,17553,5,2622,7,14572,0,359,12,3982,0,6954,12,10936,California
Tehama,2021-03-22,106,17659,11,2633,78,14650,17,376,60,4013,46,7000,77,11013,California
Tehama,2021-03-23,104,17763,36,2669,61,14711,7,383,75,4066,29,7029,82,11095,California
Tehama,2021-03-24,101,17864,17,2686,79,14790,5,388,65,4100,36,7065,70,11165,California
Tehama,2021-03-25,603,18467,415,3101,175,14965,13,401,543,4597,59,7124,556,11721,California
Tehama,2021-03-26,582,19049,454,3555,115,15080,13,414,492,5015,87,7211,505,12226,California
Tehama,2021-03-27,521,19570,401,3956,84,15164,36,450,436,5403,84,7295,472,12698,California
Tehama,2021-03-28,40,19610,15,3971,25,15189,0,450,23,5409,17,7312,23,12721,California
Tehama,2021-03-29,133,19743,31,4002,101,15290,1,451,84,5446,48,7360,85,12806,California
Tehama,2021-03-30,433,20176,255,4257,176,15466,2,453,287,5589,146,7506,289,13095,California
Tehama,2021-03-31,428,20604,320,4577,105,15571,3,456,346,5856,81,7587,348,13443,California
Tehama,2021-04-01,570,21174,274,4851,291,15862,5,461,426,6144,143,7730,431,13874,California
Tehama,2021-04-02,505,21679,243,5094,253,16115,9,470,307,6261,198,7928,315,14189,California
Tehama,2021-04-03,79,21758,11,5105,60,16175,8,478,40,6270,39,7967,48,14237,California
Tehama,2021-04-04,40,21798,9,5114,28,16203,3,481,27,6287,13,7980,30,14267,California
Tehama,2021-04-05,132,21930,21,5135,75,16278,36,517,64,6319,68,8048,100,14367,California
Tehama,2021-04-06,555,22485,119,5254,373,16651,63,580,148,6122,407,8455,210,14577,California
Tehama,2021-04-07,459,22944,311,5565,94,16745,54,634,329,6374,129,8584,381,14958,California
Tehama,2021-04-08,664,23608,195,5760,424,17169,45,679,247,6249,416,9000,291,15249,California
Tehama,2021-04-09,498,24106,236,5996,220,17389,42,721,254,6302,243,9243,296,15545,California
Tehama,2021-04-10,106,24212,28,6024,42,17431,36,757,52,6336,54,9297,88,15633,California
Tehama,2021-04-11,50,24262,12,6036,27,17458,11,768,11,6319,39,9336,22,15655,California
Tehama,2021-04-12,124,24386,6,6042,95,17553,23,791,44,6306,80,9416,67,15722,California
Tehama,2021-04-13,426,24812,75,6117,351,17904,0,791,69,6019,356,9772,69,15791,California
Tehama,2021-04-14,443,25255,58,6175,385,18289,0,791,53,5684,388,10160,53,15844,California
Tehama,2021-04-15,566,25821,209,6384,357,18646,0,791,80,5279,485,10645,80,15924,California
Tehama,2021-04-16,684,26505,398,6782,286,18932,0,791,92,4779,592,11237,92,16016,California
Tehama,2021-04-17,391,26896,300,7082,91,19023,0,791,52,4494,338,11575,53,16069,California
Tehama,2021-04-18,22,26918,8,7090,14,19037,0,791,14,4500,8,11583,14,16083,California
Tehama,2021-04-19,114,27032,8,7098,106,19143,0,791,49,4484,65,11648,49,16132,California
Tehama,2021-04-20,592,27624,492,7590,100,19243,0,791,172,4240,418,12066,174,16306,California
Tehama,2021-04-21,552,28176,463,8053,89,19332,0,791,179,4048,371,12437,179,16485,California
Tehama,2021-04-22,566,28742,396,8449,170,19502,0,791,163,3811,400,12837,163,16648,California
Tehama,2021-04-23,501,29243,384,8833,117,19619,0,791,217,3746,283,13120,218,16866,California
Tehama,2021-04-24,118,29361,23,8856,95,19714,0,791,27,3682,91,13211,27,16893,California
Tehama,2021-04-25,32,29393,21,8877,11,19725,0,791,9,3669,22,13233,9,16902,California
Tehama,2021-04-26,100,29493,14,8891,86,19811,0,791,56,3681,44,13277,56,16958,California
Tehama,2021-04-27,283,29776,225,9116,55,19866,3,794,107,3615,176,13453,110,17068,California
Tehama,2021-04-28,431,30207,352,9468,60,19926,19,813,74,3351,357,13810,93,17161,California
Tehama,2021-04-29,400,30607,189,9657,203,20129,8,821,77,3114,322,14132,85,17246,California
Tehama,2021-04-30,390,30997,290,9947,93,20222,7,828,131,2993,259,14391,138,17384,California
Tehama,2021-05-01,85,31082,7,9954,72,20294,6,834,19,2953,65,14456,25,17409,California
Tehama,2021-05-02,45,31127,23,9977,10,20304,12,846,25,2970,20,14476,37,17446,California
Tehama,2021-05-03,132,31259,44,10021,77,20381,11,857,66,2982,65,14541,77,17523,California
Tehama,2021-05-04,178,31437,63,10084,106,20487,9,866,75,2965,101,14642,84,17607,California
Tehama,2021-05-05,106,31543,30,10114,65,20552,11,877,48,2967,57,14699,59,17666,California
Tehama,2021-05-06,183,31726,98,10212,66,20618,19,896,113,3029,70,14769,132,17798,California
Tehama,2021-05-07,202,31928,88,10300,102,20720,12,908,58,2957,142,14911,70,17868,California
Tehama,2021-05-08,57,31985,9,10309,46,20766,2,910,17,2936,40,14951,19,17887,California
Tehama,2021-05-09,19,32004,5,10314,14,20780,0,910,8,2933,11,14962,8,17895,California
Tehama,2021-05-10,87,32091,7,10321,71,20851,9,919,40,2935,46,15008,48,17943,California
Tehama,2021-05-11,209,32300,138,10459,55,20906,16,935,41,2824,168,15176,57,18000,California
Tehama,2021-05-12,222,32522,139,10598,72,20978,11,946,51,2716,170,15346,62,18062,California
Tehama,2021-05-13,259,32781,172,10770,76,21054,11,957,117,2703,141,15487,128,18190,California
Tehama,2021-05-14,260,33041,144,10914,95,21149,21,978,61,2587,198,15685,82,18272,California
Tehama,2021-05-15,246,33287,144,11058,61,21210,41,1019,171,2725,74,15759,212,18484,California
Tehama,2021-05-16,30,33317,8,11066,19,21229,3,1022,18,2734,12,15771,21,18505,California
Tehama,2021-05-17,130,33447,35,11101,78,21307,17,1039,61,2744,68,15839,78,18583,California
Tehama,2021-05-18,161,33608,83,11184,63,21370,15,1054,51,2701,109,15948,66,18649,California
Tehama,2021-05-19,138,33746,62,11246,65,21435,11,1065,46,2666,92,16040,57,18706,California
Tehama,2021-05-20,347,34093,253,11499,71,21506,23,1088,242,2827,104,16144,265,18971,California
Tehama,2021-05-21,247,34340,117,11616,117,21623,13,1101,82,2760,162,16306,95,19066,California
Tehama,2021-05-22,69,34409,35,11651,30,21653,4,1105,40,2775,29,16335,44,19110,California
Tehama,2021-05-23,54,34463,25,11676,15,21668,14,1119,14,2763,40,16375,28,19138,California
Tehama,2021-05-24,109,34572,33,11709,67,21735,9,1128,35,2733,74,16449,44,19182,California
Tehama,2021-05-25,84,34656,22,11731,54,21789,8,1136,48,2753,35,16484,55,19237,California
Tehama,2021-05-26,82,34738,34,11765,45,21834,3,1139,54,2782,28,16512,57,19294,California
Tehama,2021-05-27,168,34906,103,11868,61,21895,4,1143,55,2730,111,16623,59,19353,California
Tehama,2021-05-28,149,35055,40,11908,100,21995,9,1152,71,2733,77,16700,80,19433,California
Tehama,2021-05-29,56,35111,9,11917,42,22037,5,1157,34,2750,22,16722,39,19472,California
Tehama,2021-05-30,16,35127,5,11922,10,22047,1,1158,7,2749,9,16731,8,19480,California
Tehama,2021-05-31,18,35145,2,11924,15,22062,1,1159,5,2742,13,16744,6,19486,California
Tehama,2021-06-01,107,35252,19,11943,67,22129,21,1180,34,2725,72,16816,55,19541,California
Tehama,2021-06-02,95,35347,32,11975,58,22187,5,1185,36,2707,59,16875,41,19582,California
Tehama,2021-06-03,145,35492,104,12079,28,22215,13,1198,31,2637,114,16989,44,19626,California
Tehama,2021-06-04,158,35650,41,12120,101,22316,16,1214,65,2624,92,17081,79,19705,California
Tehama,2021-06-05,170,35820,138,12258,24,22340,8,1222,32,2527,137,17218,40,19745,California
Tehama,2021-06-06,17,35837,9,12267,2,22342,6,1228,3,2522,13,17231,8,19753,California
Tehama,2021-06-07,78,35915,30,12297,46,22388,2,1230,22,2490,56,17287,24,19777,California
Tehama,2021-06-08,110,36025,34,12331,66,22454,10,1240,39,2470,69,17356,49,19826,California
Tehama,2021-06-09,98,36123,49,12380,46,22500,3,1243,44,2463,54,17410,47,19873,California
Tehama,2021-06-10,276,36399,225,12605,41,22541,10,1253,38,2274,237,17647,48,19921,California
Tehama,2021-06-11,158,36557,72,12677,77,22618,9,1262,57,2242,98,17745,66,19987,California
Tehama,2021-06-12,66,36623,41,12718,25,22643,0,1262,27,2230,39,17784,27,20014,California
Tehama,2021-06-13,23,36646,6,12724,11,22654,6,1268,5,2223,18,17802,11,20025,California
Tehama,2021-06-14,99,36745,19,12743,72,22726,8,1276,31,2194,68,17870,39,20064,California
Tehama,2021-06-15,117,36862,58,12801,39,22765,20,1296,51,2200,65,17935,71,20135,California
Tehama,2021-06-16,97,36959,65,12866,29,22794,3,1299,49,2204,48,17983,52,20187,California
Tehama,2021-06-17,156,37115,111,12977,29,22823,16,1315,88,2241,66,18049,103,20290,California
Tehama,2021-06-18,110,37225,44,13021,51,22874,15,1330,38,2222,72,18121,53,20343,California
Tehama,2021-06-19,41,37266,15,13036,21,22895,5,1335,18,2222,23,18144,23,20366,California
Tehama,2021-06-20,16,37282,5,13041,10,22905,1,1336,6,2219,10,18154,7,20373,California
Tehama,2021-06-21,69,37351,19,13060,41,22946,9,1345,26,2211,43,18197,35,20408,California
Tehama,2021-06-22,82,37433,26,13086,42,22988,14,1359,34,2212,47,18244,48,20456,California
Tehama,2021-06-23,99,37532,57,13143,38,23026,4,1363,48,2214,49,18293,51,20507,California
Tehama,2021-06-24,90,37622,44,13187,38,23064,8,1371,49,2230,41,18334,57,20564,California
Tehama,2021-06-25,139,37761,75,13262,57,23121,7,1378,60,2219,78,18412,67,20631,California
Tehama,2021-06-26,46,37807,23,13285,23,23144,0,1378,22,2217,24,18436,22,20653,California
Tehama,2021-06-27,7,37814,3,13288,3,23147,1,1379,4,2219,3,18439,5,20658,California
Tehama,2021-06-28,45,37859,17,13305,22,23169,6,1385,23,2226,22,18461,29,20687,California
Tehama,2021-06-29,70,37929,27,13332,39,23208,4,1389,37,2235,32,18493,41,20728,California
Tehama,2021-06-30,92,38021,67,13399,23,23231,2,1391,47,2239,45,18538,49,20777,California
Tehama,2021-07-01,65,38086,32,13431,30,23261,3,1394,40,2257,25,18563,43,20820,California
Tehama,2021-07-02,95,38181,49,13480,44,23305,2,1396,41,2246,54,18617,43,20863,California
Tehama,2021-07-03,38,38219,19,13499,17,23322,2,1398,13,2236,25,18642,15,20878,California
Tehama,2021-07-04,6,38225,6,13505,0,23322,0,1398,3,2236,3,18645,3,20881,California
Tehama,2021-07-05,31,38256,13,13518,16,23338,2,1400,13,2233,18,18663,15,20896,California
Tehama,2021-07-06,94,38350,53,13571,34,23372,7,1407,36,2218,58,18721,43,20939,California
Tehama,2021-07-07,97,38447,73,13644,20,23392,4,1411,39,2203,58,18779,43,20982,California
Tehama,2021-07-08,131,38578,90,13734,34,23426,7,1418,36,2151,95,18874,43,21025,California
Tehama,2021-07-09,99,38677,60,13794,34,23460,5,1423,46,2149,53,18927,51,21076,California
Tehama,2021-07-10,27,38704,17,13811,10,23470,0,1423,12,2146,15,18942,12,21088,California
Tehama,2021-07-11,17,38721,8,13819,9,23479,0,1423,11,2151,6,18948,11,21099,California
Tehama,2021-07-12,49,38770,22,13841,19,23498,8,1431,23,2156,26,18974,31,21130,California
Tehama,2021-07-13,49,38819,18,13859,24,23522,7,1438,19,2152,30,19004,26,21156,California
Tehama,2021-07-14,104,38923,84,13943,20,23542,0,1438,40,2128,64,19068,40,21196,California
Tehama,2021-07-15,44,38967,21,13964,20,23562,3,1441,20,2127,24,19092,23,21219,California
Tehama,2021-07-16,77,39044,35,13999,36,23598,6,1447,43,2142,34,19126,49,21268,California
Tehama,2021-07-17,43,39087,23,14022,18,23616,2,1449,21,2143,22,19148,23,21291,California
Tehama,2021-07-18,13,39100,8,14030,5,23621,0,1449,4,2139,8,19156,4,21295,California
Tehama,2021-07-19,67,39167,32,14062,30,23651,5,1454,40,2157,27,19183,45,21340,California
Tehama,2021-07-20,78,39245,39,14101,37,23688,2,1456,42,2165,36,19219,44,21384,California
Tehama,2021-07-21,112,39357,82,14183,29,23717,1,1457,63,2181,48,19267,64,21448,California
Tehama,2021-07-22,91,39448,49,14232,34,23751,8,1465,51,2201,39,19306,59,21507,California
Tehama,2021-07-23,99,39547,44,14276,50,23801,5,1470,64,2236,34,19340,69,21576,California
Tehama,2021-07-24,23,39570,8,14284,15,23816,0,1470,18,2249,5,19345,18,21594,California
Tehama,2021-07-25,19,39589,4,14288,15,23831,0,1470,16,2262,3,19348,16,21610,California
Tehama,2021-07-26,98,39687,45,14333,43,23874,10,1480,53,2280,45,19393,63,21673,California
Tehama,2021-07-27,96,39783,41,14374,50,23924,5,1485,50,2291,44,19437,55,21728,California
Tehama,2021-07-28,109,39892,76,14450,30,23954,3,1488,68,2321,41,19478,71,21799,California
Tehama,2021-07-29,107,39999,55,14505,44,23998,8,1496,69,2360,38,19516,77,21876,California
Tehama,2021-07-30,119,40118,61,14566,56,24054,2,1498,68,2378,51,19567,69,21945,California
Tehama,2021-07-31,18,40136,5,14571,13,24067,0,1498,8,2376,10,19577,8,21953,California
Trinity,2020-12-17,4,4,4,4,0,0,0,0,4,4,0,0,4,4,California
Trinity,2020-12-18,2,6,2,6,0,0,0,0,2,6,0,0,2,6,California
Trinity,2020-12-21,38,44,38,44,0,0,0,0,38,44,0,0,38,44,California
Trinity,2020-12-22,4,48,4,48,0,0,0,0,4,48,0,0,4,48,California
Trinity,2020-12-23,6,54,5,53,1,1,0,0,6,54,0,0,6,54,California
Trinity,2020-12-28,30,84,30,83,0,1,0,0,30,84,0,0,30,84,California
Trinity,2020-12-29,8,92,7,90,1,2,0,0,8,92,0,0,8,92,California
Trinity,2020-12-30,10,102,8,98,2,4,0,0,10,102,0,0,10,102,California
Trinity,2020-12-31,2,104,1,99,1,5,0,0,2,104,0,0,2,104,California
Trinity,2021-01-04,27,131,0,99,27,32,0,0,26,130,0,0,26,130,California
Trinity,2021-01-05,2,133,1,100,1,33,0,0,2,132,0,0,2,132,California
Trinity,2021-01-06,24,157,4,104,20,53,0,0,20,148,4,4,20,152,California
Trinity,2021-01-08,49,206,2,106,47,100,0,0,48,194,2,6,48,200,California
Trinity,2021-01-11,41,247,38,144,3,103,0,0,4,161,37,43,4,204,California
Trinity,2021-01-12,10,257,6,150,4,107,0,0,5,161,5,48,5,209,California
Trinity,2021-01-13,7,264,4,154,3,110,0,0,4,162,3,51,4,213,California
Trinity,2021-01-14,4,268,1,155,3,113,0,0,4,166,0,51,4,217,California
Trinity,2021-01-15,5,273,0,155,5,118,0,0,5,171,0,51,5,222,California
Trinity,2021-01-16,2,275,0,155,2,120,0,0,2,173,0,51,2,224,California
Trinity,2021-01-18,31,306,31,186,0,120,0,0,1,144,30,81,1,225,California
Trinity,2021-01-19,35,341,15,201,20,140,0,0,21,151,14,95,21,246,California
Trinity,2021-01-20,21,362,4,205,17,157,0,0,18,166,3,98,18,264,California
Trinity,2021-01-21,17,379,7,212,10,167,0,0,17,183,0,98,17,281,California
Trinity,2021-01-22,5,384,1,213,4,171,0,0,5,188,0,98,5,286,California
Trinity,2021-01-23,7,391,3,216,4,175,0,0,7,195,0,98,7,293,California
Trinity,2021-01-25,14,405,1,217,13,188,0,0,13,207,1,99,13,306,California
Trinity,2021-01-26,12,417,1,218,11,199,0,0,11,217,1,100,11,317,California
Trinity,2021-01-27,12,429,0,218,12,211,0,0,12,229,0,100,12,329,California
Trinity,2021-01-28,12,441,2,220,10,221,0,0,9,235,3,103,9,338,California
Trinity,2021-01-29,3,444,0,220,3,224,0,0,2,236,1,104,2,340,California
Trinity,2021-01-30,12,456,11,231,1,225,0,0,12,248,0,104,12,352,California
Trinity,2021-02-01,2,458,1,232,1,226,0,0,1,248,1,105,1,353,California
Trinity,2021-02-02,15,473,3,235,12,238,0,0,14,261,1,106,14,367,California
Trinity,2021-02-03,6,479,1,236,5,243,0,0,4,263,2,108,4,371,California
Trinity,2021-02-04,40,519,31,267,9,252,0,0,33,289,7,115,33,404,California
Trinity,2021-02-05,353,872,0,267,353,605,0,0,322,580,31,146,322,726,California
Trinity,2021-02-06,209,1081,5,272,204,809,0,0,202,775,7,153,202,928,California
Trinity,2021-02-07,1,1082,0,272,1,810,0,0,1,776,0,153,1,929,California
Trinity,2021-02-08,29,1111,2,274,27,837,0,0,16,779,13,166,16,945,California
Trinity,2021-02-09,28,1139,2,276,26,863,0,0,10,771,18,184,10,955,California
Trinity,2021-02-10,121,1260,10,286,111,974,0,0,101,852,20,204,101,1056,California
Trinity,2021-02-11,336,1596,2,288,334,1308,0,0,329,1174,7,211,329,1385,California
Trinity,2021-02-12,18,1614,10,298,8,1316,0,0,13,1182,5,216,13,1398,California
Trinity,2021-02-13,11,1625,6,304,5,1321,0,0,6,1183,5,221,6,1404,California
Trinity,2021-02-14,2,1627,2,306,0,1321,0,0,2,1185,0,221,2,1406,California
Trinity,2021-02-15,46,1673,0,306,46,1367,0,0,46,1231,0,221,46,1452,California
Trinity,2021-02-16,6,1679,1,307,5,1372,0,0,4,1233,2,223,4,1456,California
Trinity,2021-02-17,93,1772,2,309,91,1463,0,0,83,1306,10,233,83,1539,California
Trinity,2021-02-18,3,1775,0,309,3,1466,0,0,1,1305,2,235,1,1540,California
Trinity,2021-02-19,312,2087,1,310,311,1777,0,0,299,1591,13,248,299,1839,California
Trinity,2021-02-20,143,2230,14,324,129,1906,0,0,115,1678,28,276,115,1954,California
Trinity,2021-02-21,1,2231,1,325,0,1906,0,0,1,1679,0,276,1,1955,California
Trinity,2021-02-22,8,2239,0,325,8,1914,0,0,5,1681,3,279,5,1960,California
Trinity,2021-02-23,12,2251,3,328,9,1923,0,0,5,1679,7,286,5,1965,California
Trinity,2021-02-24,30,2281,8,336,22,1945,0,0,7,1663,23,309,7,1972,California
Trinity,2021-02-25,39,2320,25,361,14,1959,0,0,5,1634,34,343,5,1977,California
Trinity,2021-02-26,13,2333,2,363,11,1970,0,0,6,1633,7,350,6,1983,California
Trinity,2021-02-27,12,2345,10,373,2,1972,0,0,6,1633,6,356,6,1989,California
Trinity,2021-03-01,11,2356,1,374,10,1982,0,0,5,1632,6,362,5,1994,California
Trinity,2021-03-02,9,2365,3,377,6,1988,0,0,2,1627,7,369,2,1996,California
Trinity,2021-03-03,4,2369,0,377,4,1992,0,0,3,1629,1,370,3,1999,California
Trinity,2021-03-04,24,2393,20,397,4,1996,0,0,10,1625,14,384,10,2009,California
Trinity,2021-03-05,391,2784,1,398,390,2386,0,0,120,1478,267,651,120,2129,California
Trinity,2021-03-06,200,2984,6,404,194,2580,0,0,26,1330,174,825,26,2155,California
Trinity,2021-03-07,6,2990,3,407,2,2582,1,1,3,1331,3,828,4,2159,California
Trinity,2021-03-08,5,2995,1,408,3,2585,1,2,2,1331,3,831,3,2162,California
Trinity,2021-03-09,99,3094,1,409,96,2681,2,4,93,1420,6,837,95,2257,California
Trinity,2021-03-10,125,3219,3,412,119,2800,3,7,38,1374,87,924,41,2298,California
Trinity,2021-03-11,15,3234,3,415,10,2810,2,9,4,1369,11,935,6,2304,California
Trinity,2021-03-12,397,3631,5,420,386,3196,6,15,98,1174,299,1234,104,2408,California
Trinity,2021-03-13,13,3644,7,427,4,3200,2,17,7,1177,6,1240,9,2417,California
Trinity,2021-03-14,4,3648,1,428,3,3203,0,17,3,1179,1,1241,3,2420,California
Trinity,2021-03-15,67,3715,0,428,66,3269,1,18,15,1143,52,1293,16,2436,California
Trinity,2021-03-16,117,3832,7,435,110,3379,0,18,104,1234,13,1306,104,2540,California
Trinity,2021-03-17,99,3931,3,438,96,3475,0,18,26,1187,73,1379,26,2566,California
Trinity,2021-03-18,13,3944,3,441,7,3482,3,21,6,1189,7,1386,9,2575,California
Trinity,2021-03-19,463,4407,4,445,349,3831,110,131,33,902,430,1816,143,2718,California
Trinity,2021-03-20,110,4517,7,452,103,3934,0,131,70,933,39,1855,70,2788,California
Trinity,2021-03-21,5,4522,0,452,3,3937,2,133,3,936,2,1857,5,2793,California
Trinity,2021-03-22,2,4524,0,452,2,3939,0,133,2,938,0,1857,2,2795,California
Trinity,2021-03-23,96,4620,2,454,93,4032,1,134,78,999,18,1875,79,2874,California
Trinity,2021-03-24,12,4632,1,455,11,4043,0,134,9,1005,3,1878,9,2883,California
Trinity,2021-03-25,111,4743,8,463,97,4140,6,140,85,1070,26,1904,91,2974,California
Trinity,2021-03-26,84,4827,8,471,76,4216,0,140,77,1140,7,1911,77,3051,California
Trinity,2021-03-27,19,4846,3,474,7,4223,9,149,9,1148,10,1921,18,3069,California
Trinity,2021-03-28,5,4851,3,477,2,4225,0,149,1,1145,4,1925,1,3070,California
Trinity,2021-03-29,6,4857,1,478,5,4230,0,149,2,1143,4,1929,2,3072,California
Trinity,2021-03-30,79,4936,7,485,72,4302,0,149,68,1200,11,1940,68,3140,California
Trinity,2021-03-31,55,4991,5,490,18,4320,32,181,20,1216,35,1975,51,3191,California
Trinity,2021-04-01,41,5032,10,500,20,4340,11,192,22,1230,19,1994,33,3224,California
Trinity,2021-04-02,261,5293,6,506,180,4520,75,267,87,1219,173,2167,162,3386,California
Trinity,2021-04-03,18,5311,13,519,5,4525,0,267,8,1217,10,2177,8,3394,California
Trinity,2021-04-04,10,5321,8,527,2,4527,0,267,8,1223,2,2179,8,3402,California
Trinity,2021-04-05,60,5381,6,533,51,4578,3,270,53,1273,6,2185,56,3458,California
Trinity,2021-04-06,123,5504,15,548,105,4683,3,273,30,1212,93,2278,32,3490,California
Trinity,2021-04-07,26,5530,11,559,10,4693,5,278,19,1229,7,2285,24,3514,California
Trinity,2021-04-08,91,5621,12,571,77,4770,2,280,53,1246,38,2323,55,3569,California
Trinity,2021-04-09,168,5789,18,589,146,4916,4,284,90,1262,78,2401,94,3663,California
Trinity,2021-04-10,12,5801,7,596,5,4921,0,284,11,1272,1,2402,11,3674,California
Trinity,2021-04-11,10,5811,5,601,3,4924,2,286,4,1272,6,2408,6,3680,California
Trinity,2021-04-12,78,5889,5,606,72,4996,1,287,64,1323,13,2421,64,3744,California
Trinity,2021-04-13,106,5995,6,612,100,5096,0,287,12,1241,94,2515,12,3756,California
Trinity,2021-04-14,10,6005,5,617,5,5101,0,287,6,1243,4,2519,6,3762,California
Trinity,2021-04-15,45,6050,10,627,35,5136,0,287,15,1229,29,2548,15,3777,California
Trinity,2021-04-16,162,6212,14,641,148,5284,0,287,86,1241,74,2622,86,3863,California
Trinity,2021-04-17,11,6223,5,646,6,5290,0,287,9,1248,2,2624,9,3872,California
Trinity,2021-04-18,3,6226,1,647,2,5292,0,287,0,1245,3,2627,0,3872,California
Trinity,2021-04-19,67,6293,2,649,65,5357,0,287,66,1310,1,2628,66,3938,California
Trinity,2021-04-20,95,6388,8,657,87,5444,0,287,21,1257,74,2702,21,3959,California
Trinity,2021-04-21,22,6410,9,666,13,5457,0,287,9,1253,13,2715,9,3968,California
Trinity,2021-04-22,93,6503,5,671,88,5545,0,287,14,1188,79,2794,14,3982,California
Trinity,2021-04-23,182,6685,6,677,176,5721,0,287,112,1230,70,2864,112,4094,California
Trinity,2021-04-24,26,6711,15,692,11,5732,0,287,7,1218,19,2883,7,4101,California
Trinity,2021-04-25,10,6721,9,701,1,5733,0,287,3,1215,6,2889,3,4104,California
Trinity,2021-04-26,49,6770,9,710,40,5773,0,287,41,1248,8,2897,41,4145,California
Trinity,2021-04-27,87,6857,12,722,75,5848,0,287,23,1207,64,2961,23,4168,California
Trinity,2021-04-28,32,6889,11,733,21,5869,0,287,12,1199,20,2981,12,4180,California
Trinity,2021-04-29,36,6925,13,746,23,5892,0,287,12,1187,24,3005,12,4192,California
Trinity,2021-04-30,26,6951,21,767,5,5897,0,287,10,1182,15,3020,10,4202,California
Trinity,2021-05-01,15,6966,8,775,2,5899,5,292,5,1182,10,3030,10,4212,California
Trinity,2021-05-02,8,6974,5,780,1,5900,2,294,2,1180,6,3036,4,4216,California
Trinity,2021-05-03,57,7031,13,793,43,5943,1,295,9,1143,47,3083,10,4226,California
Trinity,2021-05-04,28,7059,11,804,16,5959,1,296,8,1132,20,3103,9,4235,California
Trinity,2021-05-05,11,7070,7,811,4,5963,0,296,4,1129,7,3110,4,4239,California
Trinity,2021-05-06,77,7147,11,822,63,6026,3,299,16,1087,61,3171,19,4258,California
Trinity,2021-05-07,183,7330,13,835,136,6162,34,333,15,968,168,3339,49,4307,California
Trinity,2021-05-08,7,7337,2,837,5,6167,0,333,2,965,5,3344,2,4309,California
Trinity,2021-05-09,11,7348,8,845,3,6170,0,333,7,968,4,3348,7,4316,California
Trinity,2021-05-10,14,7362,4,849,9,6179,1,334,7,969,7,3355,8,4324,California
Trinity,2021-05-11,8,7370,4,853,4,6183,0,334,6,973,2,3357,6,4330,California
Trinity,2021-05-12,19,7389,16,869,2,6185,1,335,14,983,5,3362,15,4345,California
Trinity,2021-05-13,15,7404,10,879,4,6189,1,336,9,987,6,3368,10,4355,California
Trinity,2021-05-14,145,7549,19,898,98,6287,28,364,39,948,106,3474,67,4422,California
Trinity,2021-05-15,17,7566,12,910,4,6291,1,365,8,949,8,3482,9,4431,California
Trinity,2021-05-16,8,7574,6,916,2,6293,0,365,6,953,2,3484,6,4437,California
Trinity,2021-05-17,108,7682,20,936,86,6379,2,367,42,931,66,3550,44,4481,California
Trinity,2021-05-18,38,7720,8,944,29,6408,1,368,11,916,27,3577,12,4493,California
Trinity,2021-05-19,149,7869,17,961,103,6511,29,397,29,855,119,3696,58,4551,California
Trinity,2021-05-20,28,7897,21,982,4,6515,3,400,17,864,11,3707,20,4571,California
Trinity,2021-05-21,21,7918,14,996,7,6522,0,400,12,867,9,3716,12,4583,California
Trinity,2021-05-22,17,7935,14,1010,3,6525,0,400,13,876,4,3720,13,4596,California
Trinity,2021-05-23,6,7941,4,1014,2,6527,0,400,2,874,4,3724,2,4598,California
Trinity,2021-05-24,110,8051,12,1026,97,6624,1,401,9,784,100,3824,10,4608,California
Trinity,2021-05-25,39,8090,14,1040,25,6649,0,401,17,779,22,3846,17,4625,California
Trinity,2021-05-26,12,8102,6,1046,6,6655,0,401,4,775,8,3854,4,4629,California
Trinity,2021-05-27,31,8133,14,1060,12,6667,5,406,8,765,23,3877,13,4642,California
Trinity,2021-05-28,16,8149,11,1071,4,6671,1,407,9,768,7,3884,10,4652,California
Trinity,2021-05-29,10,8159,7,1078,2,6673,1,408,7,773,3,3887,8,4660,California
Trinity,2021-05-30,6,8165,5,1083,1,6674,0,408,0,767,6,3893,0,4660,California
Trinity,2021-05-31,4,8169,3,1086,1,6675,0,408,2,767,2,3895,2,4662,California
Trinity,2021-06-01,14,8183,7,1093,5,6680,2,410,3,762,10,3905,5,4667,California
Trinity,2021-06-02,23,8206,18,1111,3,6683,2,412,8,757,15,3920,10,4677,California
Trinity,2021-06-03,39,8245,13,1124,26,6709,0,412,13,744,26,3946,13,4690,California
Trinity,2021-06-04,46,8291,21,1145,17,6726,8,420,12,730,34,3980,20,4710,California
Trinity,2021-06-05,19,8310,18,1163,1,6727,0,420,13,737,6,3986,13,4723,California
Trinity,2021-06-06,9,8319,6,1169,2,6729,1,421,2,733,7,3993,3,4726,California
Trinity,2021-06-07,30,8349,19,1188,10,6739,1,422,14,732,16,4009,15,4741,California
Trinity,2021-06-08,16,8365,13,1201,1,6740,2,424,4,726,12,4021,6,4747,California
Trinity,2021-06-09,31,8396,14,1215,1,6741,16,440,5,721,26,4047,21,4768,California
Trinity,2021-06-10,28,8424,19,1234,3,6744,6,446,7,713,21,4068,13,4781,California
Trinity,2021-06-11,46,8470,10,1244,33,6777,3,449,14,698,31,4099,16,4797,California
Trinity,2021-06-12,19,8489,10,1254,1,6778,8,457,4,695,15,4114,12,4809,California
Trinity,2021-06-13,4,8493,4,1258,0,6778,0,457,1,693,3,4117,1,4810,California
Trinity,2021-06-14,43,8536,16,1274,27,6805,0,457,11,672,32,4149,11,4821,California
Trinity,2021-06-15,56,8592,21,1295,12,6817,23,480,15,668,41,4190,37,4858,California
Trinity,2021-06-16,14,8606,6,1301,5,6822,3,483,4,665,10,4200,7,4865,California
Trinity,2021-06-17,19,8625,12,1313,1,6823,6,489,6,665,12,4212,12,4877,California
Trinity,2021-06-18,21,8646,11,1324,7,6830,3,492,6,659,15,4227,9,4886,California
Trinity,2021-06-19,14,8660,9,1333,2,6832,3,495,3,654,11,4238,6,4892,California
Trinity,2021-06-20,3,8663,3,1336,0,6832,0,495,3,657,0,4238,3,4895,California
Trinity,2021-06-21,9,8672,6,1342,1,6833,2,497,6,662,3,4241,8,4903,California
Trinity,2021-06-22,33,8705,9,1351,14,6847,10,507,14,667,19,4260,24,4927,California
Trinity,2021-06-23,15,8720,7,1358,2,6849,6,513,3,664,12,4272,9,4936,California
Trinity,2021-06-24,25,8745,15,1373,4,6853,6,519,16,677,9,4281,22,4958,California
Trinity,2021-06-25,10,8755,9,1382,0,6853,1,520,6,679,4,4285,6,4964,California
Trinity,2021-06-26,18,8773,18,1400,0,6853,0,520,8,677,10,4295,8,4972,California
Trinity,2021-06-27,4,8777,4,1404,0,6853,0,520,0,673,4,4299,0,4972,California
Trinity,2021-06-28,11,8788,9,1413,1,6854,1,521,4,671,7,4306,5,4977,California
Trinity,2021-06-29,11,8799,5,1418,3,6857,3,524,5,673,6,4312,8,4985,California
Trinity,2021-06-30,14,8813,10,1428,1,6858,3,527,6,674,8,4320,9,4994,California
Trinity,2021-07-01,31,8844,12,1440,12,6870,7,534,10,670,21,4341,17,5011,California
Trinity,2021-07-02,24,8868,6,1446,6,6876,12,546,6,670,18,4359,18,5029,California
Trinity,2021-07-03,4,8872,1,1447,0,6876,3,549,0,669,4,4363,3,5032,California
Trinity,2021-07-04,2,8874,1,1448,1,6877,0,549,1,669,1,4364,1,5033,California
Trinity,2021-07-05,13,8887,12,1460,1,6878,0,549,6,668,7,4371,6,5039,California
Trinity,2021-07-06,12,8899,10,1470,2,6880,0,549,6,668,6,4377,6,5045,California
Trinity,2021-07-07,13,8912,9,1479,1,6881,3,552,6,670,7,4384,9,5054,California
Trinity,2021-07-08,16,8928,7,1486,2,6883,7,559,3,666,13,4397,9,5063,California
Trinity,2021-07-09,24,8952,8,1494,14,6897,2,561,8,660,16,4413,10,5073,California
Trinity,2021-07-10,9,8961,6,1500,3,6900,0,561,7,665,2,4415,7,5080,California
Trinity,2021-07-11,7,8968,4,1504,0,6900,3,564,4,669,3,4418,7,5087,California
Trinity,2021-07-12,34,9002,11,1515,22,6922,1,565,9,654,25,4443,10,5097,California
Trinity,2021-07-13,17,9019,11,1526,6,6928,0,565,8,653,9,4452,8,5105,California
Trinity,2021-07-14,14,9033,7,1533,1,6929,6,571,5,655,9,4461,11,5116,California
Trinity,2021-07-15,17,9050,13,1546,2,6931,2,573,7,654,10,4471,9,5125,California
Trinity,2021-07-16,11,9061,7,1553,2,6933,2,575,3,651,8,4479,5,5130,California
Trinity,2021-07-17,22,9083,7,1560,7,6940,8,583,6,649,16,4495,14,5144,California
Trinity,2021-07-18,2,9085,2,1562,0,6940,0,583,2,651,0,4495,2,5146,California
Trinity,2021-07-19,12,9097,12,1574,0,6940,0,583,11,661,1,4496,11,5157,California
Trinity,2021-07-20,35,9132,8,1582,23,6963,4,587,20,670,15,4511,24,5181,California
Trinity,2021-07-21,13,9145,9,1591,3,6966,1,588,7,673,5,4516,8,5189,California
Trinity,2021-07-22,22,9167,12,1603,8,6974,2,590,9,671,13,4529,11,5200,California
Trinity,2021-07-23,22,9189,17,1620,2,6976,3,593,15,682,7,4536,18,5218,California
Trinity,2021-07-24,16,9205,11,1631,0,6976,5,598,9,689,7,4543,14,5232,California
Trinity,2021-07-25,3,9208,1,1632,1,6977,1,599,1,689,2,4545,2,5234,California
Trinity,2021-07-26,11,9219,10,1642,1,6978,0,599,10,698,1,4546,10,5244,California
Trinity,2021-07-27,40,9259,27,1669,4,6982,9,608,20,707,20,4566,29,5273,California
Trinity,2021-07-28,38,9297,21,1690,7,6989,10,618,15,709,23,4589,25,5298,California
Trinity,2021-07-29,21,9318,8,1698,2,6991,11,629,9,717,12,4601,20,5318,California
Trinity,2021-07-30,19,9337,15,1713,2,6993,2,631,7,715,11,4612,9,5327,California
Trinity,2021-07-31,9,9346,9,1722,0,6993,0,631,6,718,3,4615,6,5333,California
Tulare,2020-12-15,1,1,1,1,0,0,0,0,1,1,0,0,1,1,California
Tulare,2020-12-16,5,6,5,6,0,0,0,0,5,6,0,0,5,6,California
Tulare,2020-12-17,110,116,110,116,0,0,0,0,110,116,0,0,110,116,California
Tulare,2020-12-18,288,404,287,403,1,1,0,0,288,404,0,0,288,404,California
Tulare,2020-12-19,323,727,323,726,0,1,0,0,323,727,0,0,323,727,California
Tulare,2020-12-20,164,891,164,890,0,1,0,0,164,891,0,0,164,891,California
Tulare,2020-12-21,425,1316,425,1315,0,1,0,0,445,1336,0,0,445,1336,California
Tulare,2020-12-22,476,1792,475,1790,1,2,0,0,475,1811,0,0,475,1811,California
Tulare,2020-12-23,329,2121,320,2110,9,11,0,0,327,2138,0,0,327,2138,California
Tulare,2020-12-24,18,2139,16,2126,2,13,0,0,18,2156,0,0,18,2156,California
Tulare,2020-12-26,6,2145,5,2131,1,14,0,0,6,2162,0,0,6,2162,California
Tulare,2020-12-27,16,2161,12,2143,4,18,0,0,16,2178,0,0,16,2178,California
Tulare,2020-12-28,482,2643,469,2612,13,31,0,0,481,2659,0,0,481,2659,California
Tulare,2020-12-29,553,3196,481,3093,72,103,0,0,553,3212,0,0,553,3212,California
Tulare,2020-12-30,470,3666,427,3520,43,146,0,0,470,3682,0,0,470,3682,California
Tulare,2020-12-31,102,3768,24,3544,78,224,0,0,102,3784,0,0,102,3784,California
Tulare,2021-01-01,5,3773,1,3545,4,228,0,0,5,3789,0,0,5,3789,California
Tulare,2021-01-02,34,3807,20,3565,14,242,0,0,34,3823,0,0,34,3823,California
Tulare,2021-01-03,23,3830,9,3574,14,256,0,0,23,3846,0,0,23,3846,California
Tulare,2021-01-04,95,3925,17,3591,78,334,0,0,95,3941,0,0,95,3941,California
Tulare,2021-01-05,469,4394,280,3871,189,523,0,0,467,4406,2,2,467,4408,California
Tulare,2021-01-06,865,5259,634,4505,231,754,0,0,855,5251,10,12,855,5263,California
Tulare,2021-01-07,785,6044,588,5093,197,951,0,0,676,5818,109,121,676,5939,California
Tulare,2021-01-08,1281,7325,570,5663,711,1662,0,0,947,6432,333,454,947,6886,California
Tulare,2021-01-09,800,8125,201,5864,599,2261,0,0,614,6860,186,640,614,7500,California
Tulare,2021-01-10,53,8178,44,5908,9,2270,0,0,15,6837,38,678,15,7515,California
Tulare,2021-01-11,1278,9456,775,6683,503,2773,0,0,837,7233,441,1119,837,8352,California
Tulare,2021-01-12,1463,10919,515,7198,948,3721,0,0,1044,7861,418,1537,1046,9398,California
Tulare,2021-01-13,407,11326,177,7375,230,3951,0,0,333,8120,74,1611,333,9731,California
Tulare,2021-01-14,498,11824,148,7523,350,4301,0,0,472,8577,15,1626,472,10203,California
Tulare,2021-01-15,1669,13493,163,7686,1506,5807,0,0,1658,10224,11,1637,1658,11861,California
Tulare,2021-01-16,1946,15439,123,7809,1823,7630,0,0,1932,12142,14,1651,1932,13793,California
Tulare,2021-01-17,142,15581,122,7931,20,7650,0,0,132,12264,10,1661,132,13925,California
Tulare,2021-01-18,695,16276,659,8590,36,7686,0,0,296,12161,399,2060,296,14221,California
Tulare,2021-01-19,1034,17310,697,9287,337,8023,0,0,605,12337,429,2489,605,14826,California
Tulare,2021-01-20,2495,19805,665,9952,1830,9853,0,0,2058,14004,392,2881,2059,16885,California
Tulare,2021-01-21,1643,21448,234,10186,1409,11262,0,0,1614,15595,23,2904,1614,18499,California
Tulare,2021-01-22,1102,22550,212,10398,890,12152,0,0,1071,16636,30,2934,1071,19570,California
Tulare,2021-01-23,443,22993,156,10554,287,12439,0,0,422,17037,21,2955,422,19992,California
Tulare,2021-01-24,31,23024,28,10582,3,12442,0,0,29,17064,2,2957,29,20021,California
Tulare,2021-01-25,1360,24384,991,11573,369,12811,0,0,1307,18318,53,3010,1307,21328,California
Tulare,2021-01-26,1516,25900,1104,12677,412,13223,0,0,1173,19149,342,3352,1173,22501,California
Tulare,2021-01-27,1508,27408,1077,13754,431,13654,0,0,926,19494,581,3933,926,23427,California
Tulare,2021-01-28,1225,28633,779,14533,446,14100,0,0,822,19913,403,4336,822,24249,California
Tulare,2021-01-29,1134,29767,721,15254,413,14513,0,0,822,20423,312,4648,822,25071,California
Tulare,2021-01-30,1683,31450,1587,16841,96,14609,0,0,1659,22059,24,4672,1660,26731,California
Tulare,2021-01-31,66,31516,62,16903,4,14613,0,0,62,22117,4,4676,62,26793,California
Tulare,2021-02-01,1181,32697,901,17804,280,14893,0,0,814,22565,366,5042,814,27607,California
Tulare,2021-02-02,699,33396,342,18146,357,15250,0,0,441,22751,256,5298,442,28049,California
Tulare,2021-02-03,572,33968,234,18380,338,15588,0,0,330,22879,202,5500,330,28379,California
Tulare,2021-02-04,594,34562,184,18564,410,15998,0,0,287,22862,306,5806,289,28668,California
Tulare,2021-02-05,1248,35810,238,18802,1010,17008,0,0,405,22426,841,6647,405,29073,California
Tulare,2021-02-06,845,36655,165,18967,680,17688,0,0,210,22003,633,7280,210,29283,California
Tulare,2021-02-07,86,36741,72,19039,14,17702,0,0,24,21965,62,7342,24,29307,California
Tulare,2021-02-08,955,37696,334,19373,621,18323,0,0,242,21497,710,8052,242,29549,California
Tulare,2021-02-09,1440,39136,337,19710,1103,19426,0,0,357,20777,1077,9129,357,29906,California
Tulare,2021-02-10,2497,41633,1997,21707,500,19926,0,0,2089,22461,405,9534,2089,31995,California
Tulare,2021-02-11,1364,42997,383,22090,981,20907,0,0,886,22869,478,10012,886,32881,California
Tulare,2021-02-12,2812,45809,572,22662,2240,23147,0,0,1167,22400,1636,11648,1167,34048,California
Tulare,2021-02-13,2489,48298,157,22819,2332,25479,0,0,641,21198,1843,13491,641,34689,California
Tulare,2021-02-14,341,48639,39,22858,302,25781,0,0,304,21465,37,13528,304,34993,California
Tulare,2021-02-15,930,49569,294,23152,636,26417,0,0,665,21866,264,13792,665,35658,California
Tulare,2021-02-16,2876,52445,1606,24758,1270,27687,0,0,1102,21198,1771,15563,1103,36761,California
Tulare,2021-02-17,2736,55181,524,25282,2212,29899,0,0,458,19385,2271,17834,458,37219,California
Tulare,2021-02-18,2380,57561,458,25740,1922,31821,0,0,651,18317,1719,19553,651,37870,California
Tulare,2021-02-19,2369,59930,884,26624,1485,33306,0,0,973,17899,1391,20944,973,38843,California
Tulare,2021-02-20,3032,62962,1905,28529,1127,34433,0,0,1276,17427,1748,22692,1276,40119,California
Tulare,2021-02-21,102,63064,97,28626,5,34438,0,0,49,17426,50,22742,49,40168,California
Tulare,2021-02-22,1165,64229,740,29366,425,34863,0,0,217,16697,946,23688,217,40385,California
Tulare,2021-02-23,2049,66278,993,30359,1056,35919,0,0,1494,17639,552,24240,1494,41879,California
Tulare,2021-02-24,2546,68824,1587,31946,959,36878,0,0,2148,19393,395,24635,2149,44028,California
Tulare,2021-02-25,3673,72497,2058,34004,1615,38493,0,0,3220,22167,448,25083,3222,47250,California
Tulare,2021-02-26,4010,76507,1956,35960,2054,40547,0,0,3516,25191,492,25575,3516,50766,California
Tulare,2021-02-27,3169,79676,1598,37558,1571,42118,0,0,3028,28092,127,25702,3028,53794,California
Tulare,2021-02-28,1374,81050,1086,38644,288,42406,0,0,1350,29423,19,25721,1350,55144,California
Tulare,2021-03-01,1856,82906,828,39472,1027,43433,1,1,1649,30870,203,25924,1650,56794,California
Tulare,2021-03-02,2887,85793,1292,40764,1595,45028,0,1,2695,33378,188,26112,2696,59490,California
Tulare,2021-03-03,4167,89960,2770,43534,1396,46424,1,2,2185,33591,1976,28088,2189,61679,California
Tulare,2021-03-04,3051,93011,1386,44920,1665,48089,0,2,2695,35938,348,28436,2695,64374,California
Tulare,2021-03-05,3557,96568,1787,46707,1755,49844,15,17,3029,38461,525,28961,3048,67422,California
Tulare,2021-03-06,3120,99688,1458,48165,1602,51446,60,77,2858,41119,259,29220,2917,70339,California
Tulare,2021-03-07,1168,100856,716,48881,420,51866,32,109,1113,42210,54,29274,1145,71484,California
Tulare,2021-03-08,1744,102600,1010,49891,564,52430,170,279,1408,43457,330,29604,1577,73061,California
Tulare,2021-03-09,3307,105907,2256,52147,898,53328,153,432,2872,46046,434,30038,3023,76084,California
Tulare,2021-03-10,3009,108916,1419,53566,1414,54742,176,608,2597,48418,400,30438,2772,78856,California
Tulare,2021-03-11,4282,113198,2016,55582,1957,56699,309,917,3311,51068,971,31409,3621,82477,California
Tulare,2021-03-12,4476,117674,2445,58027,1674,58373,357,1274,3169,53295,1297,32706,3524,86001,California
Tulare,2021-03-13,4194,121868,1964,59991,2126,60499,104,1378,3228,55670,958,33664,3333,89334,California
Tulare,2021-03-14,1862,123730,989,60980,653,61152,220,1598,1331,56688,530,34194,1548,90882,California
Tulare,2021-03-15,2782,126512,1650,62630,1015,62167,117,1715,1994,58018,783,34977,2113,92995,California
Tulare,2021-03-16,3500,130012,2131,64761,1289,63456,80,1795,1921,58448,1574,36551,2004,94999,California
Tulare,2021-03-17,4121,134133,2686,67447,1360,64816,75,1870,2337,59091,1775,38326,2418,97417,California
Tulare,2021-03-18,4733,138866,3448,70895,1212,66028,73,1943,2480,59410,2241,40567,2560,99977,California
Tulare,2021-03-19,5193,144059,3406,74301,1566,67594,221,2164,2724,59909,2448,43015,2947,102924,California
Tulare,2021-03-20,4539,148598,2840,77141,1327,68921,372,2536,2038,59831,2492,45507,2414,105338,California
Tulare,2021-03-21,2025,150623,1735,78876,263,69184,27,2563,1035,59908,984,46491,1061,106399,California
Tulare,2021-03-22,2598,153221,1807,80683,678,69862,113,2676,1700,60833,891,47382,1816,108215,California
Tulare,2021-03-23,3839,157060,2214,82897,1572,71434,53,2729,2100,61264,1725,49107,2156,110371,California
Tulare,2021-03-24,3245,160305,2012,84909,1191,72625,42,2771,1721,61515,1513,50620,1764,112135,California
Tulare,2021-03-25,3554,163859,1841,86750,1548,74173,165,2936,1663,61462,1882,52502,1829,113964,California
Tulare,2021-03-26,5327,169186,3172,89922,2039,76212,116,3052,2519,61308,2789,55291,2635,116599,California
Tulare,2021-03-27,3583,172769,1835,91757,1648,77860,100,3152,942,59718,2631,57922,1041,117640,California
Tulare,2021-03-28,1494,174263,1084,92841,379,78239,31,3183,676,59619,816,58738,717,118357,California
Tulare,2021-03-29,2914,177177,1689,94530,1117,79356,108,3291,1221,59262,1688,60426,1331,119688,California
Tulare,2021-03-30,4975,182152,2818,97348,1919,81275,238,3529,1494,57519,3467,63893,1724,121412,California
Tulare,2021-03-31,4030,186182,2375,99723,1538,82813,117,3646,1552,56720,2469,66362,1670,123082,California
Tulare,2021-04-01,4578,190760,2484,102207,2023,84836,71,3717,1564,55352,3002,69364,1634,124716,California
Tulare,2021-04-02,5429,196189,3094,105301,2208,87044,127,3844,1570,53207,3842,73206,1697,126413,California
Tulare,2021-04-03,3668,199857,2119,107420,1172,88216,377,4221,841,51635,2788,75994,1216,127629,California
Tulare,2021-04-04,1635,201492,1147,108567,481,88697,7,4228,355,50721,1276,77270,362,127991,California
Tulare,2021-04-05,3381,204873,2359,110926,751,89448,271,4499,856,49337,2511,79781,1127,129118,California
Tulare,2021-04-06,3484,208357,1483,112409,1499,90947,502,5001,909,48184,2566,82347,1413,130531,California
Tulare,2021-04-07,3976,212333,1865,114274,1666,92613,445,5446,1186,47025,2780,85127,1621,132152,California
Tulare,2021-04-08,4870,217203,2644,116918,1768,94381,458,5904,1547,45718,3310,88437,2003,134155,California
Tulare,2021-04-09,4905,222108,3026,119944,1434,95815,445,6349,1837,44940,3060,91497,2282,136437,California
Tulare,2021-04-10,3888,225996,2100,122044,1468,97283,320,6669,944,43266,2934,94431,1260,137697,California
Tulare,2021-04-11,1595,227591,1056,123100,462,97745,77,6746,491,42734,1100,95531,568,138265,California
Tulare,2021-04-12,3454,231045,2150,125250,704,98449,600,7346,1078,42046,2366,97897,1678,139943,California
Tulare,2021-04-13,2452,233497,1612,126862,830,99279,10,7356,899,41420,1537,99434,911,140854,California
Tulare,2021-04-14,2906,236403,1711,128573,1195,100474,0,7356,905,40330,1995,101429,905,141759,California
Tulare,2021-04-15,3387,239790,2191,130764,1196,101670,0,7356,1480,39918,1892,103321,1480,143239,California
Tulare,2021-04-16,3734,243524,2254,133018,1480,103150,0,7356,1489,39177,2230,105551,1489,144728,California
Tulare,2021-04-17,2270,245794,1336,134354,934,104084,0,7356,1183,39280,1081,106632,1184,145912,California
Tulare,2021-04-18,1585,247379,1245,135599,340,104424,0,7356,826,39348,758,107390,826,146738,California
Tulare,2021-04-19,2193,249572,1273,136872,919,105343,1,7357,890,38943,1296,108686,891,147629,California
Tulare,2021-04-20,2460,252032,1400,138272,1060,106403,0,7357,1001,38503,1441,110127,1001,148630,California
Tulare,2021-04-21,2344,254376,1448,139720,896,107299,0,7357,838,37884,1458,111585,839,149469,California
Tulare,2021-04-22,2232,256608,1268,140988,964,108263,0,7357,754,37180,1458,113043,754,150223,California
Tulare,2021-04-23,2710,259318,1673,142661,1036,109299,1,7358,1053,36592,1642,114685,1054,151277,California
Tulare,2021-04-24,1693,261011,1081,143742,610,109909,2,7360,872,36650,816,115501,874,152151,California
Tulare,2021-04-25,725,261736,548,144290,177,110086,0,7360,276,36478,448,115949,276,152427,California
Tulare,2021-04-26,1582,263318,959,145249,603,110689,20,7380,664,36249,911,116860,682,153109,California
Tulare,2021-04-27,1730,265048,716,145965,974,111663,40,7420,734,36032,990,117850,773,153882,California
Tulare,2021-04-28,1772,266820,1018,146983,712,112375,42,7462,705,35716,1062,118912,746,154628,California
Tulare,2021-04-29,2087,268907,1261,148244,785,113160,41,7503,812,35305,1262,120174,851,155479,California
Tulare,2021-04-30,2499,271406,1817,150061,632,113792,50,7553,914,34696,1572,121746,963,156442,California
Tulare,2021-05-01,1452,272858,1247,151308,193,113985,12,7565,743,34752,699,122445,755,157197,California
Tulare,2021-05-02,597,273455,510,151818,70,114055,17,7582,190,34554,404,122849,206,157403,California
Tulare,2021-05-03,1644,275099,1116,152934,403,114458,125,7707,351,33744,1286,124135,476,157879,California
Tulare,2021-05-04,1613,276712,864,153798,678,115136,71,7778,640,33489,964,125099,709,158588,California
Tulare,2021-05-05,1341,278053,662,154460,587,115723,92,7870,461,33175,867,125966,553,159141,California
Tulare,2021-05-06,2048,280101,1386,155846,613,116336,49,7919,614,32413,1425,127391,663,159804,California
Tulare,2021-05-07,1880,281981,1280,157126,530,116866,70,7989,529,31668,1342,128733,597,160401,California
Tulare,2021-05-08,1269,283250,832,157958,411,117277,26,8015,546,31526,714,129447,572,160973,California
Tulare,2021-05-09,605,283855,478,158436,106,117383,21,8036,117,31182,483,129930,139,161112,California
Tulare,2021-05-10,1045,284900,604,159040,375,117758,66,8102,311,30830,729,130659,377,161489,California
Tulare,2021-05-11,1331,286231,702,159742,545,118303,84,8186,552,30696,770,131429,636,162125,California
Tulare,2021-05-12,1620,287851,1047,160789,516,118819,57,8243,442,30034,1160,132589,498,162623,California
Tulare,2021-05-13,1606,289457,1027,161816,539,119358,40,8283,727,29927,873,133462,766,163389,California
Tulare,2021-05-14,2009,291466,1308,163124,637,119995,64,8347,910,29816,1084,134546,973,164362,California
Tulare,2021-05-15,1605,293071,907,164031,651,120646,47,8394,679,29619,917,135463,720,165082,California
Tulare,2021-05-16,700,293771,561,164592,127,120773,12,8406,326,29585,372,135835,338,165420,California
Tulare,2021-05-17,1583,295354,990,165582,518,121291,75,8481,748,29584,823,136658,822,166242,California
Tulare,2021-05-18,1597,296951,864,166446,679,121970,54,8535,792,29629,799,137457,844,167086,California
Tulare,2021-05-19,1488,298439,959,167405,495,122465,34,8569,761,29706,718,138175,795,167881,California
Tulare,2021-05-20,1613,300052,1093,168498,433,122898,87,8656,766,29717,842,139017,853,168734,California
Tulare,2021-05-21,1962,302014,1431,169929,488,123386,43,8699,1063,29931,891,139908,1105,169839,California
Tulare,2021-05-22,1630,303644,1163,171092,444,123830,23,8722,613,29559,1009,140917,637,170476,California
Tulare,2021-05-23,416,304060,330,171422,77,123907,9,8731,209,29572,206,141123,219,170695,California
Tulare,2021-05-24,946,305006,582,172004,302,124209,62,8793,421,29532,523,141646,483,171178,California
Tulare,2021-05-25,1194,306200,709,172713,453,124662,32,8825,510,29396,678,142324,542,171720,California
Tulare,2021-05-26,886,307086,488,173201,356,125018,42,8867,392,29339,489,142813,432,172152,California
Tulare,2021-05-27,1281,308367,806,174007,443,125461,32,8899,580,29257,696,143509,614,172766,California
Tulare,2021-05-28,1197,309564,664,174671,484,125945,49,8948,627,29369,563,144072,675,173441,California
Tulare,2021-05-29,881,310445,652,175323,210,126155,19,8967,502,29513,377,144449,521,173962,California
Tulare,2021-05-30,290,310735,209,175532,73,126228,8,8975,166,29564,123,144572,174,174136,California
Tulare,2021-05-31,131,310866,51,175583,69,126297,11,8986,53,29551,77,144649,64,174200,California
Tulare,2021-06-01,1063,311929,630,176213,402,126699,31,9017,386,29299,668,145317,416,174616,California
Tulare,2021-06-02,798,312727,468,176681,297,126996,33,9050,352,29246,435,145752,382,174998,California
Tulare,2021-06-03,1145,313872,811,177492,276,127272,58,9108,389,28956,736,146488,446,175444,California
Tulare,2021-06-04,1175,315047,837,178329,306,127578,32,9140,358,28534,812,147300,390,175834,California
Tulare,2021-06-05,888,315935,702,179031,171,127749,15,9155,297,28258,588,147888,312,176146,California
Tulare,2021-06-06,427,316362,361,179392,46,127795,20,9175,140,28132,286,148174,160,176306,California
Tulare,2021-06-07,891,317253,697,180089,155,127950,39,9214,280,27842,607,148781,317,176623,California
Tulare,2021-06-08,1053,318306,775,180864,215,128165,63,9277,351,27559,697,149478,414,177037,California
Tulare,2021-06-09,1097,319403,767,181631,294,128459,36,9313,346,27193,746,150224,380,177417,California
Tulare,2021-06-10,1108,320511,891,182522,181,128640,36,9349,380,26882,726,150950,415,177832,California
Tulare,2021-06-11,1237,321748,884,183406,318,128958,35,9384,381,26452,846,151796,416,178248,California
Tulare,2021-06-12,994,322742,780,184186,203,129161,11,9395,359,26194,628,152424,370,178618,California
Tulare,2021-06-13,316,323058,227,184413,85,129246,4,9399,91,26065,224,152648,95,178713,California
Tulare,2021-06-14,778,323836,570,184983,180,129426,28,9427,298,25916,475,153123,326,179039,California
Tulare,2021-06-15,993,324829,668,185651,295,129721,30,9457,437,25834,549,153672,467,179506,California
Tulare,2021-06-16,865,325694,587,186238,228,129949,50,9507,381,25785,481,154153,432,179938,California
Tulare,2021-06-17,1032,326726,758,186996,244,130193,30,9537,418,25621,611,154764,447,180385,California
Tulare,2021-06-18,991,327717,697,187693,257,130450,37,9574,372,25412,617,155381,408,180793,California
Tulare,2021-06-19,852,328569,680,188373,158,130608,14,9588,390,25358,458,155839,404,181197,California
Tulare,2021-06-20,249,328818,186,188559,55,130663,8,9596,74,25267,174,156013,83,181280,California
Tulare,2021-06-21,528,329346,344,188903,151,130814,33,9629,309,25390,218,156231,341,181621,California
Tulare,2021-06-22,753,330099,514,189417,215,131029,24,9653,343,25354,403,156634,367,181988,California
Tulare,2021-06-23,737,330836,501,189918,210,131239,26,9679,399,25446,333,156967,425,182413,California
Tulare,2021-06-24,844,331680,637,190555,152,131391,55,9734,418,25497,423,157390,474,182887,California
Tulare,2021-06-25,850,332530,552,191107,278,131669,20,9754,445,25562,400,157790,465,183352,California
Tulare,2021-06-26,934,333464,736,191843,172,131841,26,9780,534,25725,397,158187,560,183912,California
Tulare,2021-06-27,249,333713,184,192027,58,131899,7,9787,116,25717,131,158318,123,184035,California
Tulare,2021-06-28,582,334295,440,192467,113,132012,29,9816,294,25755,286,158604,324,184359,California
Tulare,2021-06-29,726,335021,463,192930,221,132233,42,9858,343,25763,377,158981,385,184744,California
Tulare,2021-06-30,702,335723,476,193406,192,132425,34,9892,382,25862,314,159295,413,185157,California
Tulare,2021-07-01,823,336546,618,194024,171,132596,34,9926,383,25845,433,159728,416,185573,California
Tulare,2021-07-02,726,337272,510,194534,199,132795,17,9943,383,25909,337,160065,401,185974,California
Tulare,2021-07-03,457,337729,331,194865,117,132912,9,9952,218,25903,233,160298,227,186201,California
Tulare,2021-07-04,30,337759,19,194884,10,132922,1,9953,16,25906,14,160312,17,186218,California
Tulare,2021-07-05,405,338164,295,195179,98,133020,12,9965,206,25928,196,160508,218,186436,California
Tulare,2021-07-06,766,338930,552,195731,190,133210,24,9989,327,25844,434,160942,350,186786,California
Tulare,2021-07-07,699,339629,481,196212,181,133391,37,10026,319,25827,372,161314,355,187141,California
Tulare,2021-07-08,710,340339,525,196737,153,133544,32,10058,334,25820,373,161687,366,187507,California
Tulare,2021-07-09,921,341260,714,197451,184,133728,23,10081,477,25879,440,162127,499,188006,California
Tulare,2021-07-10,494,341754,377,197828,103,133831,14,10095,246,25893,246,162373,260,188266,California
Tulare,2021-07-11,217,341971,160,197988,55,133886,2,10097,115,25908,102,162475,117,188383,California
Tulare,2021-07-12,532,342503,401,198389,112,133998,19,10116,263,25924,266,162741,282,188665,California
Tulare,2021-07-13,631,343134,432,198821,177,134175,22,10138,287,25893,340,163081,309,188974,California
Tulare,2021-07-14,699,343833,480,199301,194,134369,25,10163,331,25886,363,163444,356,189330,California
Tulare,2021-07-15,872,344705,654,199955,199,134568,19,10182,403,25844,465,163909,423,189753,California
Tulare,2021-07-16,908,345613,667,200622,217,134785,24,10206,477,25918,427,164336,501,190254,California
Tulare,2021-07-17,702,346315,575,201197,116,134901,11,10217,309,25850,389,164725,321,190575,California
Tulare,2021-07-18,172,346487,131,201328,39,134940,2,10219,95,25872,75,164800,97,190672,California
Tulare,2021-07-19,672,347159,530,201858,133,135073,9,10228,371,25957,295,165095,380,191052,California
Tulare,2021-07-20,798,347957,581,202439,192,135265,25,10253,419,26024,377,165472,444,191496,California
Tulare,2021-07-21,783,348740,550,202989,213,135478,20,10273,407,26079,372,165844,427,191923,California
Tulare,2021-07-22,867,349607,645,203634,207,135685,15,10288,487,26205,375,166219,501,192424,California
Tulare,2021-07-23,1083,350690,759,204393,290,135975,34,10322,601,26363,475,166694,633,193057,California
Tulare,2021-07-24,540,351230,387,204780,136,136111,17,10339,331,26504,207,166901,348,193405,California
Tulare,2021-07-25,251,351481,189,204969,62,136173,0,10339,190,26633,61,166962,190,193595,California
Tulare,2021-07-26,639,352120,415,205384,214,136387,10,10349,404,26815,232,167194,414,194009,California
Tulare,2021-07-27,838,352958,554,205938,256,136643,28,10377,510,27028,325,167519,538,194547,California
Tulare,2021-07-28,821,353779,545,206483,247,136890,29,10406,525,27292,290,167809,554,195101,California
Tulare,2021-07-29,883,354662,612,207095,252,137142,19,10425,583,27601,293,168102,602,195703,California
Tulare,2021-07-30,1055,355717,724,207819,291,137433,40,10465,670,27930,379,168481,708,196411,California
Tulare,2021-07-31,422,356139,314,208133,98,137531,10,10475,263,28048,155,168636,273,196684,California
Tuolumne,2020-12-16,50,50,50,50,0,0,0,0,50,50,0,0,50,50,California
Tuolumne,2020-12-17,17,67,17,67,0,0,0,0,17,67,0,0,17,67,California
Tuolumne,2020-12-18,102,169,101,168,1,1,0,0,102,169,0,0,102,169,California
Tuolumne,2020-12-19,4,173,4,172,0,1,0,0,4,173,0,0,4,173,California
Tuolumne,2020-12-20,2,175,2,174,0,1,0,0,2,175,0,0,2,175,California
Tuolumne,2020-12-21,115,290,101,275,14,15,0,0,115,290,0,0,115,290,California
Tuolumne,2020-12-22,171,461,171,446,0,15,0,0,171,461,0,0,171,461,California
Tuolumne,2020-12-23,183,644,180,626,3,18,0,0,183,644,0,0,183,644,California
Tuolumne,2020-12-25,1,645,1,627,0,18,0,0,1,645,0,0,1,645,California
Tuolumne,2020-12-26,2,647,2,629,0,18,0,0,2,647,0,0,2,647,California
Tuolumne,2020-12-28,75,722,73,702,2,20,0,0,75,722,0,0,75,722,California
Tuolumne,2020-12-29,102,824,38,740,64,84,0,0,102,824,0,0,102,824,California
Tuolumne,2020-12-30,79,903,22,762,57,141,0,0,79,903,0,0,79,903,California
Tuolumne,2020-12-31,28,931,21,783,7,148,0,0,28,931,0,0,28,931,California
Tuolumne,2021-01-01,6,937,5,788,1,149,0,0,6,937,0,0,6,937,California
Tuolumne,2021-01-02,118,1055,116,904,2,151,0,0,118,1055,0,0,118,1055,California
Tuolumne,2021-01-03,2,1057,2,906,0,151,0,0,2,1057,0,0,2,1057,California
Tuolumne,2021-01-04,69,1126,26,932,43,194,0,0,69,1126,0,0,69,1126,California
Tuolumne,2021-01-05,96,1222,29,961,67,261,0,0,93,1217,3,3,94,1220,California
Tuolumne,2021-01-06,135,1357,72,1033,63,324,0,0,70,1222,65,68,70,1290,California
Tuolumne,2021-01-07,122,1479,64,1097,58,382,0,0,66,1233,55,123,66,1356,California
Tuolumne,2021-01-08,107,1586,83,1180,24,406,0,0,27,1183,79,202,29,1385,California
Tuolumne,2021-01-09,3,1589,0,1180,3,409,0,0,3,1186,0,202,3,1388,California
Tuolumne,2021-01-10,3,1592,1,1181,2,411,0,0,3,1189,0,202,3,1391,California
Tuolumne,2021-01-11,115,1707,89,1270,26,437,0,0,33,1140,82,284,33,1424,California
Tuolumne,2021-01-12,102,1809,86,1356,16,453,0,0,18,1074,84,368,18,1442,California
Tuolumne,2021-01-13,232,2041,126,1482,106,559,0,0,182,1207,50,418,183,1625,California
Tuolumne,2021-01-14,151,2192,109,1591,42,601,0,0,46,1150,103,521,46,1671,California
Tuolumne,2021-01-15,479,2671,76,1667,403,1004,0,0,416,1504,62,583,416,2087,California
Tuolumne,2021-01-16,7,2678,3,1670,4,1008,0,0,6,1509,1,584,6,2093,California
Tuolumne,2021-01-17,8,2686,4,1674,4,1012,0,0,8,1517,0,584,8,2101,California
Tuolumne,2021-01-18,48,2734,38,1712,10,1022,0,0,11,1492,36,620,11,2112,California
Tuolumne,2021-01-19,484,3218,76,1788,408,1430,0,0,438,1884,46,666,438,2550,California
Tuolumne,2021-01-20,76,3294,58,1846,18,1448,0,0,24,1857,51,717,24,2574,California
Tuolumne,2021-01-21,61,3355,27,1873,34,1482,0,0,43,1883,17,734,43,2617,California
Tuolumne,2021-01-22,174,3529,17,1890,157,1639,0,0,165,2039,9,743,165,2782,California
Tuolumne,2021-01-23,652,4181,130,2020,522,2161,0,0,541,2486,111,854,558,3340,California
Tuolumne,2021-01-24,527,4708,4,2024,523,2684,0,0,522,3007,5,859,526,3866,California
Tuolumne,2021-01-25,52,4760,29,2053,23,2707,0,0,26,3008,26,885,27,3893,California
Tuolumne,2021-01-26,81,4841,69,2122,12,2719,0,0,40,3007,41,926,40,3933,California
Tuolumne,2021-01-27,62,4903,5,2127,57,2776,0,0,8,2962,53,979,8,3941,California
Tuolumne,2021-01-28,27,4930,6,2133,21,2797,0,0,18,2971,9,988,18,3959,California
Tuolumne,2021-01-29,73,5003,5,2138,68,2865,0,0,35,2968,38,1026,35,3994,California
Tuolumne,2021-01-30,722,5725,561,2699,161,3026,0,0,701,3664,21,1047,717,4711,California
Tuolumne,2021-01-31,9,5734,2,2701,7,3033,0,0,6,3667,3,1050,6,4717,California
Tuolumne,2021-02-01,29,5763,7,2708,22,3055,0,0,26,3690,3,1053,26,4743,California
Tuolumne,2021-02-02,660,6423,50,2758,610,3665,0,0,643,4321,14,1067,645,5388,California
Tuolumne,2021-02-03,253,6676,114,2872,139,3804,0,0,93,4254,160,1227,93,5481,California
Tuolumne,2021-02-04,126,6802,15,2887,111,3915,0,0,63,4255,62,1289,63,5544,California
Tuolumne,2021-02-05,107,6909,15,2902,92,4007,0,0,38,4225,68,1357,38,5582,California
Tuolumne,2021-02-06,871,7780,592,3494,279,4286,0,0,861,5082,10,1367,867,6449,California
Tuolumne,2021-02-07,8,7788,4,3498,4,4290,0,0,4,5082,4,1371,4,6453,California
Tuolumne,2021-02-08,98,7886,43,3541,55,4345,0,0,72,5128,26,1397,72,6525,California
Tuolumne,2021-02-09,866,8752,53,3594,813,5158,0,0,822,5907,43,1440,822,7347,California
Tuolumne,2021-02-10,100,8852,20,3614,80,5238,0,0,35,5879,63,1503,35,7382,California
Tuolumne,2021-02-11,150,9002,68,3682,82,5320,0,0,84,5897,66,1569,84,7466,California
Tuolumne,2021-02-12,659,9661,25,3707,634,5954,0,0,215,5669,443,2012,215,7681,California
Tuolumne,2021-02-13,158,9819,44,3751,114,6068,0,0,124,5759,34,2046,124,7805,California
Tuolumne,2021-02-14,152,9971,14,3765,138,6206,0,0,150,5907,2,2048,150,7955,California
Tuolumne,2021-02-15,193,10164,11,3776,182,6388,0,0,183,6080,10,2058,183,8138,California
Tuolumne,2021-02-16,534,10698,18,3794,516,6904,0,0,123,5799,406,2464,125,8263,California
Tuolumne,2021-02-17,113,10811,64,3858,49,6953,0,0,63,5813,49,2513,63,8326,California
Tuolumne,2021-02-18,693,11504,32,3890,661,7614,0,0,637,6395,56,2569,638,8964,California
Tuolumne,2021-02-19,148,11652,24,3914,124,7738,0,0,45,6338,102,2671,45,9009,California
Tuolumne,2021-02-20,915,12567,344,4258,571,8309,0,0,386,6218,510,3181,390,9399,California
Tuolumne,2021-02-21,993,13560,44,4302,949,9258,0,0,476,6188,512,3693,482,9881,California
Tuolumne,2021-02-22,82,13642,59,4361,23,9281,0,0,46,6200,34,3727,46,9927,California
Tuolumne,2021-02-23,47,13689,24,4385,23,9304,0,0,22,6198,24,3751,22,9949,California
Tuolumne,2021-02-24,107,13796,58,4443,49,9353,0,0,43,6179,63,3814,44,9993,California
Tuolumne,2021-02-25,1061,14857,35,4478,1026,10379,0,0,1024,7168,36,3850,1025,11018,California
Tuolumne,2021-02-26,157,15014,12,4490,145,10524,0,0,127,7266,30,3880,128,11146,California
Tuolumne,2021-02-27,970,15984,586,5076,384,10908,0,0,252,6822,701,4581,257,11403,California
Tuolumne,2021-02-28,54,16038,4,5080,50,10958,0,0,51,6871,2,4583,51,11454,California
Tuolumne,2021-03-01,125,16163,24,5104,100,11058,1,1,81,6911,43,4626,83,11537,California
Tuolumne,2021-03-02,715,16878,78,5182,637,11695,0,1,108,6416,603,5229,108,11645,California
Tuolumne,2021-03-03,100,16978,21,5203,79,11774,0,1,68,6454,30,5259,68,11713,California
Tuolumne,2021-03-04,1179,18157,76,5279,1103,12877,0,1,1112,7502,65,5324,1113,12826,California
Tuolumne,2021-03-05,97,18254,12,5291,85,12962,0,1,55,7517,41,5365,56,12882,California
Tuolumne,2021-03-06,1070,19324,610,5901,458,13420,2,3,202,6866,860,6225,209,13091,California
Tuolumne,2021-03-07,43,19367,14,5915,15,13435,14,17,20,6877,23,6248,34,13125,California
Tuolumne,2021-03-08,203,19570,92,6007,104,13539,7,24,144,6969,59,6307,151,13276,California
Tuolumne,2021-03-09,877,20447,18,6025,848,14387,11,35,67,6244,803,7110,78,13354,California
Tuolumne,2021-03-10,104,20551,20,6045,73,14460,11,46,55,6262,48,7158,66,13420,California
Tuolumne,2021-03-11,1311,21862,45,6090,1261,15721,5,51,1257,7472,54,7212,1264,14684,California
Tuolumne,2021-03-12,319,22181,44,6134,260,15981,15,66,189,7552,128,7340,208,14892,California
Tuolumne,2021-03-13,122,22303,13,6147,109,16090,0,66,80,7592,41,7381,81,14973,California
Tuolumne,2021-03-14,151,22454,10,6157,132,16222,9,75,7,7469,144,7525,21,14994,California
Tuolumne,2021-03-15,308,22762,84,6241,221,16443,3,78,105,7382,203,7728,116,15110,California
Tuolumne,2021-03-16,816,23578,41,6282,764,17207,11,89,678,7938,136,7864,692,15802,California
Tuolumne,2021-03-17,159,23737,35,6317,111,17318,13,102,79,7951,79,7943,92,15894,California
Tuolumne,2021-03-18,956,24693,27,6344,915,18233,14,116,318,7652,631,8574,332,16226,California
Tuolumne,2021-03-19,138,24831,17,6361,91,18324,30,146,76,7697,61,8635,106,16332,California
Tuolumne,2021-03-20,94,24925,8,6369,76,18400,10,156,38,7689,55,8690,47,16379,California
Tuolumne,2021-03-21,844,25769,395,6764,439,18839,10,166,37,6947,791,9481,49,16428,California
Tuolumne,2021-03-22,166,25935,75,6839,72,18911,19,185,96,6993,69,9550,115,16543,California
Tuolumne,2021-03-23,716,26651,639,7478,63,18974,14,199,677,7646,37,9587,690,17233,California
Tuolumne,2021-03-24,111,26762,20,7498,73,19047,18,217,76,7707,33,9620,94,17327,California
Tuolumne,2021-03-25,1306,28068,25,7523,1278,20325,3,220,325,7060,975,10595,328,17655,California
Tuolumne,2021-03-26,283,28351,19,7542,240,20565,24,244,116,7046,155,10750,141,17796,California
Tuolumne,2021-03-27,593,28944,56,7598,537,21102,0,244,318,7099,269,11019,322,18118,California
Tuolumne,2021-03-28,45,28989,5,7603,40,21142,0,244,7,7069,38,11057,8,18126,California
Tuolumne,2021-03-29,213,29202,88,7691,125,21267,0,244,111,7082,99,11156,112,18238,California
Tuolumne,2021-03-30,168,29370,11,7702,156,21423,1,245,120,7158,45,11201,121,18359,California
Tuolumne,2021-03-31,96,29466,13,7715,81,21504,2,247,39,7144,55,11256,41,18400,California
Tuolumne,2021-04-01,1259,30725,29,7744,1230,22734,0,247,228,6343,1029,12285,228,18628,California
Tuolumne,2021-04-02,170,30895,9,7753,135,22869,26,273,90,6382,77,12362,116,18744,California
Tuolumne,2021-04-03,434,31329,35,7788,398,23267,1,274,238,6429,193,12555,240,18984,California
Tuolumne,2021-04-04,36,31365,5,7793,31,23298,0,274,19,6434,14,12569,19,19003,California
Tuolumne,2021-04-05,134,31499,20,7813,107,23405,7,281,57,6421,77,12646,64,19067,California
Tuolumne,2021-04-06,657,32156,519,8332,111,23516,27,308,513,6820,143,12789,542,19609,California
Tuolumne,2021-04-07,132,32288,38,8370,77,23593,17,325,52,6809,80,12869,69,19678,California
Tuolumne,2021-04-08,1457,33745,37,8407,1404,24997,16,341,249,5872,1202,14071,265,19943,California
Tuolumne,2021-04-09,278,34023,44,8451,190,25187,44,385,133,5908,144,14215,180,20123,California
Tuolumne,2021-04-10,55,34078,2,8453,33,25220,20,405,22,5918,32,14247,42,20165,California
Tuolumne,2021-04-11,18,34096,3,8456,12,25232,3,408,12,5928,5,14252,15,20180,California
Tuolumne,2021-04-12,171,34267,66,8522,100,25332,5,413,84,5935,82,14334,89,20269,California
Tuolumne,2021-04-13,795,35062,35,8557,760,26092,0,413,171,5490,616,14950,171,20440,California
Tuolumne,2021-04-14,158,35220,31,8588,127,26219,0,413,78,5493,76,15026,79,20519,California
Tuolumne,2021-04-15,349,35569,23,8611,326,26545,0,413,61,5273,281,15307,61,20580,California
Tuolumne,2021-04-16,264,35833,57,8668,207,26752,0,413,142,5305,111,15418,143,20723,California
Tuolumne,2021-04-17,44,35877,6,8674,38,26790,0,413,27,5315,17,15435,27,20750,California
Tuolumne,2021-04-18,9,35886,2,8676,7,26797,0,413,5,5317,4,15439,6,20756,California
Tuolumne,2021-04-19,177,36063,79,8755,98,26895,0,413,95,5332,80,15519,95,20851,California
Tuolumne,2021-04-20,712,36775,615,9370,97,26992,0,413,74,4775,631,16150,74,20925,California
Tuolumne,2021-04-21,122,36897,29,9399,93,27085,0,413,66,4790,51,16201,66,20991,California
Tuolumne,2021-04-22,713,37610,44,9443,669,27754,0,413,430,4948,273,16474,431,21422,California
Tuolumne,2021-04-23,176,37786,29,9472,147,27901,0,413,82,4943,88,16562,83,21505,California
Tuolumne,2021-04-24,77,37863,16,9488,61,27962,0,413,49,4964,28,16590,49,21554,California
Tuolumne,2021-04-25,26,37889,9,9497,17,27979,0,413,23,4984,3,16593,23,21577,California
Tuolumne,2021-04-26,162,38051,57,9554,105,28084,0,413,74,4974,85,16678,75,21652,California
Tuolumne,2021-04-27,143,38194,22,9576,114,28198,7,420,65,4972,74,16752,72,21724,California
Tuolumne,2021-04-28,119,38313,24,9600,83,28281,12,432,61,4990,56,16808,74,21798,California
Tuolumne,2021-04-29,289,38602,24,9624,257,28538,8,440,59,4833,224,17032,67,21865,California
Tuolumne,2021-04-30,377,38979,26,9650,339,28877,12,452,72,4617,300,17332,84,21949,California
Tuolumne,2021-05-01,25,39004,7,9657,13,28890,5,457,16,4629,9,17341,21,21970,California
Tuolumne,2021-05-02,26,39030,3,9660,21,28911,2,459,19,4643,7,17348,21,21991,California
Tuolumne,2021-05-03,111,39141,15,9675,91,29002,5,464,39,4617,70,17418,44,22035,California
Tuolumne,2021-05-04,714,39855,602,10277,108,29110,4,468,218,4344,494,17912,221,22256,California
Tuolumne,2021-05-05,112,39967,27,10304,79,29189,6,474,59,4360,49,17961,65,22321,California
Tuolumne,2021-05-06,293,40260,15,10319,262,29451,16,490,45,4178,242,18203,60,22381,California
Tuolumne,2021-05-07,329,40589,25,10344,296,29747,8,498,62,3984,264,18467,70,22451,California
Tuolumne,2021-05-08,48,40637,6,10350,38,29785,4,502,32,4004,16,18483,36,22487,California
Tuolumne,2021-05-09,17,40654,2,10352,13,29798,2,504,3,3995,14,18497,5,22492,California
Tuolumne,2021-05-10,117,40771,45,10397,65,29863,7,511,33,3952,83,18580,40,22532,California
Tuolumne,2021-05-11,207,40978,63,10460,132,29995,12,523,59,3877,146,18726,71,22603,California
Tuolumne,2021-05-12,136,41114,24,10484,108,30103,4,527,53,3851,83,18809,57,22660,California
Tuolumne,2021-05-13,118,41232,18,10502,92,30195,8,535,73,3887,44,18853,80,22740,California
Tuolumne,2021-05-14,205,41437,74,10576,121,30316,10,545,105,3904,98,18951,115,22855,California
Tuolumne,2021-05-15,58,41495,13,10589,38,30354,7,552,20,3894,38,18989,28,22883,California
Tuolumne,2021-05-16,27,41522,7,10596,18,30372,2,554,12,3894,14,19003,14,22897,California
Tuolumne,2021-05-17,111,41633,31,10627,77,30449,3,557,46,3880,64,19067,50,22947,California
Tuolumne,2021-05-18,182,41815,55,10682,80,30529,47,604,61,3868,120,19187,108,23055,California
Tuolumne,2021-05-19,120,41935,21,10703,66,30595,33,637,46,3873,74,19261,79,23134,California
Tuolumne,2021-05-20,413,42348,22,10725,383,30978,8,645,52,3575,358,19619,60,23194,California
Tuolumne,2021-05-21,204,42552,93,10818,105,31083,6,651,117,3614,84,19703,123,23317,California
Tuolumne,2021-05-22,58,42610,19,10837,33,31116,6,657,25,3612,32,19735,30,23347,California
Tuolumne,2021-05-23,27,42637,7,10844,19,31135,1,658,10,3606,17,19752,11,23358,California
Tuolumne,2021-05-24,139,42776,43,10887,90,31225,6,664,53,3580,85,19837,59,23417,California
Tuolumne,2021-05-25,298,43074,221,11108,71,31296,6,670,111,3513,184,20021,117,23534,California
Tuolumne,2021-05-26,87,43161,24,11132,61,31357,2,672,36,3500,51,20072,38,23572,California
Tuolumne,2021-05-27,76,43237,15,11147,58,31415,3,675,29,3486,46,20118,32,23604,California
Tuolumne,2021-05-28,115,43352,52,11199,62,31477,1,676,66,3507,46,20164,67,23671,California
Tuolumne,2021-05-29,38,43390,7,11206,25,31502,6,682,17,3509,21,20185,23,23694,California
Tuolumne,2021-05-30,18,43408,1,11207,14,31516,3,685,4,3502,14,20199,7,23701,California
Tuolumne,2021-05-31,9,43417,1,11208,7,31523,1,686,1,3496,8,20207,2,23703,California
Tuolumne,2021-06-01,81,43498,22,11230,55,31578,4,690,25,3470,55,20262,29,23732,California
Tuolumne,2021-06-02,75,43573,8,11238,58,31636,9,699,22,3449,52,20314,31,23763,California
Tuolumne,2021-06-03,78,43651,25,11263,38,31674,15,714,24,3437,52,20366,40,23803,California
Tuolumne,2021-06-04,133,43784,61,11324,69,31743,3,717,38,3387,91,20457,41,23844,California
Tuolumne,2021-06-05,41,43825,10,11334,29,31772,2,719,16,3380,25,20482,18,23862,California
Tuolumne,2021-06-06,19,43844,5,11339,7,31779,7,726,4,3376,15,20497,11,23873,California
Tuolumne,2021-06-07,62,43906,14,11353,40,31819,8,734,27,3376,35,20532,35,23908,California
Tuolumne,2021-06-08,74,43980,22,11375,51,31870,1,735,27,3359,45,20577,28,23936,California
Tuolumne,2021-06-09,88,44068,44,11419,34,31904,10,745,41,3364,46,20623,51,23987,California
Tuolumne,2021-06-10,99,44167,15,11434,77,31981,7,752,27,3326,72,20695,34,24021,California
Tuolumne,2021-06-11,103,44270,47,11481,53,32034,3,755,25,3280,74,20769,28,24049,California
Tuolumne,2021-06-12,61,44331,19,11500,26,32060,16,771,18,3273,41,20810,34,24083,California
Tuolumne,2021-06-13,17,44348,2,11502,11,32071,4,775,4,3268,13,20823,8,24091,California
Tuolumne,2021-06-14,100,44448,33,11535,63,32134,4,779,52,3276,48,20871,56,24147,California
Tuolumne,2021-06-15,130,44578,82,11617,39,32173,9,788,20,3197,108,20979,29,24176,California
Tuolumne,2021-06-16,95,44673,46,11663,46,32219,3,791,53,3213,41,21020,57,24233,California
Tuolumne,2021-06-17,46,44719,10,11673,35,32254,1,792,18,3204,28,21048,19,24252,California
Tuolumne,2021-06-18,172,44891,95,11768,63,32317,14,806,61,3168,110,21158,74,24326,California
Tuolumne,2021-06-19,25,44916,9,11777,13,32330,3,809,10,3166,15,21173,13,24339,California
Tuolumne,2021-06-20,11,44927,1,11778,10,32340,0,809,8,3171,3,21176,8,24347,California
Tuolumne,2021-06-21,40,44967,3,11781,36,32376,1,810,21,3174,19,21195,22,24369,California
Tuolumne,2021-06-22,44,45011,10,11791,34,32410,0,810,21,3172,23,21218,21,24390,California
Tuolumne,2021-06-23,71,45082,13,11804,38,32448,20,830,33,3187,38,21256,53,24443,California
Tuolumne,2021-06-24,56,45138,24,11828,26,32474,6,836,25,3189,30,21286,32,24475,California
Tuolumne,2021-06-25,56,45194,31,11859,20,32494,5,841,30,3197,26,21312,34,24509,California
Tuolumne,2021-06-26,14,45208,5,11864,9,32503,0,841,9,3201,5,21317,9,24518,California
Tuolumne,2021-06-27,7,45215,2,11866,5,32508,0,841,7,3208,0,21317,7,24525,California
Tuolumne,2021-06-28,40,45255,20,11886,15,32523,5,846,27,3227,13,21330,32,24557,California
Tuolumne,2021-06-29,36,45291,18,11904,16,32539,2,848,21,3236,14,21344,23,24580,California
Tuolumne,2021-06-30,80,45371,35,11939,44,32583,1,849,21,3202,56,21400,22,24602,California
Tuolumne,2021-07-01,37,45408,16,11955,14,32597,7,856,24,3220,13,21413,31,24633,California
Tuolumne,2021-07-02,62,45470,30,11985,26,32623,6,862,43,3250,19,21432,49,24682,California
Tuolumne,2021-07-03,9,45479,4,11989,5,32628,0,862,6,3253,3,21435,6,24688,California
Tuolumne,2021-07-04,1,45480,1,11990,0,32628,0,862,1,3254,0,21435,1,24689,California
Tuolumne,2021-07-05,17,45497,3,11993,14,32642,0,862,9,3255,8,21443,9,24698,California
Tuolumne,2021-07-06,57,45554,19,12012,35,32677,3,865,21,3244,33,21476,22,24720,California
Tuolumne,2021-07-07,69,45623,33,12045,28,32705,8,873,29,3242,38,21514,36,24756,California
Tuolumne,2021-07-08,35,45658,14,12059,19,32724,2,875,22,3254,12,21526,24,24780,California
Tuolumne,2021-07-09,36,45694,16,12075,20,32744,0,875,20,3258,16,21542,20,24800,California
Tuolumne,2021-07-10,7,45701,1,12076,6,32750,0,875,3,3257,4,21546,3,24803,California
Tuolumne,2021-07-11,3,45704,1,12077,2,32752,0,875,3,3260,0,21546,3,24806,California
Tuolumne,2021-07-12,40,45744,12,12089,28,32780,0,875,12,3244,28,21574,12,24818,California
Tuolumne,2021-07-13,28,45772,10,12099,18,32798,0,875,18,3252,10,21584,18,24836,California
Tuolumne,2021-07-14,45,45817,15,12114,29,32827,1,876,23,3256,21,21605,25,24861,California
Tuolumne,2021-07-15,21,45838,9,12123,7,32834,5,881,8,3257,12,21617,13,24874,California
Tuolumne,2021-07-16,130,45968,93,12216,25,32859,12,893,62,3265,65,21682,73,24947,California
Tuolumne,2021-07-17,19,45987,2,12218,17,32876,0,893,13,3272,6,21688,13,24960,California
Tuolumne,2021-07-18,8,45995,6,12224,2,32878,0,893,4,3272,4,21692,4,24964,California
Tuolumne,2021-07-19,58,46053,22,12246,35,32913,1,894,37,3293,17,21709,38,25002,California
Tuolumne,2021-07-20,40,46093,19,12265,21,32934,0,894,26,3306,13,21722,26,25028,California
Tuolumne,2021-07-21,54,46147,14,12279,36,32970,4,898,28,3312,26,21748,32,25060,California
Tuolumne,2021-07-22,46,46193,11,12290,25,32995,10,908,27,3331,18,21766,37,25097,California
Tuolumne,2021-07-23,91,46284,58,12348,28,33023,5,913,58,3362,33,21799,64,25161,California
Tuolumne,2021-07-24,17,46301,3,12351,14,33037,0,913,12,3369,5,21804,12,25173,California
Tuolumne,2021-07-25,16,46317,12,12363,3,33040,1,914,15,3384,1,21805,16,25189,California
Tuolumne,2021-07-26,72,46389,41,12404,24,33064,7,921,47,3414,25,21830,55,25244,California
Tuolumne,2021-07-27,57,46446,22,12426,33,33097,2,923,39,3437,18,21848,41,25285,California
Tuolumne,2021-07-28,71,46517,10,12436,37,33134,24,947,30,3451,40,21888,54,25339,California
Tuolumne,2021-07-29,43,46560,22,12458,21,33155,0,947,32,3473,10,21898,32,25371,California
Tuolumne,2021-07-30,137,46697,70,12528,55,33210,12,959,91,3534,45,21943,106,25477,California
Tuolumne,2021-07-31,17,46714,0,12528,17,33227,0,959,13,3543,4,21947,13,25490,California
Ventura,2020-12-15,5,5,5,5,0,0,0,0,5,5,0,0,5,5,California
Ventura,2020-12-16,74,79,74,79,0,0,0,0,74,79,0,0,74,79,California
Ventura,2020-12-17,318,397,318,397,0,0,0,0,318,397,0,0,318,397,California
Ventura,2020-12-18,1598,1995,1598,1995,0,0,0,0,1598,1995,0,0,1598,1995,California
Ventura,2020-12-19,977,2972,976,2971,1,1,0,0,977,2972,0,0,977,2972,California
Ventura,2020-12-20,458,3430,458,3429,0,1,0,0,458,3430,0,0,458,3430,California
Ventura,2020-12-21,1505,4935,1505,4934,0,1,0,0,1505,4935,0,0,1505,4935,California
Ventura,2020-12-22,1159,6094,1154,6088,5,6,0,0,1159,6094,0,0,1159,6094,California
Ventura,2020-12-23,1085,7179,1034,7122,51,57,0,0,1085,7179,0,0,1085,7179,California
Ventura,2020-12-24,477,7656,376,7498,101,158,0,0,477,7656,0,0,477,7656,California
Ventura,2020-12-25,12,7668,7,7505,5,163,0,0,12,7668,0,0,12,7668,California
Ventura,2020-12-26,118,7786,97,7602,21,184,0,0,118,7786,0,0,118,7786,California
Ventura,2020-12-27,60,7846,29,7631,31,215,0,0,60,7846,0,0,60,7846,California
Ventura,2020-12-28,1089,8935,948,8579,141,356,0,0,1089,8935,0,0,1089,8935,California
Ventura,2020-12-29,1190,10125,780,9359,410,766,0,0,1190,10125,0,0,1190,10125,California
Ventura,2020-12-30,1998,12123,1531,10890,467,1233,0,0,1998,12123,0,0,1998,12123,California
Ventura,2020-12-31,484,12607,165,11055,319,1552,0,0,479,12597,5,5,479,12602,California
Ventura,2021-01-01,46,12653,21,11076,25,1577,0,0,46,12643,0,5,46,12648,California
Ventura,2021-01-02,169,12822,77,11153,92,1669,0,0,169,12812,0,5,169,12817,California
Ventura,2021-01-03,21,12843,9,11162,12,1681,0,0,21,12833,0,5,21,12838,California
Ventura,2021-01-04,1042,13885,494,11656,548,2229,0,0,1040,13873,0,5,1040,13878,California
Ventura,2021-01-05,1384,15269,787,12443,597,2826,0,0,1270,15032,111,116,1270,15148,California
Ventura,2021-01-06,2050,17319,1174,13617,876,3702,0,0,1560,16113,481,597,1562,16710,California
Ventura,2021-01-07,2075,19394,1325,14942,750,4452,0,0,1039,16122,1031,1628,1040,17750,California
Ventura,2021-01-08,2213,21607,1487,16429,726,5178,0,0,912,15737,1299,2927,914,18664,California
Ventura,2021-01-09,718,22325,495,16924,223,5401,0,0,318,15655,400,3327,318,18982,California
Ventura,2021-01-10,345,22670,327,17251,18,5419,0,0,133,15576,212,3539,133,19115,California
Ventura,2021-01-11,2447,25117,1492,18743,955,6374,0,0,1495,16124,951,4490,1499,20614,California
Ventura,2021-01-12,3043,28160,1620,20363,1423,7797,0,0,1923,16927,1120,5610,1923,22537,California
Ventura,2021-01-13,2940,31100,1440,21803,1500,9297,0,0,2025,18040,913,6523,2026,24563,California
Ventura,2021-01-14,2787,33887,1105,22908,1682,10979,0,0,2326,19907,460,6983,2327,26890,California
Ventura,2021-01-15,2893,36780,969,23877,1924,12903,0,0,2676,22367,217,7200,2677,29567,California
Ventura,2021-01-16,483,37263,189,24066,294,13197,0,0,404,22692,79,7279,404,29971,California
Ventura,2021-01-17,270,37533,145,24211,125,13322,0,0,261,22945,8,7287,261,30232,California
Ventura,2021-01-18,2229,39762,1680,25891,549,13871,0,0,1679,24076,549,7836,1680,31912,California
Ventura,2021-01-19,3062,42824,2126,28017,936,14807,0,0,2147,25311,915,8751,2150,34062,California
Ventura,2021-01-20,4158,46982,3214,31231,944,15751,0,0,3054,27266,1100,9851,3055,37117,California
Ventura,2021-01-21,3860,50842,2706,33937,1154,16905,0,0,3176,29768,676,10527,3178,40295,California
Ventura,2021-01-22,3577,54419,2466,36403,1111,18016,0,0,3409,33009,168,10695,3409,43704,California
Ventura,2021-01-23,1156,55575,638,37041,518,18534,0,0,1059,33974,96,10791,1061,44765,California
Ventura,2021-01-24,445,56020,128,37169,317,18851,0,0,431,34391,14,10805,431,45196,California
Ventura,2021-01-25,3127,59147,2020,39189,1107,19958,0,0,2572,36410,554,11359,2573,47769,California
Ventura,2021-01-26,3675,62822,2199,41388,1476,21434,0,0,2666,38071,1005,12364,2666,50435,California
Ventura,2021-01-27,3438,66260,1551,42939,1887,23321,0,0,2681,40000,754,13118,2683,53118,California
Ventura,2021-01-28,3842,70102,1995,44934,1847,25168,0,0,3215,42607,611,13729,3218,56336,California
Ventura,2021-01-29,4283,74385,2538,47472,1745,26913,0,0,3772,45884,496,14225,3773,60109,California
Ventura,2021-01-30,3033,77418,1968,49440,1065,27978,0,0,2861,48579,167,14392,2862,62971,California
Ventura,2021-01-31,798,78216,416,49856,382,28360,0,0,706,49194,91,14483,706,63677,California
Ventura,2021-02-01,3987,82203,2117,51973,1870,30230,0,0,3197,51612,781,15264,3199,66876,California
Ventura,2021-02-02,4408,86611,2347,54320,2061,32291,0,0,3359,53934,1040,16304,3362,70238,California
Ventura,2021-02-03,4427,91038,2067,56387,2360,34651,0,0,3400,56314,1022,17326,3402,73640,California
Ventura,2021-02-04,4801,95839,2289,58676,2512,37163,0,0,3505,58534,1289,18615,3509,77149,California
Ventura,2021-02-05,4896,100735,2375,61051,2521,39684,0,0,3343,60339,1541,20156,3346,80495,California
Ventura,2021-02-06,2825,103560,1504,62555,1321,41005,0,0,2417,62349,408,20564,2418,82913,California
Ventura,2021-02-07,716,104276,225,62780,491,41496,0,0,586,62806,130,20694,587,83500,California
Ventura,2021-02-08,3562,107838,1650,64430,1912,43408,0,0,2447,64149,1106,21800,2449,85949,California
Ventura,2021-02-09,4738,112576,1977,66407,2761,46169,0,0,2475,64369,2259,24059,2479,88428,California
Ventura,2021-02-10,4725,117301,2241,68648,2484,48653,0,0,2375,64410,2335,26394,2376,90804,California
Ventura,2021-02-11,4684,121985,1861,70509,2823,51476,0,0,2458,64653,2218,28612,2461,93265,California
Ventura,2021-02-12,6358,128343,2667,73176,3691,55167,0,0,3261,64824,3090,31702,3261,96526,California
Ventura,2021-02-13,3317,131660,1837,75013,1480,56647,0,0,1858,65231,1454,33156,1861,98387,California
Ventura,2021-02-14,1211,132871,119,75132,1092,57739,0,0,1006,66036,203,33359,1008,99395,California
Ventura,2021-02-15,4031,136902,1822,76954,2209,59948,0,0,2124,66262,1900,35259,2126,101521,California
Ventura,2021-02-16,5591,142493,2726,79680,2865,62813,0,0,3026,66736,2553,37812,3027,104548,California
Ventura,2021-02-17,5317,147810,1917,81597,3400,66213,0,0,3355,68141,1950,39762,3355,107903,California
Ventura,2021-02-18,5801,153611,1832,83429,3969,70182,0,0,3661,69678,2124,41886,3661,111564,California
Ventura,2021-02-19,6563,160174,3830,87259,2733,72915,0,0,3040,69209,3515,45401,3046,114610,California
Ventura,2021-02-20,4991,165165,3225,90484,1766,74681,0,0,2761,69761,2213,47614,2765,117375,California
Ventura,2021-02-21,1104,166269,812,91296,292,74973,0,0,463,69589,635,48249,463,117838,California
Ventura,2021-02-22,5735,172004,2546,93842,3189,78162,0,0,3659,71195,2055,50304,3661,121499,California
Ventura,2021-02-23,6197,178201,3070,96912,3127,81289,0,0,3575,72177,2597,52901,3579,125078,California
Ventura,2021-02-24,7325,185526,2682,99594,4643,85932,0,0,4420,73718,2881,55782,4422,129500,California
Ventura,2021-02-25,7918,193444,2710,102304,5208,91140,0,0,4801,75426,3098,58880,4806,134306,California
Ventura,2021-02-26,9776,203220,2872,105176,6904,98044,0,0,6386,78458,3358,62238,6390,140696,California
Ventura,2021-02-27,11030,214250,5511,110687,5519,103563,0,0,8287,84035,2720,64958,8297,148993,California
Ventura,2021-02-28,2646,216896,1713,112400,933,104496,0,0,2159,85720,475,65433,2160,151153,California
Ventura,2021-03-01,7429,224325,2956,115356,4469,108965,4,4,4920,88181,2475,67908,4936,156089,California
Ventura,2021-03-02,7977,232302,4187,119543,3788,112753,2,6,5592,91405,2370,70278,5594,161683,California
Ventura,2021-03-03,8910,241212,4034,123577,4873,117626,3,9,6282,95093,2602,72880,6290,167973,California
Ventura,2021-03-04,8403,249615,3912,127489,4491,122117,0,9,5669,98050,2717,75597,5674,173647,California
Ventura,2021-03-05,10115,259730,4831,132320,5272,127389,12,21,7189,102354,2910,78507,7214,180861,California
Ventura,2021-03-06,7762,267492,4398,136718,3209,130598,155,176,5764,106292,1986,80493,5924,186785,California
Ventura,2021-03-07,1714,269206,617,137335,951,131549,146,322,1251,107231,463,80956,1402,188187,California
Ventura,2021-03-08,6861,276067,3453,140788,3245,134794,163,485,4733,110015,2113,83069,4897,193084,California
Ventura,2021-03-09,6851,282918,3028,143816,3631,138425,192,677,3963,111305,2872,85941,4162,197246,California
Ventura,2021-03-10,7049,289967,3022,146838,3788,142213,239,916,4706,113923,2325,88266,4943,202189,California
Ventura,2021-03-11,6564,296531,2899,149737,3347,145560,318,1234,3568,114836,2972,91238,3885,206074,California
Ventura,2021-03-12,8748,305279,3050,152787,4848,150408,850,2084,4271,115493,4452,95690,5109,211183,California
Ventura,2021-03-13,7279,312558,2503,155290,3941,154349,835,2919,4321,117705,2942,98632,5154,216337,California
Ventura,2021-03-14,2114,314672,471,155761,1145,155494,498,3417,714,117521,1396,100028,1212,217549,California
Ventura,2021-03-15,7102,321774,2030,157791,3723,159217,1349,4766,3114,118021,3956,103984,4456,222005,California
Ventura,2021-03-16,8175,329949,2462,160253,4597,163814,1116,5882,4183,119341,3971,107955,5291,227296,California
Ventura,2021-03-17,7753,337702,2799,163052,4611,168425,343,6225,4700,121353,3032,110987,5044,232340,California
Ventura,2021-03-18,7582,345284,3301,166353,4134,172559,147,6372,4953,123840,2614,113601,5101,237441,California
Ventura,2021-03-19,8691,353975,3813,170166,4763,177322,115,6487,5217,125728,3441,117042,5329,242770,California
Ventura,2021-03-20,8908,362883,5938,176104,2946,180268,24,6511,4560,125996,4317,121359,4585,247355,California
Ventura,2021-03-21,2797,365680,1527,177631,898,181166,372,6883,1270,126126,1508,122867,1638,248993,California
Ventura,2021-03-22,7445,373125,3715,181346,3628,184794,102,6985,4844,128505,2569,125436,4948,253941,California
Ventura,2021-03-23,8297,381422,3942,185288,4284,189078,71,7056,4556,129435,3697,129133,4627,258568,California
Ventura,2021-03-24,9004,390426,3440,188728,5486,194564,78,7134,4348,129259,4606,133739,4430,262998,California
Ventura,2021-03-25,8842,399268,3919,192647,4821,199385,102,7236,4362,129271,4451,138190,4463,267461,California
Ventura,2021-03-26,10060,409328,3398,196045,6005,205390,657,7893,3913,127731,6107,144297,4567,272028,California
Ventura,2021-03-27,8787,418115,3935,199980,4812,210202,40,7933,2296,123623,6444,150741,2336,274364,California
Ventura,2021-03-28,2518,420633,1412,201392,1097,211299,9,7942,1343,123806,1169,151910,1352,275716,California
Ventura,2021-03-29,8655,429288,4331,205723,4276,215575,48,7990,4195,123624,4425,156335,4243,279959,California
Ventura,2021-03-30,9049,438337,4488,210211,4432,220007,129,8119,4329,123384,4697,161032,4457,284416,California
Ventura,2021-03-31,10860,449197,4880,215091,5354,225361,626,8745,4608,122402,6211,167243,5229,289645,California
Ventura,2021-04-01,10950,460147,5303,220394,4768,230129,879,9624,5453,123289,5437,172680,6324,295969,California
Ventura,2021-04-02,11878,472025,4653,225047,5876,236005,1349,10973,5642,124089,6189,178869,6989,302958,California
Ventura,2021-04-03,8105,480130,4032,229079,2889,238894,1184,12157,3399,123973,4686,183555,4570,307528,California
Ventura,2021-04-04,1722,481852,965,230044,622,239516,135,12292,1149,124692,565,184120,1284,308812,California
Ventura,2021-04-05,9482,491334,4870,234914,3484,243000,1128,13420,4799,125948,4664,188784,5920,314732,California
Ventura,2021-04-06,11006,502340,5591,240505,3921,246921,1494,14914,5649,127765,5325,194109,7142,321874,California
Ventura,2021-04-07,11501,513841,5410,245915,4580,251501,1511,16425,5202,128197,6271,200380,6703,328577,California
Ventura,2021-04-08,10474,524315,5286,251201,4199,255700,989,17414,5193,129114,5249,205629,6166,334743,California
Ventura,2021-04-09,11418,535733,4388,255589,5285,260985,1745,19159,4974,129411,6410,212039,6707,341450,California
Ventura,2021-04-10,9894,545627,4189,259778,3536,264521,2169,21328,3042,127784,6830,218869,5203,346653,California
Ventura,2021-04-11,2454,548081,862,260640,1013,265534,579,21907,690,127299,1752,220621,1267,347920,California
Ventura,2021-04-12,9096,557177,4520,265160,3733,269267,843,22750,3791,126642,5285,225906,4628,352548,California
Ventura,2021-04-13,8945,566122,4555,269715,4384,273651,6,22756,3751,125250,5150,231056,3758,356306,California
Ventura,2021-04-14,8890,575012,4140,273855,4735,278386,15,22771,3390,123205,5454,236510,3409,359715,California
Ventura,2021-04-15,9489,584501,4595,278450,4867,283253,27,22798,4070,121929,5374,241884,4098,363813,California
Ventura,2021-04-16,10264,594765,4511,282961,5751,289004,2,22800,4786,121275,5447,247331,4793,368606,California
Ventura,2021-04-17,9079,603844,5419,288380,3646,292650,14,22814,5259,122744,3803,251134,5272,373878,California
Ventura,2021-04-18,2213,606057,1086,289466,1127,293777,0,22814,962,122466,1241,252375,963,374841,California
Ventura,2021-04-19,8180,614237,4887,294353,3290,297067,3,22817,4688,123696,3463,255838,4693,379534,California
Ventura,2021-04-20,9596,623833,5083,299436,4508,301575,5,22822,4461,123058,5104,260942,4466,384000,California
Ventura,2021-04-21,9283,633116,4805,304241,4472,306047,6,22828,4401,122615,4850,265792,4407,388407,California
Ventura,2021-04-22,10260,643376,5608,309849,4651,310698,1,22829,4564,121515,5668,271460,4568,392975,California
Ventura,2021-04-23,11168,654544,5541,315390,5626,316324,1,22830,5551,121489,5580,277040,5554,398529,California
Ventura,2021-04-24,10695,665239,5970,321360,4725,321049,0,22830,6291,123401,4381,281421,6293,404822,California
Ventura,2021-04-25,2498,667737,1736,323096,762,321811,0,22830,1168,123243,1326,282747,1168,405990,California
Ventura,2021-04-26,8077,675814,4622,327718,3388,325199,67,22897,3370,122002,4672,287419,3431,409421,California
Ventura,2021-04-27,9316,685130,5202,332920,3888,329087,226,23123,3498,119931,5794,293213,3723,413144,California
Ventura,2021-04-28,8539,693669,4940,337860,3275,332362,324,23447,3355,118461,5150,298363,3680,416824,California
Ventura,2021-04-29,8078,701747,4355,342215,3460,335822,263,23710,2877,116432,5168,303531,3139,419963,California
Ventura,2021-04-30,9649,711396,5565,347780,3806,339628,278,23988,3988,115066,5623,309154,4257,424220,California
Ventura,2021-05-01,5219,716615,3679,351459,1429,341057,111,24099,2063,114128,3106,312260,2168,426388,California
Ventura,2021-05-02,2147,718762,1432,352891,624,341681,91,24190,1036,114154,1102,313362,1128,427516,California
Ventura,2021-05-03,6382,725144,3924,356815,2168,343849,290,24480,1999,112087,4356,317718,2289,429805,California
Ventura,2021-05-04,6491,731635,3396,360211,2801,346650,294,24774,2329,110565,4146,321864,2624,432429,California
Ventura,2021-05-05,5549,737184,3095,363306,2194,348844,260,25034,1976,109254,3538,325402,2227,434656,California
Ventura,2021-05-06,6325,743509,3257,366563,2803,351647,265,25299,2021,107261,4279,329681,2286,436942,California
Ventura,2021-05-07,6959,750468,3428,369991,3257,354904,274,25573,2376,105359,4551,334232,2649,439591,California
Ventura,2021-05-08,5488,755956,4245,374236,1081,355985,162,25735,1230,102506,4242,338474,1389,440980,California
Ventura,2021-05-09,1127,757083,819,375055,261,356246,47,25782,427,102287,692,339166,473,441453,California
Ventura,2021-05-10,6213,763296,4145,379200,1854,358100,214,25996,1403,99109,4794,343960,1616,443069,California
Ventura,2021-05-11,5454,768750,3350,382550,1874,359974,230,26226,1528,96957,3911,347871,1759,444828,California
Ventura,2021-05-12,5123,773873,2998,385548,1905,361879,220,26446,1552,95179,3550,351421,1772,446600,California
Ventura,2021-05-13,6460,780333,3900,389448,2348,364227,212,26658,2302,93557,4140,355561,2518,449118,California
Ventura,2021-05-14,7579,787912,4679,394127,2676,366903,224,26882,2861,91938,4700,360261,3081,452199,California
Ventura,2021-05-15,6804,794716,5415,399542,1305,368208,84,26966,2799,90849,3972,364233,2883,455082,California
Ventura,2021-05-16,2218,796934,1722,401264,442,368650,54,27020,1040,90769,1173,365406,1093,456175,California
Ventura,2021-05-17,5951,802885,3576,404840,2158,370808,217,27237,2422,89896,3511,368917,2638,458813,California
Ventura,2021-05-18,5491,808376,3175,408015,2134,372942,182,27419,2140,88890,3327,372244,2321,461134,California
Ventura,2021-05-19,5943,814319,3548,411563,2184,375126,211,27630,2362,87913,3546,375790,2569,463703,California
Ventura,2021-05-20,5578,819897,3057,414620,2362,377488,159,27789,2128,86781,3415,379205,2283,465986,California
Ventura,2021-05-21,8016,827913,4489,419109,3348,380836,179,27968,2560,84103,5418,384623,2740,468726,California
Ventura,2021-05-22,5714,833627,2888,421997,2748,383584,78,28046,1756,81992,3945,388568,1834,470560,California
Ventura,2021-05-23,2000,835627,1530,423527,398,383982,72,28118,750,81573,1241,389809,822,471382,California
Ventura,2021-05-24,4557,840184,2460,425987,1930,385912,167,28285,1447,80094,3088,392897,1609,472991,California
Ventura,2021-05-25,4348,844532,2234,428221,1962,387874,152,28437,1417,78750,2912,395809,1568,474559,California
Ventura,2021-05-26,4353,848885,2293,430514,1893,389767,167,28604,1652,77893,2678,398487,1821,476380,California
Ventura,2021-05-27,3920,852805,1912,432426,1878,391645,130,28734,1384,76885,2520,401007,1512,477892,California
Ventura,2021-05-28,4629,857434,2481,434907,1953,393598,195,28929,2010,76492,2593,403600,2200,480092,California
Ventura,2021-05-29,2196,859630,1352,436259,777,394375,67,28996,1081,76537,1103,404703,1148,481240,California
Ventura,2021-05-30,917,860547,583,436842,280,394655,54,29050,359,76397,552,405255,412,481652,California
Ventura,2021-05-31,262,860809,140,436982,112,394767,10,29060,62,76270,199,405454,72,481724,California
Ventura,2021-06-01,4052,864861,2291,439273,1596,396363,165,29225,1305,75018,2722,408176,1470,483194,California
Ventura,2021-06-02,2983,867844,1636,440909,1208,397571,139,29364,999,74189,1966,410142,1137,484331,California
Ventura,2021-06-03,3278,871122,2013,442922,1111,398682,154,29518,876,72828,2390,412532,1029,485360,California
Ventura,2021-06-04,4635,875757,3047,445969,1427,400109,161,29679,1422,71215,3195,415727,1582,486942,California
Ventura,2021-06-05,3844,879601,3198,449167,582,400691,64,29743,1152,69754,2678,418405,1217,488159,California
Ventura,2021-06-06,1263,880864,1080,450247,138,400829,45,29788,283,69114,968,419373,328,488487,California
Ventura,2021-06-07,3174,884038,2362,452609,700,401529,112,29900,938,67942,2221,421594,1049,489536,California
Ventura,2021-06-08,3088,887126,2027,454636,924,402453,137,30037,886,66780,2185,423779,1023,490559,California
Ventura,2021-06-09,2984,890110,2072,456708,805,403258,107,30144,772,65461,2198,425977,879,491438,California
Ventura,2021-06-10,3066,893176,2141,458849,823,404081,102,30246,819,64147,2233,428210,919,492357,California
Ventura,2021-06-11,3531,896707,2418,461267,973,405054,140,30386,996,62757,2523,430733,1133,493490,California
Ventura,2021-06-12,2190,898897,1713,462980,431,405485,46,30432,514,61652,1665,432398,560,494050,California
Ventura,2021-06-13,1022,899919,788,463768,170,405655,64,30496,231,61160,789,433187,297,494347,California
Ventura,2021-06-14,2650,902569,1811,465579,709,406364,130,30626,816,60281,1824,435011,945,495292,California
Ventura,2021-06-15,2466,905035,1581,467160,772,407136,113,30739,845,59630,1606,436617,955,496247,California
Ventura,2021-06-16,2512,907547,1839,468999,565,407701,108,30847,829,58906,1659,438276,935,497182,California
Ventura,2021-06-17,2238,909785,1560,470559,575,408276,103,30950,817,58414,1412,439688,920,498102,California
Ventura,2021-06-18,3015,912800,2119,472678,768,409044,128,31078,984,57510,2015,441703,1111,499213,California
Ventura,2021-06-19,1397,914197,1083,473761,288,409332,26,31104,524,57198,862,442565,550,499763,California
Ventura,2021-06-20,697,914894,539,474300,115,409447,43,31147,261,57069,433,442998,304,500067,California
Ventura,2021-06-21,1689,916583,1075,475375,494,409941,120,31267,835,57180,843,443841,954,501021,California
Ventura,2021-06-22,2011,918594,1406,476781,503,410444,102,31369,742,56766,1257,445098,843,501864,California
Ventura,2021-06-23,1810,920404,1240,478021,460,410904,110,31479,747,56570,1052,446150,856,502720,California
Ventura,2021-06-24,1851,922255,1210,479231,520,411424,121,31600,727,56306,1112,447262,848,503568,California
Ventura,2021-06-25,2449,924704,1627,480858,646,412070,176,31776,890,55825,1547,448809,1066,504634,California
Ventura,2021-06-26,1575,926279,1276,482134,236,412306,63,31839,528,55376,1040,449849,591,505225,California
Ventura,2021-06-27,586,926865,452,482586,108,412414,26,31865,262,55344,321,450170,289,505514,California
Ventura,2021-06-28,1791,928656,1435,484021,251,412665,105,31970,732,55135,1046,451216,837,506351,California
Ventura,2021-06-29,1682,930338,1125,485146,466,413131,91,32061,694,54939,979,452195,783,507134,California
Ventura,2021-06-30,1598,931936,1120,486266,377,413508,101,32162,779,55005,811,453006,877,508011,California
Ventura,2021-07-01,1481,933417,1097,487363,306,413814,78,32240,632,54876,838,453844,709,508720,California
Ventura,2021-07-02,1788,935205,1218,488581,474,414288,96,32336,824,54840,955,454799,919,509639,California
Ventura,2021-07-03,896,936101,669,489250,191,414479,36,32372,445,54878,443,455242,481,510120,California
Ventura,2021-07-04,62,936163,45,489295,13,414492,4,32376,27,54875,34,455276,31,510151,California
Ventura,2021-07-05,953,937116,693,489988,192,414684,68,32444,402,54796,546,455822,467,510618,California
Ventura,2021-07-06,1511,938627,1050,491038,387,415071,74,32518,647,54661,856,456678,721,511339,California
Ventura,2021-07-07,1536,940163,1066,492104,368,415439,102,32620,586,54406,943,457621,688,512027,California
Ventura,2021-07-08,1761,941924,1348,493452,338,415777,75,32695,725,54179,1027,458648,800,512827,California
Ventura,2021-07-09,1637,943561,1181,494633,348,416125,108,32803,678,54019,942,459590,782,513609,California
Ventura,2021-07-10,944,944505,727,495360,169,416294,48,32851,459,54045,481,460071,507,514116,California
Ventura,2021-07-11,469,944974,386,495746,66,416360,17,32868,181,53957,286,460357,198,514314,California
Ventura,2021-07-12,1378,946352,1060,496806,254,416614,64,32932,580,53806,795,461152,644,514958,California
Ventura,2021-07-13,1426,947778,918,497724,451,417065,57,32989,660,53762,761,461913,717,515675,California
Ventura,2021-07-14,1209,948987,815,498539,325,417390,69,33058,508,53646,692,462605,576,516251,California
Ventura,2021-07-15,1520,950507,1130,499669,323,417713,67,33125,731,53667,777,463382,798,517049,California
Ventura,2021-07-16,1777,952284,1242,500911,463,418176,72,33197,826,53630,934,464316,897,517946,California
Ventura,2021-07-17,987,953271,715,501626,218,418394,54,33251,472,53645,511,464827,526,518472,California
Ventura,2021-07-18,591,953862,467,502093,108,418502,16,33267,297,53668,290,465117,313,518785,California
Ventura,2021-07-19,1389,955251,1078,503171,261,418763,50,33317,658,53649,728,465845,709,519494,California
Ventura,2021-07-20,1493,956744,1034,504205,398,419161,61,33378,763,53752,721,466566,824,520318,California
Ventura,2021-07-21,1556,958300,1145,505350,341,419502,70,33448,760,53799,782,467348,829,521147,California
Ventura,2021-07-22,1563,959863,1133,506483,365,419867,65,33513,831,53975,719,468067,895,522042,California
Ventura,2021-07-23,1883,961746,1269,507752,525,420392,89,33602,941,54077,927,468994,1029,523071,California
Ventura,2021-07-24,1055,962801,802,508554,227,420619,26,33628,599,54253,449,469443,625,523696,California
Ventura,2021-07-25,524,963325,410,508964,108,420727,6,33634,383,54503,139,469582,389,524085,California
Ventura,2021-07-26,1513,964838,1161,510125,301,421028,51,33685,916,54881,588,470170,966,525051,California
Ventura,2021-07-27,1643,966481,1171,511296,395,421423,77,33762,939,55197,699,470869,1015,526066,California
Ventura,2021-07-28,1582,968063,1116,512412,386,421809,80,33842,932,55567,643,471512,1013,527079,California
Ventura,2021-07-29,1737,969800,1280,513692,384,422193,73,33915,972,55858,754,472266,1045,528124,California
Ventura,2021-07-30,1768,971568,1285,514977,402,422595,81,33996,1024,56242,720,472986,1104,529228,California
Ventura,2021-07-31,833,972401,641,515618,162,422757,30,34026,486,56424,334,473320,516,529744,California
Yolo,2020-12-15,39,39,39,39,0,0,0,0,39,39,0,0,39,39,California
Yolo,2020-12-16,80,119,80,119,0,0,0,0,80,119,0,0,80,119,California
Yolo,2020-12-17,108,227,108,227,0,0,0,0,108,227,0,0,108,227,California
Yolo,2020-12-18,232,459,232,459,0,0,0,0,232,459,0,0,232,459,California
Yolo,2020-12-19,87,546,87,546,0,0,0,0,87,546,0,0,87,546,California
Yolo,2020-12-20,106,652,106,652,0,0,0,0,106,652,0,0,106,652,California
Yolo,2020-12-21,253,905,253,905,0,0,0,0,253,905,0,0,253,905,California
Yolo,2020-12-22,387,1292,386,1291,1,1,0,0,387,1292,0,0,387,1292,California
Yolo,2020-12-23,441,1733,420,1711,21,22,0,0,441,1733,0,0,441,1733,California
Yolo,2020-12-24,154,1887,94,1805,60,82,0,0,154,1887,0,0,154,1887,California
Yolo,2020-12-25,1,1888,1,1806,0,82,0,0,1,1888,0,0,1,1888,California
Yolo,2020-12-26,76,1964,26,1832,50,132,0,0,76,1964,0,0,76,1964,California
Yolo,2020-12-27,47,2011,20,1852,27,159,0,0,47,2011,0,0,47,2011,California
Yolo,2020-12-28,406,2417,236,2088,170,329,0,0,406,2417,0,0,406,2417,California
Yolo,2020-12-29,494,2911,268,2356,226,555,0,0,494,2911,0,0,494,2911,California
Yolo,2020-12-30,635,3546,263,2619,372,927,0,0,635,3546,0,0,635,3546,California
Yolo,2020-12-31,186,3732,93,2712,93,1020,0,0,186,3732,0,0,186,3732,California
Yolo,2021-01-01,57,3789,55,2767,2,1022,0,0,57,3789,0,0,57,3789,California
Yolo,2021-01-02,71,3860,27,2794,44,1066,0,0,71,3860,0,0,71,3860,California
Yolo,2021-01-03,44,3904,19,2813,25,1091,0,0,44,3904,0,0,44,3904,California
Yolo,2021-01-04,195,4099,41,2854,154,1245,0,0,195,4099,0,0,195,4099,California
Yolo,2021-01-05,617,4716,239,3093,378,1623,0,0,553,4588,64,64,553,4652,California
Yolo,2021-01-06,491,5207,185,3278,306,1929,0,0,350,4797,141,205,350,5002,California
Yolo,2021-01-07,719,5926,233,3511,486,2415,0,0,527,5133,191,396,527,5529,California
Yolo,2021-01-08,637,6563,314,3825,323,2738,0,0,409,5315,227,623,409,5938,California
Yolo,2021-01-09,423,6986,71,3896,352,3090,0,0,377,5646,46,669,377,6315,California
Yolo,2021-01-10,406,7392,79,3975,327,3417,0,0,336,5912,70,739,336,6651,California
Yolo,2021-01-11,564,7956,328,4303,236,3653,0,0,289,5928,275,1014,291,6942,California
Yolo,2021-01-12,559,8515,442,4745,117,3770,0,0,189,5749,369,1383,190,7132,California
Yolo,2021-01-13,770,9285,315,5060,455,4225,0,0,517,6013,253,1636,517,7649,California
Yolo,2021-01-14,383,9668,186,5246,197,4422,0,0,279,6188,104,1740,279,7928,California
Yolo,2021-01-15,636,10304,325,5571,311,4733,0,0,552,6657,84,1824,553,8481,California
Yolo,2021-01-16,748,11052,92,5663,656,5389,0,0,716,7341,32,1856,716,9197,California
Yolo,2021-01-17,189,11241,119,5782,70,5459,0,0,182,7516,7,1863,182,9379,California
Yolo,2021-01-18,489,11730,310,6092,179,5638,0,0,335,7697,154,2017,335,9714,California
Yolo,2021-01-19,556,12286,368,6460,188,5826,0,0,380,7901,176,2193,380,10094,California
Yolo,2021-01-20,659,12945,383,6843,276,6102,0,0,463,8169,195,2388,463,10557,California
Yolo,2021-01-21,648,13593,384,7227,264,6366,0,0,459,8439,189,2577,459,11016,California
Yolo,2021-01-22,756,14349,253,7480,503,6869,0,0,639,8963,115,2692,639,11655,California
Yolo,2021-01-23,621,14970,124,7604,497,7366,0,0,573,9488,48,2740,573,12228,California
Yolo,2021-01-24,211,15181,123,7727,88,7454,0,0,170,9617,41,2781,170,12398,California
Yolo,2021-01-25,737,15918,163,7890,574,8028,0,0,514,9907,224,3005,514,12912,California
Yolo,2021-01-26,827,16745,326,8216,501,8529,0,0,430,9940,397,3402,430,13342,California
Yolo,2021-01-27,670,17415,223,8439,447,8976,0,0,386,10042,284,3686,386,13728,California
Yolo,2021-01-28,1057,18472,561,9000,496,9472,0,0,929,10843,128,3814,929,14657,California
Yolo,2021-01-29,996,19468,258,9258,738,10210,0,0,909,11666,86,3900,909,15566,California
Yolo,2021-01-30,1525,20993,927,10185,598,10808,0,0,1403,12953,116,4016,1403,16969,California
Yolo,2021-01-31,238,21231,200,10385,38,10846,0,0,209,13134,28,4044,209,17178,California
Yolo,2021-02-01,859,22090,363,10748,496,11342,0,0,621,13521,234,4278,621,17799,California
Yolo,2021-02-02,1347,23437,762,11510,585,11927,0,0,929,14033,418,4696,930,18729,California
Yolo,2021-02-03,1527,24964,396,11906,1131,13058,0,0,1181,14871,343,5039,1181,19910,California
Yolo,2021-02-04,1799,26763,279,12185,1520,14578,0,0,1237,15558,552,5591,1239,21149,California
Yolo,2021-02-05,1609,28372,917,13102,692,15270,0,0,1201,16353,407,5998,1202,22351,California
Yolo,2021-02-06,1949,30321,1262,14364,687,15957,0,0,1572,17549,377,6375,1573,23924,California
Yolo,2021-02-07,532,30853,249,14613,283,16240,0,0,169,17356,362,6737,169,24093,California
Yolo,2021-02-08,942,31795,327,14940,615,16855,0,0,600,17618,338,7075,600,24693,California
Yolo,2021-02-09,859,32654,385,15325,474,17329,0,0,571,17901,288,7363,571,25264,California
Yolo,2021-02-10,1466,34120,475,15800,991,18320,0,0,831,18099,635,7998,833,26097,California
Yolo,2021-02-11,1571,35691,807,16607,764,19084,0,0,1176,18880,395,8393,1176,27273,California
Yolo,2021-02-12,1951,37642,764,17371,1187,20271,0,0,1462,19858,485,8878,1463,28736,California
Yolo,2021-02-13,2075,39717,715,18086,1360,21631,0,0,1390,20563,685,9563,1390,30126,California
Yolo,2021-02-14,565,40282,153,18239,412,22043,0,0,440,20879,124,9687,440,30566,California
Yolo,2021-02-15,550,40832,209,18448,341,22384,0,0,279,20888,271,9958,280,30846,California
Yolo,2021-02-16,1139,41971,426,18874,713,23097,0,0,813,21376,326,10284,814,31660,California
Yolo,2021-02-17,1388,43359,705,19579,683,23780,0,0,991,21971,397,10681,992,32652,California
Yolo,2021-02-18,2499,45858,813,20392,1686,25466,0,0,1719,22912,779,11460,1720,34372,California
Yolo,2021-02-19,1766,47624,746,21138,1020,26486,0,0,1139,23426,625,12085,1139,35511,California
Yolo,2021-02-20,2574,50198,962,22100,1612,28098,0,0,1385,23628,1184,13269,1386,36897,California
Yolo,2021-02-21,327,50525,234,22334,93,28191,0,0,106,23514,220,13489,106,37003,California
Yolo,2021-02-22,1409,51934,614,22948,795,28986,0,0,708,23523,699,14188,708,37711,California
Yolo,2021-02-23,1166,53100,880,23828,286,29272,0,0,432,23222,733,14921,432,38143,California
Yolo,2021-02-24,2124,55224,610,24438,1514,30786,0,0,1395,23890,727,15648,1395,39538,California
Yolo,2021-02-25,1443,56667,502,24940,941,31727,0,0,939,24326,503,16151,939,40477,California
Yolo,2021-02-26,2720,59387,1068,26008,1652,33379,0,0,1312,24234,1404,17555,1312,41789,California
Yolo,2021-02-27,1768,61155,819,26827,949,34328,0,0,1290,25046,478,18033,1290,43079,California
Yolo,2021-02-28,1905,63060,1592,28419,313,34641,0,0,737,24619,1165,19198,738,43817,California
Yolo,2021-03-01,1174,64234,383,28802,791,35432,0,0,706,24860,465,19663,706,44523,California
Yolo,2021-03-02,1573,65807,755,29557,818,36250,0,0,981,25250,591,20254,981,45504,California
Yolo,2021-03-03,1940,67747,670,30227,1269,37519,1,1,866,25045,1072,21326,867,46371,California
Yolo,2021-03-04,3061,70808,1483,31710,1578,39097,0,1,1592,25171,1466,22792,1592,47963,California
Yolo,2021-03-05,2518,73326,1427,33137,1080,40177,11,12,1517,25699,1000,23792,1528,49491,California
Yolo,2021-03-06,1520,74846,1166,34303,325,40502,29,41,866,25942,652,24444,895,50386,California
Yolo,2021-03-07,944,75790,687,34990,231,40733,26,67,789,26602,155,24599,815,51201,California
Yolo,2021-03-08,1357,77147,511,35501,802,41535,44,111,884,27060,470,25069,928,52129,California
Yolo,2021-03-09,1590,78737,690,36191,838,42373,62,173,966,27466,622,25691,1028,53157,California
Yolo,2021-03-10,2232,80969,1076,37267,863,43236,293,466,983,27490,1244,26935,1268,54425,California
Yolo,2021-03-11,2707,83676,1611,38878,1026,44262,70,536,1811,28475,895,27830,1880,56305,California
Yolo,2021-03-12,2924,86600,1357,40235,1486,45748,81,617,1377,28395,1538,29368,1458,57763,California
Yolo,2021-03-13,1954,88554,730,40965,1047,46795,177,794,1022,28664,929,30297,1198,58961,California
Yolo,2021-03-14,1076,89630,210,41175,716,47511,150,944,539,28812,535,30832,683,59644,California
Yolo,2021-03-15,1679,91309,774,41949,721,48232,184,1128,1066,29444,612,31444,1244,60888,California
Yolo,2021-03-16,2070,93379,754,42703,1243,49475,73,1201,1275,29998,793,32237,1347,62235,California
Yolo,2021-03-17,2553,95932,1016,43719,1462,50937,75,1276,1784,31091,765,33002,1858,64093,California
Yolo,2021-03-18,3054,98986,1046,44765,1782,52719,226,1502,1271,30807,1779,34781,1495,65588,California
Yolo,2021-03-19,2105,101091,874,45639,1161,53880,70,1572,1078,30935,1020,35801,1148,66736,California
Yolo,2021-03-20,2776,103867,821,46460,1911,55791,44,1616,1068,30346,1703,37504,1114,67850,California
Yolo,2021-03-21,317,104184,217,46677,92,55883,8,1624,174,30386,142,37646,182,68032,California
Yolo,2021-03-22,1410,105594,493,47170,858,56741,59,1683,911,30858,497,38143,969,69001,California
Yolo,2021-03-23,1759,107353,952,48122,750,57491,57,1740,1074,31304,683,38826,1129,70130,California
Yolo,2021-03-24,2890,110243,1414,49536,1424,58915,52,1792,1389,31259,1487,40313,1442,71572,California
Yolo,2021-03-25,2557,112800,1415,50951,1114,60029,28,1820,1246,31232,1301,41614,1274,72846,California
Yolo,2021-03-26,2406,115206,1266,52217,1120,61149,20,1840,1025,30902,1374,42988,1044,73890,California
Yolo,2021-03-27,1683,116889,468,52685,1197,62346,18,1858,735,30708,947,43935,753,74643,California
Yolo,2021-03-28,1113,118002,866,53551,228,62574,19,1877,242,30102,866,44801,260,74903,California
Yolo,2021-03-29,2038,120040,824,54375,1185,63759,29,1906,966,30029,1068,45869,995,75898,California
Yolo,2021-03-30,2329,122369,1129,55504,1182,64941,18,1924,1189,30103,1135,47004,1209,77107,California
Yolo,2021-03-31,2371,124740,1241,56745,1093,66034,37,1961,1170,30110,1200,48204,1207,78314,California
Yolo,2021-04-01,3866,128606,1870,58615,1520,67554,476,2437,1588,29898,2275,50479,2063,80377,California
Yolo,2021-04-02,3408,132014,1516,60131,1744,69298,148,2585,2052,30748,1349,51828,2199,82576,California
Yolo,2021-04-03,1836,133850,1104,61235,513,69811,219,2804,810,30753,1024,52852,1029,83605,California
Yolo,2021-04-04,392,134242,157,61392,172,69983,63,2867,142,30709,249,53101,205,83810,California
Yolo,2021-04-05,1948,136190,748,62140,1099,71082,101,2968,901,30670,1042,54143,1003,84813,California
Yolo,2021-04-06,2610,138800,1337,63477,1097,72179,176,3144,1121,30486,1478,55621,1294,86107,California
Yolo,2021-04-07,3000,141800,1528,65005,1117,73296,355,3499,1729,31307,1266,56887,2087,88194,California
Yolo,2021-04-08,2440,144240,1016,66021,947,74243,477,3976,858,31059,1580,58467,1332,89526,California
Yolo,2021-04-09,2598,146838,928,66949,1106,75349,564,4540,836,30691,1758,60225,1390,90916,California
Yolo,2021-04-10,1762,148600,824,67773,754,76103,184,4724,1021,31157,738,60963,1204,92120,California
Yolo,2021-04-11,934,149534,286,68059,576,76679,72,4796,367,31031,564,61527,438,92558,California
Yolo,2021-04-12,1786,151320,524,68583,1120,77799,142,4938,796,30984,986,62513,939,93497,California
Yolo,2021-04-13,2011,153331,927,69510,1084,78883,0,4938,923,30820,1087,63600,923,94420,California
Yolo,2021-04-14,2864,156195,771,70281,2093,80976,0,4938,1384,30731,1473,65073,1384,95804,California
Yolo,2021-04-15,3371,159566,1142,71423,2229,83205,0,4938,2285,31937,1079,66152,2285,98089,California
Yolo,2021-04-16,3072,162638,1988,73411,1084,84289,0,4938,1963,32799,1101,67253,1963,100052,California
Yolo,2021-04-17,1620,164258,474,73885,1146,85435,0,4938,843,32870,772,68025,843,100895,California
Yolo,2021-04-18,644,164902,319,74204,325,85760,0,4938,359,32950,279,68304,359,101254,California
Yolo,2021-04-19,1688,166590,727,74931,960,86720,1,4939,767,32802,916,69220,768,102022,California
Yolo,2021-04-20,2082,168672,1074,76005,1008,87728,0,4939,1070,32863,1009,70229,1070,103092,California
Yolo,2021-04-21,2075,170747,1064,77069,1011,88739,0,4939,1111,33014,960,71189,1111,104203,California
Yolo,2021-04-22,2001,172748,911,77980,1090,89829,0,4939,993,33006,1002,72191,994,105197,California
Yolo,2021-04-23,2698,175446,1591,79571,1107,90936,0,4939,1182,32685,1503,73694,1182,106379,California
Yolo,2021-04-24,1182,176628,649,80220,530,91466,3,4942,463,32441,710,74404,466,106845,California
Yolo,2021-04-25,963,177591,414,80634,549,92015,0,4942,732,32944,229,74633,732,107577,California
Yolo,2021-04-26,1268,178859,508,81142,757,92772,3,4945,539,32760,727,75360,543,108120,California
Yolo,2021-04-27,1577,180436,748,81890,807,93579,22,4967,608,32422,968,76328,630,108750,California
Yolo,2021-04-28,2089,182525,1036,82926,1025,94604,28,4995,756,31877,1329,77657,784,109534,California
Yolo,2021-04-29,1806,184331,850,83776,870,95474,86,5081,706,31571,1096,78753,790,110324,California
Yolo,2021-04-30,2129,186460,1101,84877,972,96446,56,5137,1055,31615,1067,79820,1111,111435,California
Yolo,2021-05-01,1295,187755,1002,85879,273,96719,20,5157,375,31092,918,80738,395,111830,California
Yolo,2021-05-02,522,188277,430,86309,69,96788,23,5180,321,31235,201,80939,344,112174,California
Yolo,2021-05-03,1146,189423,417,86726,696,97484,33,5213,299,30722,844,81783,331,112505,California
Yolo,2021-05-04,1469,190892,687,87413,759,98243,23,5236,503,30287,961,82744,526,113031,California
Yolo,2021-05-05,1608,192500,455,87868,1087,99330,66,5302,475,29702,1126,83870,541,113572,California
Yolo,2021-05-06,1523,194023,708,88576,734,100064,81,5383,495,29266,1011,84881,575,114147,California
Yolo,2021-05-07,2332,196355,1407,89983,874,100938,51,5434,463,27918,1861,86742,513,114660,California
Yolo,2021-05-08,866,197221,376,90359,433,101371,57,5491,325,27761,537,87279,380,115040,California
Yolo,2021-05-09,406,197627,175,90534,218,101589,13,5504,89,27548,315,87594,102,115142,California
Yolo,2021-05-10,1204,198831,364,90898,794,102383,46,5550,212,26815,990,88584,257,115399,California
Yolo,2021-05-11,1195,200026,706,91604,467,102850,22,5572,294,26237,894,89478,316,115715,California
Yolo,2021-05-12,1847,201873,717,92321,1097,103947,33,5605,339,25106,1503,90981,372,116087,California
Yolo,2021-05-13,2641,204514,859,93180,1726,105673,56,5661,670,23866,1967,92948,727,116814,California
Yolo,2021-05-14,2449,206963,1528,94708,890,106563,31,5692,1203,23860,1240,94188,1234,118048,California
Yolo,2021-05-15,1276,208239,733,95441,496,107059,47,5739,662,23956,613,94801,709,118757,California
Yolo,2021-05-16,1459,209698,1245,96686,207,107266,7,5746,1021,24549,435,95236,1028,119785,California
Yolo,2021-05-17,1141,210839,451,97137,669,107935,21,5767,350,24133,787,96023,371,120156,California
Yolo,2021-05-18,1804,212643,1112,98249,671,108606,21,5788,918,24194,878,96901,939,121095,California
Yolo,2021-05-19,1308,213951,590,98839,679,109285,39,5827,522,23972,783,97684,561,121656,California
Yolo,2021-05-20,1356,215307,699,99538,631,109916,26,5853,391,23431,958,98642,417,122073,California
Yolo,2021-05-21,1718,217025,992,100530,699,110615,27,5880,386,22518,1325,99967,412,122485,California
Yolo,2021-05-22,821,217846,540,101070,273,110888,8,5888,281,22277,531,100498,290,122775,California
Yolo,2021-05-23,638,218484,166,101236,455,111343,17,5905,106,21871,530,101028,124,122899,California
Yolo,2021-05-24,768,219252,347,101583,401,111744,20,5925,241,21612,522,101550,263,123162,California
Yolo,2021-05-25,877,220129,508,102091,347,112091,22,5947,342,21446,530,102080,364,123526,California
Yolo,2021-05-26,817,220946,268,102359,516,112607,33,5980,245,21156,568,102648,278,123804,California
Yolo,2021-05-27,759,221705,380,102739,331,112938,48,6028,299,21048,455,103103,347,124151,California
Yolo,2021-05-28,878,222583,397,103136,450,113388,31,6059,376,20956,497,103600,405,124556,California
Yolo,2021-05-29,600,223183,345,103481,218,113606,37,6096,272,20937,325,103925,306,124862,California
Yolo,2021-05-30,136,223319,71,103552,58,113664,7,6103,55,20920,79,104004,62,124924,California
Yolo,2021-05-31,71,223390,19,103571,48,113712,4,6107,16,20884,55,104059,19,124943,California
Yolo,2021-06-01,758,224148,329,103900,402,114114,27,6134,245,20649,507,104566,272,125215,California
Yolo,2021-06-02,757,224905,302,104202,434,114548,21,6155,228,20372,526,105092,249,125464,California
Yolo,2021-06-03,915,225820,589,104791,303,114851,23,6178,209,19903,701,105793,232,125696,California
Yolo,2021-06-04,1497,227317,1219,106010,255,115106,23,6201,380,19193,1112,106905,402,126098,California
Yolo,2021-06-05,731,228048,557,106567,157,115263,17,6218,149,18777,582,107487,166,126264,California
Yolo,2021-06-06,1130,229178,1065,107632,57,115320,8,6226,161,17979,968,108455,170,126434,California
Yolo,2021-06-07,520,229698,270,107902,228,115548,22,6248,113,17710,402,108857,133,126567,California
Yolo,2021-06-08,1039,230737,808,108710,211,115759,20,6268,194,17079,844,109701,213,126780,California
Yolo,2021-06-09,790,231527,488,109198,272,116031,30,6298,214,16752,570,110271,243,127023,California
Yolo,2021-06-10,578,232105,366,109564,178,116209,34,6332,168,16546,408,110679,202,127225,California
Yolo,2021-06-11,659,232764,447,110011,188,116397,24,6356,193,16299,464,111143,217,127442,California
Yolo,2021-06-12,481,233245,277,110288,179,116576,25,6381,143,16132,334,111477,167,127609,California
Yolo,2021-06-13,155,233400,116,110404,38,116614,1,6382,61,16102,93,111570,63,127672,California
Yolo,2021-06-14,409,233809,253,110657,125,116739,31,6413,131,15988,277,111847,163,127835,California
Yolo,2021-06-15,775,234584,404,111061,344,117083,27,6440,211,15667,559,112406,238,128073,California
Yolo,2021-06-16,477,235061,243,111304,192,117275,42,6482,169,15570,306,112712,209,128282,California
Yolo,2021-06-17,497,235558,316,111620,125,117400,56,6538,173,15477,322,113034,229,128511,California
Yolo,2021-06-18,559,236117,400,112020,137,117537,22,6560,208,15358,348,113382,229,128740,California
Yolo,2021-06-19,324,236441,207,112227,99,117636,18,6578,118,15289,205,113587,136,128876,California
Yolo,2021-06-20,115,236556,73,112300,38,117674,4,6582,63,15306,50,113637,67,128943,California
Yolo,2021-06-21,208,236764,90,112390,99,117773,19,6601,113,15345,93,113730,132,129075,California
Yolo,2021-06-22,525,237289,298,112688,207,117980,20,6621,214,15270,309,114039,234,129309,California
Yolo,2021-06-23,375,237664,211,112899,147,118127,17,6638,150,15216,221,114260,167,129476,California
Yolo,2021-06-24,401,238065,247,113146,109,118236,45,6683,175,15211,225,114485,220,129696,California
Yolo,2021-06-25,552,238617,390,113536,118,118354,44,6727,191,15090,356,114841,235,129931,California
Yolo,2021-06-26,273,238890,168,113704,82,118436,23,6750,111,15064,160,115001,134,130065,California
Yolo,2021-06-27,178,239068,141,113845,32,118468,5,6755,64,15018,114,115115,68,130133,California
Yolo,2021-06-28,257,239325,132,113977,52,118520,73,6828,110,15054,146,115261,182,130315,California
Yolo,2021-06-29,421,239746,264,114241,108,118628,49,6877,156,14998,261,115522,205,130520,California
Yolo,2021-06-30,362,240108,200,114441,134,118762,28,6905,129,14922,232,115754,156,130676,California
Yolo,2021-07-01,310,240418,175,114616,103,118865,32,6937,112,14870,195,115949,143,130819,California
Yolo,2021-07-02,342,240760,233,114849,99,118964,10,6947,138,14815,203,116152,148,130967,California
Yolo,2021-07-03,207,240967,128,114977,75,119039,4,6951,91,14795,115,116267,95,131062,California
Yolo,2021-07-04,73,241040,41,115018,27,119066,5,6956,22,14772,50,116317,27,131089,California
Yolo,2021-07-05,140,241180,84,115102,51,119117,5,6961,68,14774,71,116388,73,131162,California
Yolo,2021-07-06,358,241538,238,115340,100,119217,20,6981,134,14708,221,116609,155,131317,California
Yolo,2021-07-07,371,241909,195,115535,111,119328,65,7046,142,14686,228,116837,206,131523,California
Yolo,2021-07-08,345,242254,197,115732,89,119417,59,7105,120,14643,220,117057,177,131700,California
Yolo,2021-07-09,360,242614,247,115979,97,119514,16,7121,139,14583,215,117272,155,131855,California
Yolo,2021-07-10,192,242806,134,116113,43,119557,15,7136,76,14559,115,117387,91,131946,California
Yolo,2021-07-11,80,242886,59,116172,21,119578,0,7136,40,14560,39,117426,40,131986,California
Yolo,2021-07-12,197,243083,140,116312,47,119625,10,7146,92,14559,103,117529,102,132088,California
Yolo,2021-07-13,322,243405,196,116508,94,119719,32,7178,133,14537,176,117705,154,132242,California
Yolo,2021-07-14,233,243638,148,116656,77,119796,8,7186,99,14510,133,117838,106,132348,California
Yolo,2021-07-15,326,243964,242,116898,71,119867,13,7199,148,14493,178,118016,161,132509,California
Yolo,2021-07-16,332,244296,232,117130,91,119958,9,7208,171,14513,160,118176,180,132689,California
Yolo,2021-07-17,208,244504,131,117261,76,120034,1,7209,97,14502,109,118285,98,132787,California
Yolo,2021-07-18,107,244611,72,117333,34,120068,1,7210,49,14495,57,118342,50,132837,California
Yolo,2021-07-19,225,244836,154,117487,65,120133,6,7216,118,14512,107,118449,124,132961,California
Yolo,2021-07-20,343,245179,222,117709,110,120243,11,7227,192,14568,147,118596,203,133164,California
Yolo,2021-07-21,352,245531,192,117901,125,120368,35,7262,159,14571,191,118787,194,133358,California
Yolo,2021-07-22,293,245824,199,118100,86,120454,8,7270,164,14615,128,118915,172,133530,California
Yolo,2021-07-23,345,246169,235,118335,101,120555,9,7279,203,14688,139,119054,212,133742,California
Yolo,2021-07-24,150,246319,93,118428,54,120609,3,7282,80,14702,69,119123,83,133825,California
Yolo,2021-07-25,98,246417,62,118490,35,120644,1,7283,63,14731,35,119158,64,133889,California
Yolo,2021-07-26,248,246665,160,118650,72,120716,16,7299,156,14812,91,119249,172,134061,California
Yolo,2021-07-27,312,246977,209,118859,88,120804,15,7314,184,14884,127,119376,199,134260,California
Yolo,2021-07-28,398,247375,288,119147,95,120899,15,7329,227,14960,166,119542,242,134502,California
Yolo,2021-07-29,390,247765,279,119426,96,120995,15,7344,233,15055,153,119695,248,134750,California
Yolo,2021-07-30,466,248231,316,119742,131,121126,19,7363,287,15193,168,119863,306,135056,California
Yolo,2021-07-31,148,248379,85,119827,57,121183,6,7369,91,15233,57,119920,97,135153,California
Yuba,2020-12-16,4,4,4,4,0,0,0,0,4,4,0,0,4,4,California
Yuba,2020-12-17,4,8,4,8,0,0,0,0,4,8,0,0,4,8,California
Yuba,2020-12-18,8,16,8,16,0,0,0,0,8,16,0,0,8,16,California
Yuba,2020-12-19,12,28,12,28,0,0,0,0,12,28,0,0,12,28,California
Yuba,2020-12-20,20,48,20,48,0,0,0,0,20,48,0,0,20,48,California
Yuba,2020-12-21,42,90,42,90,0,0,0,0,42,90,0,0,42,90,California
Yuba,2020-12-22,82,172,82,172,0,0,0,0,82,172,0,0,82,172,California
Yuba,2020-12-23,64,236,62,234,2,2,0,0,64,236,0,0,64,236,California
Yuba,2020-12-24,21,257,11,245,10,12,0,0,21,257,0,0,21,257,California
Yuba,2020-12-25,1,258,1,246,0,12,0,0,1,258,0,0,1,258,California
Yuba,2020-12-26,15,273,14,260,1,13,0,0,15,273,0,0,15,273,California
Yuba,2020-12-27,15,288,15,275,0,13,0,0,15,288,0,0,15,288,California
Yuba,2020-12-28,50,338,34,309,16,29,0,0,50,338,0,0,50,338,California
Yuba,2020-12-29,74,412,10,319,64,93,0,0,74,412,0,0,74,412,California
Yuba,2020-12-30,64,476,21,340,43,136,0,0,64,476,0,0,64,476,California
Yuba,2020-12-31,39,515,6,346,33,169,0,0,39,515,0,0,39,515,California
Yuba,2021-01-02,20,535,19,365,1,170,0,0,20,535,0,0,20,535,California
Yuba,2021-01-03,10,545,6,371,4,174,0,0,10,545,0,0,10,545,California
Yuba,2021-01-04,93,638,23,394,70,244,0,0,93,638,0,0,93,638,California
Yuba,2021-01-05,73,711,39,433,34,278,0,0,72,709,1,1,72,710,California
Yuba,2021-01-06,153,864,76,509,77,355,0,0,147,850,6,7,147,857,California
Yuba,2021-01-07,78,942,20,529,58,413,0,0,74,920,4,11,74,931,California
Yuba,2021-01-08,77,1019,25,554,52,465,0,0,70,983,7,18,70,1001,California
Yuba,2021-01-09,19,1038,17,571,2,467,0,0,10,984,9,27,10,1011,California
Yuba,2021-01-10,115,1153,22,593,93,560,0,0,93,1055,22,49,93,1104,California
Yuba,2021-01-11,73,1226,50,643,23,583,0,0,33,1048,40,89,33,1137,California
Yuba,2021-01-12,107,1333,75,718,32,615,0,0,45,1031,62,151,45,1182,California
Yuba,2021-01-13,120,1453,72,790,48,663,0,0,54,1020,65,216,54,1236,California
Yuba,2021-01-14,114,1567,44,834,70,733,0,0,102,1110,12,228,102,1338,California
Yuba,2021-01-15,203,1770,88,922,115,848,0,0,192,1291,11,239,192,1530,California
Yuba,2021-01-16,186,1956,21,943,165,1013,0,0,172,1449,14,253,172,1702,California
Yuba,2021-01-17,13,1969,9,952,4,1017,0,0,7,1450,6,259,7,1709,California
Yuba,2021-01-18,61,2030,31,983,30,1047,0,0,37,1463,24,283,37,1746,California
Yuba,2021-01-19,83,2113,32,1015,51,1098,0,0,67,1514,16,299,67,1813,California
Yuba,2021-01-20,135,2248,86,1101,49,1147,0,0,112,1603,23,322,112,1925,California
Yuba,2021-01-21,228,2476,105,1206,123,1270,0,0,219,1813,9,331,219,2144,California
Yuba,2021-01-22,105,2581,7,1213,98,1368,0,0,96,1900,9,340,96,2240,California
Yuba,2021-01-23,203,2784,7,1220,196,1564,0,0,201,2099,2,342,201,2441,California
Yuba,2021-01-24,11,2795,8,1228,3,1567,0,0,9,2106,2,344,9,2450,California
Yuba,2021-01-25,87,2882,31,1259,56,1623,0,0,54,2128,32,376,54,2504,California
Yuba,2021-01-26,148,3030,40,1299,108,1731,0,0,92,2164,56,432,92,2596,California
Yuba,2021-01-27,187,3217,131,1430,56,1787,0,0,119,2215,68,500,119,2715,California
Yuba,2021-01-28,228,3445,91,1521,137,1924,0,0,176,2339,52,552,176,2891,California
Yuba,2021-01-29,153,3598,47,1568,106,2030,0,0,112,2410,41,593,112,3003,California
Yuba,2021-01-30,406,4004,24,1592,382,2412,0,0,395,2794,11,604,395,3398,California
Yuba,2021-01-31,17,4021,11,1603,6,2418,0,0,15,2807,2,606,15,3413,California
Yuba,2021-02-01,158,4179,77,1680,81,2499,0,0,132,2915,25,631,133,3546,California
Yuba,2021-02-02,125,4304,21,1701,104,2603,0,0,100,2990,25,656,100,3646,California
Yuba,2021-02-03,231,4535,29,1730,202,2805,0,0,119,2998,111,767,119,3765,California
Yuba,2021-02-04,295,4830,117,1847,178,2983,0,0,248,3199,47,814,248,4013,California
Yuba,2021-02-05,156,4986,35,1882,121,3104,0,0,75,3194,80,894,75,4088,California
Yuba,2021-02-06,452,5438,23,1905,429,3533,0,0,444,3630,8,902,444,4532,California
Yuba,2021-02-07,21,5459,15,1920,6,3539,0,0,17,3643,4,906,17,4549,California
Yuba,2021-02-08,100,5559,36,1956,64,3603,0,0,68,3679,32,938,68,4617,California
Yuba,2021-02-09,164,5723,61,2017,103,3706,0,0,92,3699,72,1010,92,4709,California
Yuba,2021-02-10,365,6088,176,2193,189,3895,0,0,127,3590,236,1246,127,4836,California
Yuba,2021-02-11,408,6496,68,2261,340,4235,0,0,304,3792,102,1348,304,5140,California
Yuba,2021-02-12,268,6764,26,2287,242,4477,0,0,152,3828,116,1464,152,5292,California
Yuba,2021-02-13,441,7205,36,2323,405,4882,0,0,390,4167,51,1515,390,5682,California
Yuba,2021-02-14,53,7258,11,2334,42,4924,0,0,47,4208,6,1521,47,5729,California
Yuba,2021-02-15,91,7349,36,2370,55,4979,0,0,71,4259,20,1541,71,5800,California
Yuba,2021-02-16,204,7553,55,2425,149,5128,0,0,144,4343,60,1601,144,5944,California
Yuba,2021-02-17,387,7940,157,2582,230,5358,0,0,103,4163,283,1884,103,6047,California
Yuba,2021-02-18,333,8273,54,2636,279,5637,0,0,202,4234,131,2015,202,6249,California
Yuba,2021-02-19,225,8498,77,2713,148,5785,0,0,139,4288,85,2100,139,6388,California
Yuba,2021-02-20,402,8900,30,2743,372,6157,0,0,343,4572,59,2159,343,6731,California
Yuba,2021-02-21,25,8925,15,2758,10,6167,0,0,15,4577,10,2169,15,6746,California
Yuba,2021-02-22,133,9058,82,2840,51,6218,0,0,40,4524,93,2262,40,6786,California
Yuba,2021-02-23,135,9193,30,2870,105,6323,0,0,55,4501,79,2341,56,6842,California
Yuba,2021-02-24,503,9696,145,3015,358,6681,0,0,108,4214,395,2736,108,6950,California
Yuba,2021-02-25,367,10063,141,3156,226,6907,0,0,230,4307,137,2873,230,7180,California
Yuba,2021-02-26,271,10334,74,3230,197,7104,0,0,146,4330,123,2996,146,7326,California
Yuba,2021-02-27,472,10806,49,3279,423,7527,0,0,389,4636,83,3079,389,7715,California
Yuba,2021-02-28,78,10884,24,3303,54,7581,0,0,55,4668,23,3102,55,7770,California
Yuba,2021-03-01,170,11054,47,3350,123,7704,0,0,89,4677,80,3182,89,7859,California
Yuba,2021-03-02,175,11229,44,3394,131,7835,0,0,86,4674,89,3271,86,7945,California
Yuba,2021-03-03,660,11889,161,3555,499,8334,0,0,203,4421,456,3727,203,8148,California
Yuba,2021-03-04,484,12373,280,3835,204,8538,0,0,336,4610,147,3874,336,8484,California
Yuba,2021-03-05,329,12702,58,3893,270,8808,1,1,261,4804,68,3942,262,8746,California
Yuba,2021-03-06,479,13181,32,3925,443,9251,4,5,371,5072,107,4049,375,9121,California
Yuba,2021-03-07,60,13241,31,3956,27,9278,2,7,44,5102,16,4065,46,9167,California
Yuba,2021-03-08,165,13406,52,4008,97,9375,16,23,101,5155,64,4129,117,9284,California
Yuba,2021-03-09,183,13589,48,4056,115,9490,20,43,87,5166,96,4225,107,9391,California
Yuba,2021-03-10,744,14333,234,4290,480,9970,30,73,239,4930,505,4730,269,9660,California
Yuba,2021-03-11,451,14784,203,4493,235,10205,13,86,299,5090,152,4882,312,9972,California
Yuba,2021-03-12,471,15255,84,4577,334,10539,53,139,163,4998,308,5190,216,10188,California
Yuba,2021-03-13,471,15726,341,4918,115,10654,15,154,369,5281,101,5291,384,10572,California
Yuba,2021-03-14,109,15835,20,4938,80,10734,9,163,48,5278,60,5351,57,10629,California
Yuba,2021-03-15,203,16038,55,4993,133,10867,15,178,108,5306,95,5446,123,10752,California
Yuba,2021-03-16,313,16351,80,5073,209,11076,24,202,197,5412,115,5561,221,10973,California
Yuba,2021-03-17,759,17110,172,5245,557,11633,30,232,199,5084,557,6118,229,11202,California
Yuba,2021-03-18,590,17700,160,5405,315,11948,115,347,361,5330,229,6347,475,11677,California
Yuba,2021-03-19,332,18032,117,5522,162,12110,53,400,183,5417,148,6495,235,11912,California
Yuba,2021-03-20,564,18596,83,5605,462,12572,19,419,479,5831,84,6579,498,12410,California
Yuba,2021-03-21,67,18663,40,5645,27,12599,0,419,45,5854,22,6601,45,12455,California
Yuba,2021-03-22,199,18862,73,5718,118,12717,8,427,153,5969,46,6647,161,12616,California
Yuba,2021-03-23,275,19137,81,5799,166,12883,28,455,183,6091,89,6736,211,12827,California
Yuba,2021-03-24,769,19906,256,6055,432,13315,81,536,186,5777,581,7317,267,13094,California
Yuba,2021-03-25,523,20429,274,6329,226,13541,23,559,255,5787,268,7585,278,13372,California
Yuba,2021-03-26,402,20831,142,6471,229,13770,31,590,228,5873,173,7758,259,13631,California
Yuba,2021-03-27,468,21299,30,6501,435,14205,3,593,415,6238,52,7810,417,14048,California
Yuba,2021-03-28,109,21408,44,6545,61,14266,4,597,36,6205,73,7883,40,14088,California
Yuba,2021-03-29,304,21712,90,6635,182,14448,32,629,183,6299,121,8004,215,14303,California
Yuba,2021-03-30,285,21997,74,6709,203,14651,8,637,193,6408,92,8096,201,14504,California
Yuba,2021-03-31,691,22688,117,6826,563,15214,11,648,242,6214,447,8543,253,14757,California
Yuba,2021-04-01,639,23327,295,7121,315,15529,29,677,293,6190,346,8889,322,15079,California
Yuba,2021-04-02,525,23852,104,7225,336,15865,85,762,201,6152,323,9212,285,15364,California
Yuba,2021-04-03,666,24518,58,7283,117,15982,491,1253,89,6156,576,9788,580,15944,California
Yuba,2021-04-04,60,24578,11,7294,42,16024,7,1260,31,6165,29,9817,38,15982,California
Yuba,2021-04-05,260,24838,88,7382,149,16173,23,1283,127,6183,131,9948,149,16131,California
Yuba,2021-04-06,358,25196,117,7499,180,16353,61,1344,170,6226,187,10135,230,16361,California
Yuba,2021-04-07,796,25992,412,7911,330,16683,54,1398,361,6208,432,10567,414,16775,California
Yuba,2021-04-08,769,26761,301,8212,199,16882,269,1667,283,6274,485,11052,551,17326,California
Yuba,2021-04-09,414,27175,173,8385,173,17055,68,1735,176,6281,237,11289,244,17570,California
Yuba,2021-04-10,610,27785,72,8457,86,17141,452,2187,71,6266,537,11826,522,18092,California
Yuba,2021-04-11,107,27892,27,8484,68,17209,12,2199,45,6262,61,11887,57,18149,California
Yuba,2021-04-12,221,28113,49,8533,138,17347,34,2233,82,6239,138,12025,115,18264,California
Yuba,2021-04-13,408,28521,106,8639,302,17649,0,2233,200,6232,207,12232,200,18464,California
Yuba,2021-04-14,724,29245,110,8749,614,18263,0,2233,130,5770,592,12824,130,18594,California
Yuba,2021-04-15,351,29596,134,8883,217,18480,0,2233,153,5726,197,13021,153,18747,California
Yuba,2021-04-16,355,29951,103,8986,252,18732,0,2233,186,5745,167,13188,186,18933,California
Yuba,2021-04-17,418,30369,62,9048,356,19088,0,2233,345,6018,72,13260,345,19278,California
Yuba,2021-04-18,68,30437,20,9068,48,19136,0,2233,35,6021,32,13292,35,19313,California
Yuba,2021-04-19,252,30689,107,9175,145,19281,0,2233,103,5975,149,13441,103,19416,California
Yuba,2021-04-20,353,31042,106,9281,247,19528,0,2233,190,6006,160,13601,191,19607,California
Yuba,2021-04-21,747,31789,323,9604,424,19952,0,2233,321,5901,426,14027,321,19928,California
Yuba,2021-04-22,381,32170,155,9759,226,20178,0,2233,206,5932,175,14202,206,20134,California
Yuba,2021-04-23,381,32551,132,9891,249,20427,0,2233,176,5905,203,14405,176,20310,California
Yuba,2021-04-24,224,32775,69,9960,155,20582,0,2233,123,5927,101,14506,123,20433,California
Yuba,2021-04-25,77,32852,30,9990,47,20629,0,2233,36,5922,41,14547,36,20469,California
Yuba,2021-04-26,258,33110,70,10060,184,20813,4,2237,116,5900,142,14689,120,20589,California
Yuba,2021-04-27,500,33610,176,10236,313,21126,11,2248,248,5909,250,14939,259,20848,California
Yuba,2021-04-28,463,34073,193,10429,265,21391,5,2253,162,5780,296,15235,167,21015,California
Yuba,2021-04-29,468,34541,93,10522,374,21765,1,2254,160,5634,307,15542,161,21176,California
Yuba,2021-04-30,355,34896,109,10631,215,21980,31,2285,151,5614,202,15744,182,21358,California
Yuba,2021-05-01,215,35111,95,10726,101,22081,19,2304,100,5619,114,15858,119,21477,California
Yuba,2021-05-02,72,35183,41,10767,27,22108,4,2308,38,5627,34,15892,42,21519,California
Yuba,2021-05-03,168,35351,69,10836,91,22199,8,2316,53,5575,113,16005,61,21580,California
Yuba,2021-05-04,347,35698,109,10945,216,22415,22,2338,157,5564,190,16195,179,21759,California
Yuba,2021-05-05,341,36039,97,11042,237,22652,7,2345,121,5472,220,16415,128,21887,California
Yuba,2021-05-06,303,36342,125,11167,139,22791,39,2384,101,5413,199,16614,140,22027,California
Yuba,2021-05-07,374,36716,104,11271,242,23033,28,2412,119,5306,254,16868,147,22174,California
Yuba,2021-05-08,137,36853,57,11328,74,23107,6,2418,58,5291,79,16947,64,22238,California
Yuba,2021-05-09,56,36909,25,11353,28,23135,3,2421,34,5306,22,16969,37,22275,California
Yuba,2021-05-10,174,37083,55,11408,101,23236,18,2439,53,5258,119,17088,71,22346,California
Yuba,2021-05-11,392,37475,180,11588,199,23435,13,2452,139,5159,250,17338,151,22497,California
Yuba,2021-05-12,277,37752,146,11734,123,23558,8,2460,102,5094,175,17513,110,22607,California
Yuba,2021-05-13,370,38122,197,11931,129,23687,44,2504,115,5001,252,17765,159,22766,California
Yuba,2021-05-14,374,38496,138,12069,215,23902,21,2525,153,4954,220,17985,173,22939,California
Yuba,2021-05-15,448,38944,115,12184,311,24213,22,2547,113,4755,333,18318,134,23073,California
Yuba,2021-05-16,156,39100,53,12237,94,24307,9,2556,96,4801,59,18377,105,23178,California
Yuba,2021-05-17,220,39320,91,12328,109,24416,20,2576,89,4781,129,18506,109,23287,California
Yuba,2021-05-18,396,39716,165,12493,222,24638,9,2585,165,4724,231,18737,174,23461,California
Yuba,2021-05-19,259,39975,143,12636,110,24748,6,2591,129,4729,130,18867,135,23596,California
Yuba,2021-05-20,436,40411,307,12943,116,24864,13,2604,260,4826,176,19043,273,23869,California
Yuba,2021-05-21,515,40926,270,13213,238,25102,7,2611,306,4932,207,19250,313,24182,California
Yuba,2021-05-22,231,41157,125,13338,97,25199,9,2620,94,4898,137,19387,103,24285,California
Yuba,2021-05-23,75,41232,42,13380,31,25230,2,2622,38,4902,36,19423,40,24325,California
Yuba,2021-05-24,164,41396,56,13436,91,25321,17,2639,47,4851,116,19539,65,24390,California
Yuba,2021-05-25,317,41713,110,13546,190,25511,17,2656,110,4772,205,19744,126,24516,California
Yuba,2021-05-26,243,41956,106,13652,121,25632,16,2672,89,4724,153,19897,105,24621,California
Yuba,2021-05-27,248,42204,75,13727,161,25793,12,2684,100,4691,145,20042,112,24733,California
Yuba,2021-05-28,248,42452,111,13838,130,25923,7,2691,116,4684,130,20172,123,24856,California
Yuba,2021-05-29,168,42620,68,13906,78,26001,22,2713,88,4715,79,20251,110,24966,California
Yuba,2021-05-30,54,42674,24,13930,25,26026,5,2718,22,4710,32,20283,27,24993,California
Yuba,2021-05-31,29,42703,3,13933,19,26045,7,2725,10,4708,19,20302,17,25010,California
Yuba,2021-06-01,247,42950,104,14037,136,26181,7,2732,84,4639,159,20461,90,25100,California
Yuba,2021-06-02,204,43154,80,14117,117,26298,7,2739,59,4563,143,20604,67,25167,California
Yuba,2021-06-03,182,43336,106,14223,70,26368,6,2745,63,4515,117,20721,69,25236,California
Yuba,2021-06-04,245,43581,119,14342,115,26483,11,2756,80,4442,163,20884,90,25326,California
Yuba,2021-06-05,200,43781,150,14492,44,26527,6,2762,90,4429,109,20993,96,25422,California
Yuba,2021-06-06,112,43893,95,14587,14,26541,3,2765,21,4363,90,21083,24,25446,California
Yuba,2021-06-07,115,44008,48,14635,51,26592,16,2781,36,4336,79,21162,52,25498,California
Yuba,2021-06-08,246,44254,113,14748,124,26716,9,2790,71,4243,173,21335,80,25578,California
Yuba,2021-06-09,172,44426,103,14851,62,26778,7,2797,72,4223,99,21434,79,25657,California
Yuba,2021-06-10,386,44812,305,15156,72,26850,9,2806,97,4043,286,21720,106,25763,California
Yuba,2021-06-11,330,45142,234,15390,84,26934,12,2818,66,3858,264,21984,79,25842,California
Yuba,2021-06-12,132,45274,90,15480,36,26970,6,2824,36,3804,96,22080,42,25884,California
Yuba,2021-06-13,46,45320,21,15501,23,26993,2,2826,12,3785,33,22113,14,25898,California
Yuba,2021-06-14,114,45434,55,15556,49,27042,10,2836,33,3748,80,22193,43,25941,California
Yuba,2021-06-15,240,45674,98,15654,134,27176,8,2844,90,3699,147,22340,98,26039,California
Yuba,2021-06-16,157,45831,96,15750,51,27227,10,2854,73,3700,82,22422,83,26122,California
Yuba,2021-06-17,198,46029,116,15866,70,27297,12,2866,85,3684,113,22535,97,26219,California
Yuba,2021-06-18,225,46254,111,15977,93,27390,21,2887,74,3630,149,22684,95,26314,California
Yuba,2021-06-19,136,46390,67,16044,62,27452,7,2894,33,3567,103,22787,40,26354,California
Yuba,2021-06-20,33,46423,19,16063,11,27463,3,2897,13,3563,20,22807,16,26370,California
Yuba,2021-06-21,90,46513,39,16102,42,27505,9,2906,44,3573,42,22849,52,26422,California
Yuba,2021-06-22,176,46689,73,16175,91,27596,12,2918,70,3550,104,22953,81,26503,California
Yuba,2021-06-23,127,46816,71,16246,43,27639,13,2931,52,3540,74,23027,64,26567,California
Yuba,2021-06-24,138,46954,83,16329,47,27686,8,2939,60,3530,78,23105,68,26635,California
Yuba,2021-06-25,168,47122,96,16425,63,27749,9,2948,82,3535,86,23191,91,26726,California
Yuba,2021-06-26,132,47254,105,16530,26,27775,1,2949,43,3491,88,23279,44,26770,California
Yuba,2021-06-27,64,47318,42,16572,20,27795,2,2951,36,3501,28,23307,38,26808,California
Yuba,2021-06-28,61,47379,34,16606,24,27819,3,2954,28,3499,33,23340,31,26839,California
Yuba,2021-06-29,160,47539,84,16690,67,27886,9,2963,60,3469,99,23439,69,26908,California
Yuba,2021-06-30,138,47677,79,16769,52,27938,7,2970,71,3480,67,23506,78,26986,California
Yuba,2021-07-01,122,47799,84,16853,30,27968,8,2978,45,3457,76,23582,53,27039,California
Yuba,2021-07-02,126,47925,53,16906,58,28026,15,2993,42,3430,84,23666,57,27096,California
Yuba,2021-07-03,66,47991,44,16950,22,28048,0,2993,36,3436,30,23696,36,27132,California
Yuba,2021-07-04,6,47997,3,16953,3,28051,0,2993,3,3436,3,23699,3,27135,California
Yuba,2021-07-05,68,48065,46,16999,17,28068,5,2998,38,3449,30,23729,43,27178,California
Yuba,2021-07-06,174,48239,94,17093,66,28134,14,3012,65,3425,103,23832,79,27257,California
Yuba,2021-07-07,144,48383,96,17189,37,28171,11,3023,56,3405,87,23919,67,27324,California
Yuba,2021-07-08,150,48533,88,17277,43,28214,19,3042,58,3390,92,24011,77,27401,California
Yuba,2021-07-09,160,48693,94,17371,52,28266,14,3056,79,3402,81,24092,93,27494,California
Yuba,2021-07-10,87,48780,57,17428,29,28295,1,3057,59,3434,28,24120,60,27554,California
Yuba,2021-07-11,35,48815,17,17445,17,28312,1,3058,14,3428,21,24141,15,27569,California
Yuba,2021-07-12,93,48908,54,17499,24,28336,15,3073,35,3420,58,24199,50,27619,California
Yuba,2021-07-13,127,49035,69,17568,49,28385,9,3082,56,3414,71,24270,65,27684,California
Yuba,2021-07-14,91,49126,55,17623,30,28415,6,3088,43,3415,48,24318,49,27733,California
Yuba,2021-07-15,113,49239,62,17685,43,28458,8,3096,48,3408,63,24381,56,27789,California
Yuba,2021-07-16,159,49398,93,17778,51,28509,15,3111,79,3424,78,24459,94,27883,California
Yuba,2021-07-17,68,49466,42,17820,24,28533,2,3113,37,3432,31,24490,39,27922,California
Yuba,2021-07-18,51,49517,27,17847,19,28552,5,3118,27,3440,24,24514,32,27954,California
Yuba,2021-07-19,72,49589,29,17876,33,28585,10,3128,33,3445,38,24552,43,27997,California
Yuba,2021-07-20,172,49761,97,17973,70,28655,5,3133,89,3457,82,24634,94,28091,California
Yuba,2021-07-21,157,49918,71,18044,57,28712,29,3162,75,3478,82,24716,103,28194,California
Yuba,2021-07-22,147,50065,84,18128,48,28760,15,3177,76,3503,66,24782,91,28285,California
Yuba,2021-07-23,143,50208,69,18197,69,28829,5,3182,82,3529,61,24843,87,28372,California
Yuba,2021-07-24,120,50328,79,18276,32,28861,9,3191,72,3562,48,24891,81,28453,California
Yuba,2021-07-25,55,50383,32,18308,18,28879,5,3196,32,3576,23,24914,37,28490,California
Yuba,2021-07-26,148,50531,84,18392,51,28930,13,3209,90,3621,58,24972,103,28593,California
Yuba,2021-07-27,185,50716,99,18491,78,29008,8,3217,118,3681,66,25038,126,28719,California
Yuba,2021-07-28,203,50919,122,18613,77,29085,4,3221,141,3765,61,25099,145,28864,California
Yuba,2021-07-29,169,51088,93,18706,54,29139,22,3243,103,3824,65,25164,124,28988,California
Yuba,2021-07-30,230,51318,141,18847,60,29199,29,3272,149,3923,79,25243,178,29166,California
Yuba,2021-07-31,95,51413,69,18916,22,29221,4,3276,59,3950,36,25279,63,29229,California
